Game Id;PlayerId;TeamId;Game Rating;SA;GA;SV;SV%;TOI;PIM
0;233;29;0;0;0;0;.00nan;0;0
0;2423;15;91;37;2;35;.946;3552000;0
0;4106;15;0;0;0;0;.00nan;0;0
0;18351;29;81;25;1;24;.960;3600000;0
1;500;4182;0;0;0;0;.00nan;0;0
1;1572;4838;0;0;0;0;.00nan;0;0
1;2328;4838;43;30;5;25;.833;3570000;0
1;25521;4182;62;29;3;26;.897;3600000;0
2;1074;0;0;0;0;0;.00nan;0;0
2;1821;3;54;24;3;21;.875;3600000;0
2;2054;3;0;0;0;0;.00nan;0;0
2;31035;0;92;53;4;49;.925;3579000;0
3;18104;10;0;0;0;0;.00nan;0;0
3;27488;10;87;42;3;39;.929;3856000;0
3;27739;22;75;37;3;34;.919;3900000;0
3;28026;22;0;0;0;0;.00nan;0;0
4;1614;25;81;41;4;37;.902;3900000;0
4;5182;25;0;0;0;0;.00nan;0;0
4;15505;8;90;54;4;50;.926;3900000;0
4;25076;8;0;0;0;0;.00nan;0;0
5;335;18;100;41;2;39;.951;3900000;0
5;823;23;0;0;0;0;.00nan;0;0
5;5001;18;0;0;0;0;.00nan;0;0
5;10274;23;86;27;2;25;.926;3900000;0
6;1074;0;68;29;3;26;.897;3565000;0
6;5385;17;0;0;0;0;.00nan;0;0
6;31035;0;0;0;0;0;.00nan;0;0
6;34006;17;75;29;2;27;.931;3600000;0
7;1821;3;0;0;0;0;.00nan;0;0
7;2054;3;92;30;1;29;.967;3600000;0
7;2058;28;82;50;4;46;.920;3600000;0
7;14061;28;0;0;0;0;.00nan;0;0
8;233;29;0;0;0;0;.00nan;0;0
8;323;9;86;32;1;31;.969;3560000;0
8;18351;29;100;26;0;26;1.000;3600000;0
8;20853;9;0;0;0;0;.00nan;0;0
9;61;31;0;0;0;0;.00nan;0;0
9;2423;15;68;39;4;35;.897;3554000;0
9;4106;15;0;0;0;0;.00nan;0;0
9;34797;31;59;25;3;22;.880;3600000;0
10;445;12;31;33;6;27;.818;2342000;0
10;18104;10;61;26;3;23;.885;3600000;0
10;27488;10;0;0;0;0;.00nan;0;0
10;34786;12;55;4;0;4;1.000;1258000;0
11;10103;24;92;43;2;41;.953;3900000;0
11;13979;24;0;0;0;0;.00nan;0;0
11;18078;20;58;15;2;13;.867;3900000;0
11;32146;20;0;0;0;0;.00nan;0;0
12;13842;34;21;26;6;20;.769;2626000;0
12;15502;34;60;11;1;10;.909;974000;0
12;22601;26;0;0;0;0;.00nan;0;0
12;32754;26;60;35;3;32;.914;3600000;0
13;1572;4838;75;25;2;23;.920;3900000;0
13;2328;4838;0;0;0;0;.00nan;0;0
13;15464;32;0;0;0;0;.00nan;0;0
13;16006;32;83;29;2;27;.931;3900000;0
14;1913;30;69;35;4;31;.886;3577000;0
14;4506;33;49;21;3;18;.857;3600000;0
14;4826;30;0;0;0;0;.00nan;0;0
14;34740;33;0;0;0;0;.00nan;0;0
15;500;4182;74;19;1;18;.947;3600000;0
15;724;11;88;42;3;39;.929;3523000;0
15;21522;11;0;0;0;0;.00nan;0;0
15;25521;4182;0;0;0;0;.00nan;0;0
16;51;21;0;0;0;0;.00nan;0;0
16;15505;8;66;33;4;29;.879;3600000;0
16;25076;8;0;0;0;0;.00nan;0;0
16;25843;21;83;24;1;23;.958;3600000;0
17;335;18;86;49;4;45;.918;3600000;0
17;1251;14;100;22;0;22;1.000;3600000;0
17;5001;18;0;0;0;0;.00nan;0;0
17;25584;14;0;0;0;0;.00nan;0;0
18;262;35;0;0;0;0;.00nan;0;0
18;1430;35;57;33;4;29;.879;3595000;0
18;1913;30;0;0;0;0;.00nan;0;0
18;4826;30;82;30;2;28;.933;3600000;0
19;445;12;83;37;2;35;.946;3569000;0
19;4450;5;0;0;0;0;.00nan;0;0
19;19823;5;65;17;1;16;.941;3600000;0
19;34786;12;0;0;0;0;.00nan;0;0
20;5385;17;100;36;0;36;1.000;3600000;0
20;22601;26;0;0;0;0;.00nan;0;0
20;32754;26;62;20;2;18;.900;3581000;0
20;34006;17;0;0;0;0;.00nan;0;0
21;1821;3;0;0;0;0;.00nan;0;0
21;2054;3;73;32;3;29;.906;3600000;0
21;2058;28;47;35;5;30;.857;2260000;0
21;14061;28;52;9;1;8;.889;1340000;0
22;1074;0;59;47;6;41;.872;3600000;0
22;18104;10;0;0;0;0;.00nan;0;0
22;27488;10;79;23;1;22;.957;3600000;0
22;31035;0;0;0;0;0;.00nan;0;0
23;323;9;0;0;0;0;.00nan;0;0
23;335;18;0;0;0;0;.00nan;0;0
23;5001;18;66;48;6;42;.875;3600000;0
23;20853;9;65;23;2;21;.913;3600000;0
24;61;31;0;0;0;0;.00nan;0;0
24;18078;20;100;33;2;31;.939;3900000;0
24;32146;20;0;0;0;0;.00nan;0;0
24;34797;31;60;27;2;25;.926;3900000;0
25;2423;15;0;0;0;0;.00nan;0;0
25;4106;15;51;30;4;26;.867;3600000;0
25;15505;8;0;0;0;0;.00nan;0;0
25;25076;8;86;16;0;16;1.000;3600000;0
26;233;29;0;0;0;0;.00nan;0;0
26;18351;29;58;39;5;34;.872;3600000;0
26;27739;22;79;22;1;21;.955;3600000;0
26;28026;22;0;0;0;0;.00nan;0;0
27;1572;4838;0;0;0;0;.00nan;0;0
27;2328;4838;29;34;7;27;.794;3600000;0
27;13842;34;0;0;0;0;.00nan;0;0
27;15502;34;80;39;3;36;.923;3600000;0
28;10103;24;57;22;3;19;.864;3600000;0
28;13979;24;0;0;0;0;.00nan;0;0
28;15464;32;56;47;6;41;.872;3600000;0
28;16006;32;0;0;0;0;.00nan;0;0
29;1614;25;54;27;3;24;.889;3900000;0
29;1796;16;78;34;3;31;.912;3887000;0
29;5182;25;0;0;0;0;.00nan;0;0
29;15437;16;0;0;0;0;.00nan;0;0
30;544;19;0;0;0;0;.00nan;0;0
30;823;23;0;0;0;0;.00nan;0;0
30;10274;23;80;42;3;39;.929;3783000;0
30;31124;19;70;31;4;27;.871;3783000;0
31;262;35;0;0;0;0;.00nan;0;0
31;724;11;52;41;6;35;.854;3600000;0
31;1430;35;87;32;1;31;.969;3600000;0
31;21522;11;0;0;0;0;.00nan;0;0
32;738;27;66;32;3;29;.906;3561000;0
32;4506;33;74;29;2;27;.931;3600000;0
32;26623;27;0;0;0;0;.00nan;0;0
32;34740;33;0;0;0;0;.00nan;0;0
33;445;12;0;0;0;0;.00nan;0;0
33;2058;28;0;0;0;0;.00nan;0;0
33;14061;28;76;25;2;23;.920;3600000;0
33;34786;12;52;28;3;25;.893;3567000;0
34;1821;3;0;0;0;0;.00nan;0;0
34;2054;3;91;43;2;41;.953;3600000;0
34;18104;10;0;0;0;0;.00nan;0;0
34;27488;10;99;38;1;37;.974;3600000;0
35;1251;14;95;32;1;31;.969;3600000;0
35;1572;4838;0;0;0;0;.00nan;0;0
35;2328;4838;40;22;4;18;.818;3600000;0
35;25584;14;0;0;0;0;.00nan;0;0
36;544;19;100;32;0;32;1.000;3600000;0
36;1244;19;0;0;0;0;.00nan;0;0
36;1913;30;69;37;4;33;.892;3600000;0
36;4826;30;0;0;0;0;.00nan;0;0
37;1796;16;84;28;1;27;.964;3600000;0
37;15437;16;0;0;0;0;.00nan;0;0
37;22601;26;0;0;0;0;.00nan;0;0
37;32754;26;76;43;4;39;.907;3600000;0
38;335;18;71;35;3;32;.914;3900000;0
38;5001;18;0;0;0;0;.00nan;0;0
38;5385;17;79;42;3;39;.929;3900000;0
38;34006;17;0;0;0;0;.00nan;0;0
39;738;27;40;22;5;17;.773;3251000;0
39;1074;0;0;0;0;0;.00nan;0;0
39;26623;27;49;1;0;1;1.000;349000;0
39;31035;0;100;45;2;43;.956;3600000;0
40;323;9;0;0;0;0;.00nan;0;0
40;13842;34;0;0;0;0;.00nan;0;0
40;15502;34;96;34;1;33;.971;3549000;0
40;20853;9;94;24;0;24;1.000;3600000;0
41;61;31;72;31;3;28;.903;3581000;0
41;233;29;0;0;0;0;.00nan;0;0
41;18351;29;74;38;2;36;.947;3600000;0
41;34797;31;0;0;0;0;.00nan;0;0
42;51;21;0;0;0;0;.00nan;0;0
42;1572;4838;52;25;4;21;.840;3524000;0
42;2328;4838;0;0;0;0;.00nan;0;0
42;25843;21;71;28;2;26;.929;3600000;0
43;445;12;48;29;4;25;.862;3600000;0
43;2423;15;69;46;5;41;.891;3600000;0
43;4106;15;0;0;0;0;.00nan;0;0
43;34786;12;0;0;0;0;.00nan;0;0
44;1614;25;62;30;3;27;.900;3600000;0
44;5182;25;0;0;0;0;.00nan;0;0
44;27739;22;0;0;0;0;.00nan;0;0
44;28026;22;55;32;4;28;.875;3600000;0
45;15505;8;0;0;0;0;.00nan;0;0
45;18078;20;53;21;3;18;.857;3900000;0
45;25076;8;93;45;3;42;.933;3900000;0
45;32146;20;0;0;0;0;.00nan;0;0
46;724;11;0;0;0;0;.00nan;0;0
46;15464;32;0;0;0;0;.00nan;0;0
46;16006;32;64;25;2;23;.920;3600000;0
46;21522;11;77;40;3;37;.925;3545000;0
47;262;35;77;42;4;38;.905;3900000;0
47;1430;35;0;0;0;0;.00nan;0;0
47;4506;33;62;29;4;25;.862;3900000;0
47;34740;33;0;0;0;0;.00nan;0;0
48;823;23;63;16;1;15;.938;3600000;0
48;1913;30;0;0;0;0;.00nan;0;0
48;4826;30;68;41;4;37;.902;3600000;0
48;10274;23;0;0;0;0;.00nan;0;0
49;1251;14;26;7;3;4;.571;588000;0
49;4450;5;87;30;2;28;.933;3600000;0
49;19823;5;0;0;0;0;.00nan;0;0
49;25584;14;71;34;2;32;.941;3012000;0
50;500;4182;75;43;4;39;.907;3600000;0
50;1796;16;55;44;6;38;.864;3359000;0
50;15437;16;50;1;0;1;1.000;170000;0
50;25521;4182;0;0;0;0;.00nan;0;0
51;1074;0;65;42;4;38;.905;3600000;0
51;10103;24;0;0;0;0;.00nan;0;0
51;13979;24;78;9;0;9;1.000;3600000;0
51;31035;0;0;0;0;0;.00nan;0;0
52;738;27;89;33;1;32;.970;3600000;0
52;2058;28;79;25;2;23;.920;3547000;0
52;14061;28;0;0;0;0;.00nan;0;0
52;26623;27;0;0;0;0;.00nan;0;0
53;323;9;0;0;0;0;.00nan;0;0
53;544;19;100;26;0;26;1.000;3600000;0
53;1244;19;0;0;0;0;.00nan;0;0
53;20853;9;81;40;3;37;.925;3600000;0
54;61;31;55;4;0;4;1.000;678000;0
54;1614;25;62;24;3;21;.875;3600000;0
54;5182;25;0;0;0;0;.00nan;0;0
54;34797;31;43;40;6;34;.850;2922000;0
55;51;21;0;0;0;0;.00nan;0;0
55;25843;21;51;25;3;22;.880;3544000;0
55;27739;22;83;37;2;35;.946;3600000;0
55;28026;22;0;0;0;0;.00nan;0;0
56;13842;34;0;0;0;0;.00nan;0;0
56;15502;34;61;41;6;35;.854;3600000;0
56;18078;20;68;16;1;15;.938;3600000;0
56;32146;20;0;0;0;0;.00nan;0;0
57;335;18;0;0;0;0;.00nan;0;0
57;5001;18;98;37;1;36;.973;3600000;0
57;15505;8;47;32;5;27;.844;3600000;0
57;25076;8;0;0;0;0;.00nan;0;0
58;15464;32;69;34;3;31;.912;3600000;0
58;16006;32;0;0;0;0;.00nan;0;0
58;18104;10;0;0;0;0;.00nan;0;0
58;27488;10;68;38;4;34;.895;3548000;0
59;1913;30;71;45;5;40;.889;3600000;0
59;4506;33;83;20;1;19;.950;3600000;0
59;4826;30;0;0;0;0;.00nan;0;0
59;34740;33;0;0;0;0;.00nan;0;0
60;823;23;0;0;0;0;.00nan;0;0
60;10274;23;39;23;5;18;.783;3573000;0
60;22601;26;78;39;4;35;.897;3600000;0
60;32754;26;0;0;0;0;.00nan;0;0
61;4450;5;55;16;2;14;.875;3600000;0
61;5385;17;69;47;5;42;.894;3600000;0
61;19823;5;0;0;0;0;.00nan;0;0
61;34006;17;0;0;0;0;.00nan;0;0
62;738;27;0;0;0;0;.00nan;0;0
62;1821;3;0;0;0;0;.00nan;0;0
62;2054;3;75;26;2;24;.923;3600000;0
62;26623;27;29;28;5;23;.821;3600000;0
63;445;12;0;0;0;0;.00nan;0;0
63;724;11;0;0;0;0;.00nan;0;0
63;21522;11;76;31;2;29;.935;3572000;0
63;34786;12;78;24;1;23;.958;3600000;0
64;500;4182;0;0;0;0;.00nan;0;0
64;823;23;84;37;3;34;.919;3560000;0
64;10274;23;0;0;0;0;.00nan;0;0
64;25521;4182;65;30;2;28;.933;3600000;0
65;323;9;56;27;3;24;.889;3600000;0
65;1074;0;62;31;4;27;.871;3600000;0
65;20853;9;0;0;0;0;.00nan;0;0
65;31035;0;0;0;0;0;.00nan;0;0
66;2058;28;41;26;4;22;.846;3600000;0
66;14061;28;0;0;0;0;.00nan;0;0
66;18104;10;0;0;0;0;.00nan;0;0
66;27488;10;96;30;1;29;.967;3600000;0
67;233;29;0;0;0;0;.00nan;0;0
67;1614;25;79;30;2;28;.933;3600000;0
67;5182;25;0;0;0;0;.00nan;0;0
67;18351;29;71;36;3;33;.917;3580000;0
68;51;21;65;21;2;19;.905;3600000;0
68;5385;17;0;0;0;0;.00nan;0;0
68;25843;21;0;0;0;0;.00nan;0;0
68;34006;17;61;35;4;31;.886;3584000;0
69;61;31;0;0;0;0;.00nan;0;0
69;1251;14;49;36;6;30;.833;2611000;0
69;25584;14;53;2;0;2;1.000;989000;0
69;34797;31;37;37;7;30;.811;3575000;0
70;1821;3;67;32;3;29;.906;3607000;0
70;2054;3;0;0;0;0;.00nan;0;0
70;2423;15;62;30;4;26;.867;3607000;0
70;4106;15;0;0;0;0;.00nan;0;0
71;544;19;100;40;0;40;1.000;3600000;0
71;27739;22;79;36;3;33;.917;3600000;0
71;28026;22;0;0;0;0;.00nan;0;0
71;31124;19;0;0;0;0;.00nan;0;0
72;10103;24;0;0;0;0;.00nan;0;0
72;13842;34;100;40;1;39;.975;3600000;0
72;13979;24;61;23;3;20;.870;3549000;0
72;15502;34;0;0;0;0;.00nan;0;0
73;724;11;88;36;1;35;.972;3574000;0
73;1796;16;0;0;0;0;.00nan;0;0
73;15437;16;80;13;0;13;1.000;3600000;0
73;21522;11;0;0;0;0;.00nan;0;0
74;262;35;0;0;0;0;.00nan;0;0
74;1430;35;73;37;3;34;.919;3600000;0
74;1913;30;0;0;0;0;.00nan;0;0
74;4826;30;81;57;5;52;.912;3576000;0
75;4506;33;83;26;1;25;.962;3600000;0
75;15464;32;0;0;0;0;.00nan;0;0
75;16006;32;77;35;3;32;.914;3594000;0
75;34740;33;0;0;0;0;.00nan;0;0
76;18078;20;57;22;2;20;.909;3583000;0
76;22601;26;0;0;0;0;.00nan;0;0
76;32146;20;0;0;0;0;.00nan;0;0
76;32754;26;89;33;1;32;.970;3600000;0
77;335;18;81;31;2;29;.935;3600000;0
77;1572;4838;0;0;0;0;.00nan;0;0
77;2328;4838;91;41;1;40;.976;3600000;0
77;5001;18;0;0;0;0;.00nan;0;0
78;738;27;91;46;3;43;.935;3564000;0
78;4450;5;72;17;1;16;.941;3600000;0
78;19823;5;0;0;0;0;.00nan;0;0
78;26623;27;0;0;0;0;.00nan;0;0
79;323;9;0;0;0;0;.00nan;0;0
79;15505;8;61;35;4;31;.886;3562000;0
79;20853;9;54;22;3;19;.864;3600000;0
79;25076;8;0;0;0;0;.00nan;0;0
80;262;35;71;44;5;39;.886;3533000;0
80;1430;35;0;0;0;0;.00nan;0;0
80;15464;32;0;0;0;0;.00nan;0;0
80;16006;32;83;35;3;32;.914;3600000;0
81;500;4182;80;36;3;33;.917;3733000;0
81;18078;20;0;0;0;0;.00nan;0;0
81;25521;4182;0;0;0;0;.00nan;0;0
81;32146;20;58;29;4;25;.862;3733000;0
82;233;29;0;0;0;0;.00nan;0;0
82;5385;17;87;54;5;49;.907;3571000;0
82;18351;29;70;28;3;25;.893;3600000;0
82;34006;17;0;0;0;0;.00nan;0;0
83;2058;28;52;25;3;22;.880;3600000;0
83;14061;28;0;0;0;0;.00nan;0;0
83;27739;22;0;0;0;0;.00nan;0;0
83;28026;22;59;33;4;29;.879;3600000;0
84;61;31;85;26;1;25;.962;3600000;0
84;22601;26;94;38;2;36;.947;3600000;0
84;32754;26;0;0;0;0;.00nan;0;0
84;34797;31;0;0;0;0;.00nan;0;0
85;544;19;78;27;2;25;.926;3600000;0
85;18104;10;0;0;0;0;.00nan;0;0
85;27488;10;92;28;1;27;.964;3600000;0
85;31124;19;0;0;0;0;.00nan;0;0
86;1821;3;79;27;1;26;.963;3055000;0
86;2054;3;36;12;3;9;.750;491000;0
86;10103;24;0;0;0;0;.00nan;0;0
86;13979;24;68;33;3;30;.909;3600000;0
87;445;12;61;16;2;14;.875;3600000;0
87;13842;34;0;0;0;0;.00nan;0;0
87;15502;34;51;53;8;45;.849;3600000;0
87;34786;12;0;0;0;0;.00nan;0;0
88;724;11;0;0;0;0;.00nan;0;0
88;1796;16;0;0;0;0;.00nan;0;0
88;15437;16;82;24;1;23;.958;3600000;0
88;21522;11;52;30;4;26;.867;3600000;0
89;51;21;0;0;0;0;.00nan;0;0
89;544;19;0;0;0;0;.00nan;0;0
89;25843;21;37;42;7;35;.833;3600000;0
89;31124;19;40;20;4;16;.800;3600000;0
90;233;29;74;21;1;20;.952;3600000;0
90;2423;15;86;35;2;33;.943;3589000;0
90;4106;15;0;0;0;0;.00nan;0;0
90;18351;29;0;0;0;0;.00nan;0;0
91;738;27;72;32;2;30;.938;3900000;0
91;15464;32;87;37;2;35;.946;3900000;0
91;16006;32;0;0;0;0;.00nan;0;0
91;26623;27;0;0;0;0;.00nan;0;0
92;500;4182;82;23;1;22;.957;3628000;0
92;1614;25;100;35;0;35;1.000;3628000;0
92;5182;25;0;0;0;0;.00nan;0;0
92;25521;4182;0;0;0;0;.00nan;0;0
93;262;35;0;0;0;0;.00nan;0;0
93;335;18;0;0;0;0;.00nan;0;0
93;1430;35;97;37;1;36;.973;3600000;0
93;5001;18;57;28;3;25;.893;3513000;0
94;1913;30;96;42;2;40;.952;3600000;0
94;4506;33;42;29;5;24;.828;3600000;0
94;4826;30;0;0;0;0;.00nan;0;0
94;34740;33;0;0;0;0;.00nan;0;0
95;1074;0;81;39;3;36;.923;3600000;0
95;1572;4838;0;0;0;0;.00nan;0;0
95;2328;4838;100;33;0;33;1.000;3600000;0
95;31035;0;0;0;0;0;.00nan;0;0
96;61;31;30;44;8;36;.818;2997000;0
96;4450;5;0;0;0;0;.00nan;0;0
96;19823;5;71;28;2;26;.929;3600000;0
96;34797;31;46;7;1;6;.857;603000;0
97;323;9;23;25;6;19;.760;2672000;0
97;20853;9;64;10;0;10;1.000;928000;0
97;27739;22;99;36;1;35;.972;3600000;0
97;28026;22;0;0;0;0;.00nan;0;0
98;1821;3;0;0;0;0;.00nan;0;0
98;2054;3;78;37;3;34;.919;3600000;0
98;15505;8;54;36;5;31;.861;3546000;0
98;25076;8;0;0;0;0;.00nan;0;0
99;445;12;0;0;0;0;.00nan;0;0
99;500;4182;38;39;7;32;.821;3600000;0
99;25521;4182;0;0;0;0;.00nan;0;0
99;34786;12;56;29;4;25;.862;3600000;0
100;823;23;0;0;0;0;.00nan;0;0
100;1251;14;72;53;6;47;.887;3104000;0
100;10274;23;73;33;4;29;.879;3600000;0
100;25584;14;46;6;1;5;.833;496000;0
101;233;29;0;0;0;0;.00nan;0;0
101;18351;29;43;20;4;16;.800;3525000;0
101;22601;26;0;0;0;0;.00nan;0;0
101;32754;26;93;39;2;37;.949;3600000;0
102;544;19;65;33;4;29;.879;3600000;0
102;2423;15;8;24;7;17;.708;3600000;0
102;4106;15;0;0;0;0;.00nan;0;0
102;31124;19;0;0;0;0;.00nan;0;0
103;4450;5;91;22;0;22;1.000;3600000;0
103;10103;24;0;0;0;0;.00nan;0;0
103;13979;24;83;45;3;42;.933;3600000;0
103;19823;5;0;0;0;0;.00nan;0;0
104;1614;25;61;31;4;27;.871;3559000;0
104;1796;16;75;36;3;33;.917;3600000;0
104;5182;25;0;0;0;0;.00nan;0;0
104;15437;16;0;0;0;0;.00nan;0;0
105;335;18;42;31;5;26;.839;3600000;0
105;1251;14;0;0;0;0;.00nan;0;0
105;5001;18;0;0;0;0;.00nan;0;0
105;25584;14;87;38;2;36;.947;3600000;0
106;1913;30;74;23;1;22;.957;3576000;0
106;4826;30;0;0;0;0;.00nan;0;0
106;5385;17;100;32;0;32;1.000;3600000;0
106;34006;17;0;0;0;0;.00nan;0;0
107;724;11;23;24;6;18;.750;3600000;0
107;4506;33;88;28;1;27;.964;3600000;0
107;21522;11;0;0;0;0;.00nan;0;0
107;34740;33;0;0;0;0;.00nan;0;0
108;738;27;99;25;0;25;1.000;3600000;0
108;1074;0;0;0;0;0;.00nan;0;0
108;26623;27;0;0;0;0;.00nan;0;0
108;31035;0;92;36;2;34;.944;3584000;0
109;262;35;0;0;0;0;.00nan;0;0
109;1430;35;83;27;2;25;.926;3600000;0
109;1572;4838;0;0;0;0;.00nan;0;0
109;2328;4838;62;42;5;37;.881;3600000;0
110;61;31;68;28;3;25;.893;3600000;0
110;323;9;56;33;4;29;.879;3574000;0
110;20853;9;0;0;0;0;.00nan;0;0
110;34797;31;0;0;0;0;.00nan;0;0
111;13842;34;0;0;0;0;.00nan;0;0
111;15502;34;66;46;5;41;.891;3600000;0
111;18104;10;0;0;0;0;.00nan;0;0
111;27488;10;74;20;1;19;.950;3600000;0
112;22601;26;71;32;3;29;.906;3595000;0
112;27739;22;60;14;2;12;.857;3600000;0
112;28026;22;0;0;0;0;.00nan;0;0
112;32754;26;0;0;0;0;.00nan;0;0
113;10103;24;29;8;3;5;.625;442000;0
113;13979;24;76;17;1;16;.941;3127000;0
113;15505;8;62;26;3;23;.885;3600000;0
113;25076;8;0;0;0;0;.00nan;0;0
114;445;12;51;23;3;20;.870;3564000;0
114;2058;28;0;0;0;0;.00nan;0;0
114;14061;28;86;26;1;25;.962;3600000;0
114;34786;12;0;0;0;0;.00nan;0;0
115;500;4182;0;0;0;0;.00nan;0;0
115;1913;30;0;0;0;0;.00nan;0;0
115;4826;30;96;38;2;36;.947;3900000;0
115;25521;4182;75;24;2;22;.917;3900000;0
116;61;31;0;0;0;0;.00nan;0;0
116;4450;5;47;18;3;15;.833;3633000;0
116;19823;5;0;0;0;0;.00nan;0;0
116;34797;31;92;54;4;50;.926;3633000;0
117;323;9;0;0;0;0;.00nan;0;0
117;1821;3;0;0;0;0;.00nan;0;0
117;2054;3;65;3;0;3;1.000;3600000;0
117;20853;9;63;46;6;40;.870;3600000;0
118;51;21;0;0;0;0;.00nan;0;0
118;2423;15;68;26;3;23;.885;3600000;0
118;4106;15;0;0;0;0;.00nan;0;0
118;25843;21;63;35;4;31;.886;3573000;0
119;1796;16;51;27;4;23;.852;3531000;0
119;15437;16;0;0;0;0;.00nan;0;0
119;15505;8;0;0;0;0;.00nan;0;0
119;25076;8;94;43;2;41;.953;3600000;0
120;15464;32;62;28;3;25;.893;3547000;0
120;16006;32;0;0;0;0;.00nan;0;0
120;18078;20;76;21;1;20;.952;3600000;0
120;32146;20;0;0;0;0;.00nan;0;0
121;262;35;65;10;0;10;1.000;588000;0
121;1430;35;42;38;6;32;.842;3012000;0
121;1614;25;0;0;0;0;.00nan;0;0
121;5182;25;52;15;2;13;.867;3600000;0
122;544;19;55;21;2;19;.905;3565000;0
122;1251;14;0;0;0;0;.00nan;0;0
122;25584;14;97;50;1;49;.980;3600000;0
122;31124;19;0;0;0;0;.00nan;0;0
123;335;18;77;21;1;20;.952;3600000;0
123;823;23;63;11;0;11;1.000;942000;0
123;5001;18;0;0;0;0;.00nan;0;0
123;10274;23;49;39;6;33;.846;2658000;0
124;724;11;0;0;0;0;.00nan;0;0
124;1074;0;40;2;1;1;.500;160000;0
124;21522;11;55;33;4;29;.879;3600000;0
124;31035;0;50;34;5;29;.853;3358000;0
125;738;27;60;34;4;30;.882;3600000;0
125;4506;33;78;26;1;25;.962;3600000;0
125;26623;27;0;0;0;0;.00nan;0;0
125;34740;33;0;0;0;0;.00nan;0;0
126;51;21;45;31;5;26;.839;3600000;0
126;13842;34;0;0;0;0;.00nan;0;0
126;15502;34;61;17;2;15;.882;3600000;0
126;25843;21;0;0;0;0;.00nan;0;0
127;10103;24;0;0;0;0;.00nan;0;0
127;13979;24;84;17;0;17;1.000;3600000;0
127;22601;26;97;39;2;37;.949;3600000;0
127;32754;26;0;0;0;0;.00nan;0;0
128;1074;0;60;33;4;29;.879;3600000;0
128;1913;30;94;26;1;25;.962;3600000;0
128;4826;30;0;0;0;0;.00nan;0;0
128;31035;0;0;0;0;0;.00nan;0;0
129;724;11;46;29;5;24;.828;3600000;0
129;5385;17;96;35;1;34;.971;3600000;0
129;21522;11;0;0;0;0;.00nan;0;0
129;34006;17;0;0;0;0;.00nan;0;0
130;1572;4838;94;39;2;37;.949;3162000;0
130;2328;4838;28;7;3;4;.571;438000;0
130;18104;10;0;0;0;0;.00nan;0;0
130;27488;10;45;27;4;23;.852;3600000;0
131;233;29;0;0;0;0;.00nan;0;0
131;18351;29;88;39;3;36;.923;3568000;0
131;27739;22;87;27;1;26;.963;3600000;0
131;28026;22;0;0;0;0;.00nan;0;0
132;2058;28;86;32;2;30;.938;3583000;0
132;14061;28;0;0;0;0;.00nan;0;0
132;15505;8;79;23;1;22;.957;3600000;0
132;25076;8;0;0;0;0;.00nan;0;0
133;823;23;0;0;0;0;.00nan;0;0
133;1572;4838;0;0;0;0;.00nan;0;0
133;2328;4838;57;37;4;33;.892;3600000;0
133;10274;23;100;27;0;27;1.000;3600000;0
134;500;4182;78;27;1;26;.963;3600000;0
134;1821;3;0;0;0;0;.00nan;0;0
134;2054;3;79;37;4;33;.892;3600000;0
134;25521;4182;0;0;0;0;.00nan;0;0
135;323;9;53;15;2;13;.867;2565000;0
135;1074;0;0;0;0;0;.00nan;0;0
135;20853;9;33;16;4;12;.750;1009000;0
135;31035;0;58;40;5;35;.875;3600000;0
136;1251;14;33;29;6;23;.793;3228000;0
136;22601;26;45;19;3;16;.842;1318000;0
136;25584;14;52;1;0;1;1.000;372000;0
136;32754;26;56;29;4;25;.862;2246000;0
137;262;35;47;35;5;30;.857;3600000;0
137;1430;35;0;0;0;0;.00nan;0;0
137;2058;28;0;0;0;0;.00nan;0;0
137;14061;28;64;20;1;19;.950;3600000;0
138;445;12;72;34;3;31;.912;3600000;0
138;4506;33;0;0;0;0;.00nan;0;0
138;34740;33;89;17;0;17;1.000;3600000;0
138;34786;12;0;0;0;0;.00nan;0;0
139;544;19;86;16;0;16;1.000;3600000;0
139;15464;32;68;35;3;32;.914;3564000;0
139;16006;32;0;0;0;0;.00nan;0;0
139;31124;19;0;0;0;0;.00nan;0;0
140;335;18;76;27;2;25;.926;3600000;0
140;5001;18;0;0;0;0;.00nan;0;0
140;18104;10;0;0;0;0;.00nan;0;0
140;27488;10;64;31;4;27;.871;3583000;0
141;51;21;0;0;0;0;.00nan;0;0
141;1913;30;49;27;4;23;.852;3546000;0
141;4826;30;0;0;0;0;.00nan;0;0
141;25843;21;74;36;3;33;.917;3600000;0
142;738;27;0;0;0;0;.00nan;0;0
142;5385;17;49;35;6;29;.829;3600000;0
142;26623;27;69;27;2;25;.926;3600000;0
142;34006;17;0;0;0;0;.00nan;0;0
143;10103;24;0;0;0;0;.00nan;0;0
143;13979;24;73;41;4;37;.902;3600000;0
143;15505;8;90;24;1;23;.958;3600000;0
143;25076;8;0;0;0;0;.00nan;0;0
144;1614;25;50;25;4;21;.840;3572000;0
144;5182;25;0;0;0;0;.00nan;0;0
144;13842;34;78;33;2;31;.939;3600000;0
144;15502;34;0;0;0;0;.00nan;0;0
145;823;23;0;0;0;0;.00nan;0;0
145;10274;23;100;37;1;36;.973;3600000;0
145;15464;32;0;0;0;0;.00nan;0;0
145;16006;32;67;30;3;27;.900;3573000;0
146;724;11;0;0;0;0;.00nan;0;0
146;1796;16;0;0;0;0;.00nan;0;0
146;15437;16;72;26;2;24;.923;3552000;0
146;21522;11;100;23;0;23;1.000;3600000;0
147;323;9;0;0;0;0;.00nan;0;0
147;4450;5;0;0;0;0;.00nan;0;0
147;19823;5;60;23;2;21;.913;3638000;0
147;20853;9;87;41;3;38;.927;3638000;0
148;233;29;0;0;0;0;.00nan;0;0
148;1821;3;74;21;1;20;.952;2448000;0
148;2054;3;25;9;4;5;.556;1152000;0
148;18351;29;57;17;2;15;.882;3600000;0
149;928;20;0;0;0;0;.00nan;0;0
149;1074;0;0;0;0;0;.00nan;0;0
149;18078;20;42;26;5;21;.808;3900000;0
149;31035;0;59;40;5;35;.875;3900000;0
150;500;4182;64;32;4;28;.875;3600000;0
150;2058;28;65;38;5;33;.868;3545000;0
150;14061;28;0;0;0;0;.00nan;0;0
150;25521;4182;0;0;0;0;.00nan;0;0
151;61;31;0;0;0;0;.00nan;0;0
151;27739;22;92;44;3;41;.932;3571000;0
151;28026;22;0;0;0;0;.00nan;0;0
151;34797;31;69;25;2;23;.920;3600000;0
152;1251;14;0;0;0;0;.00nan;0;0
152;2423;15;0;0;0;0;.00nan;0;0
152;4106;15;67;32;4;28;.875;3548000;0
152;25584;14;82;33;2;31;.939;3600000;0
153;445;12;93;41;2;39;.951;3569000;0
153;544;19;76;25;1;24;.960;3600000;0
153;31124;19;0;0;0;0;.00nan;0;0
153;34786;12;0;0;0;0;.00nan;0;0
154;738;27;74;39;4;35;.897;3572000;0
154;1796;16;80;30;2;28;.933;3600000;0
154;15437;16;0;0;0;0;.00nan;0;0
154;26623;27;0;0;0;0;.00nan;0;0
155;1572;4838;0;0;0;0;.00nan;0;0
155;2328;4838;65;31;3;28;.903;3600000;0
155;5385;17;100;38;0;38;1.000;3600000;0
155;34006;17;0;0;0;0;.00nan;0;0
156;4506;33;0;0;0;0;.00nan;0;0
156;15505;8;76;41;4;37;.902;3600000;0
156;25076;8;0;0;0;0;.00nan;0;0
156;34740;33;69;15;1;14;.933;3600000;0
157;823;23;0;0;0;0;.00nan;0;0
157;10274;23;52;32;5;27;.844;3546000;0
157;18104;10;0;0;0;0;.00nan;0;0
157;27488;10;64;24;3;21;.875;3600000;0
158;335;18;65;28;3;25;.893;3600000;0
158;5001;18;0;0;0;0;.00nan;0;0
158;15464;32;0;0;0;0;.00nan;0;0
158;16006;32;38;32;6;26;.813;3600000;0
159;1913;30;100;30;0;30;1.000;3600000;0
159;4826;30;0;0;0;0;.00nan;0;0
159;22601;26;69;17;1;16;.941;3556000;0
159;32754;26;0;0;0;0;.00nan;0;0
160;51;21;0;0;0;0;.00nan;0;0
160;724;11;0;0;0;0;.00nan;0;0
160;21522;11;91;28;1;27;.964;3600000;0
160;25843;21;75;51;6;45;.882;3600000;0
161;323;9;0;0;0;0;.00nan;0;0
161;5385;17;89;33;1;32;.970;3600000;0
161;20853;9;75;33;2;31;.939;3590000;0
161;34006;17;0;0;0;0;.00nan;0;0
162;1821;3;68;13;0;13;1.000;1281000;0
162;2054;3;34;23;5;18;.783;2319000;0
162;4450;5;0;0;0;0;.00nan;0;0
162;19823;5;53;16;2;14;.875;3600000;0
163;500;4182;89;30;2;28;.933;3600000;0
163;1074;0;0;0;0;0;.00nan;0;0
163;25521;4182;0;0;0;0;.00nan;0;0
163;31035;0;60;44;5;39;.886;3600000;0
164;233;29;0;0;0;0;.00nan;0;0
164;2058;28;98;51;1;50;.980;3566000;0
164;14061;28;0;0;0;0;.00nan;0;0
164;18351;29;82;12;0;12;1.000;3600000;0
165;61;31;0;0;0;0;.00nan;0;0
165;10103;24;0;0;0;0;.00nan;0;0
165;13979;24;46;25;4;21;.840;3600000;0
165;34797;31;47;31;5;26;.839;3544000;0
166;262;35;0;0;0;0;.00nan;0;0
166;1430;35;98;52;4;48;.923;3777000;0
166;2423;15;57;36;5;31;.861;3777000;0
166;4106;15;0;0;0;0;.00nan;0;0
167;1251;14;0;0;0;0;.00nan;0;0
167;25584;14;87;26;1;25;.962;3600000;0
167;27739;22;41;39;6;33;.846;2601000;0
167;28026;22;55;4;0;4;1.000;999000;0
168;1614;25;84;32;1;31;.969;3600000;0
168;5182;25;0;0;0;0;.00nan;0;0
168;13842;34;0;0;0;0;.00nan;0;0
168;15502;34;75;38;3;35;.921;3592000;0
169;928;20;0;0;0;0;.00nan;0;0
169;4506;33;85;30;1;29;.967;3600000;0
169;18078;20;39;19;4;15;.789;3600000;0
169;34740;33;0;0;0;0;.00nan;0;0
170;544;19;0;0;0;0;.00nan;0;0
170;18104;10;80;16;0;16;1.000;3600000;0
170;27488;10;0;0;0;0;.00nan;0;0
170;31124;19;91;44;4;40;.909;3600000;0
171;1572;4838;0;0;0;0;.00nan;0;0
171;2328;4838;49;27;4;23;.852;3600000;0
171;22601;26;0;0;0;0;.00nan;0;0
171;32754;26;73;22;1;21;.955;3600000;0
172;51;21;98;40;1;39;.975;3900000;0
172;738;27;0;0;0;0;.00nan;0;0
172;25843;21;0;0;0;0;.00nan;0;0
172;26623;27;73;21;1;20;.952;3900000;0
173;323;9;27;31;6;25;.806;3306000;0
173;500;4182;0;0;0;0;.00nan;0;0
173;20853;9;53;2;0;2;1.000;294000;0
173;25521;4182;68;25;2;23;.920;3600000;0
174;15464;32;77;22;1;21;.955;3626000;0
174;15505;8;66;20;2;18;.900;3626000;0
174;16006;32;0;0;0;0;.00nan;0;0
174;25076;8;0;0;0;0;.00nan;0;0
175;262;35;89;37;2;35;.946;3600000;0
175;928;20;66;31;3;28;.903;3546000;0
175;1430;35;0;0;0;0;.00nan;0;0
175;18078;20;0;0;0;0;.00nan;0;0
176;335;18;40;34;6;28;.824;3600000;0
176;445;12;0;0;0;0;.00nan;0;0
176;5001;18;0;0;0;0;.00nan;0;0
176;34786;12;70;30;2;28;.933;3600000;0
177;1796;16;90;38;2;36;.947;3600000;0
177;1913;30;84;26;1;25;.962;3600000;0
177;4826;30;0;0;0;0;.00nan;0;0
177;15437;16;0;0;0;0;.00nan;0;0
178;724;11;60;5;0;5;1.000;1027000;0
178;1821;3;0;0;0;0;.00nan;0;0
178;2054;3;93;31;1;30;.968;3600000;0
178;21522;11;16;19;6;13;.684;2573000;0
179;61;31;89;22;0;22;1.000;3600000;0
179;18104;10;95;42;2;40;.952;3582000;0
179;27488;10;0;0;0;0;.00nan;0;0
179;34797;31;0;0;0;0;.00nan;0;0
180;5385;17;65;16;1;15;.938;3600000;0
180;27739;22;79;34;3;31;.912;3545000;0
180;28026;22;0;0;0;0;.00nan;0;0
180;34006;17;0;0;0;0;.00nan;0;0
181;2058;28;44;41;6;35;.854;3019000;0
181;4450;5;49;27;4;23;.852;3600000;0
181;14061;28;56;4;0;4;1.000;533000;0
181;19823;5;0;0;0;0;.00nan;0;0
182;724;11;55;34;4;30;.882;3600000;0
182;1074;0;88;30;1;29;.967;3600000;0
182;21522;11;0;0;0;0;.00nan;0;0
182;31035;0;0;0;0;0;.00nan;0;0
183;323;9;66;35;4;31;.886;3900000;0
183;823;23;0;0;0;0;.00nan;0;0
183;10274;23;53;32;4;28;.875;3900000;0
183;20853;9;0;0;0;0;.00nan;0;0
184;233;29;0;0;0;0;.00nan;0;0
184;10103;24;0;0;0;0;.00nan;0;0
184;13979;24;57;42;6;36;.857;3600000;0
184;18351;29;72;23;2;21;.913;3600000;0
185;51;21;0;0;0;0;.00nan;0;0
185;61;31;0;0;0;0;.00nan;0;0
185;25843;21;53;33;4;29;.879;3515000;0
185;34797;31;71;28;2;26;.929;3600000;0
186;2423;15;94;50;1;49;.980;3900000;0
186;4106;15;0;0;0;0;.00nan;0;0
186;15505;8;79;22;1;21;.955;3900000;0
186;25076;8;0;0;0;0;.00nan;0;0
187;1796;16;84;23;1;22;.957;3600000;0
187;4506;33;69;38;4;34;.895;3600000;0
187;15437;16;0;0;0;0;.00nan;0;0
187;34740;33;0;0;0;0;.00nan;0;0
188;544;19;64;32;3;29;.906;3549000;0
188;738;27;92;43;2;41;.953;3600000;0
188;26623;27;0;0;0;0;.00nan;0;0
188;31124;19;0;0;0;0;.00nan;0;0
189;335;18;0;0;0;0;.00nan;0;0
189;1913;30;79;33;2;31;.939;3600000;0
189;4826;30;0;0;0;0;.00nan;0;0
189;5001;18;70;29;3;26;.897;3544000;0
190;500;4182;71;23;1;22;.957;3600000;0
190;1572;4838;0;0;0;0;.00nan;0;0
190;2328;4838;86;36;2;34;.944;3559000;0
190;25521;4182;0;0;0;0;.00nan;0;0
191;1251;14;0;0;0;0;.00nan;0;0
191;1821;3;48;0;0;0;.00nan;241000;0
191;2054;3;26;33;7;26;.788;3359000;0
191;25584;14;87;26;1;25;.962;3600000;0
192;445;12;0;0;0;0;.00nan;0;0
192;15464;32;86;33;2;31;.939;3600000;0
192;16006;32;0;0;0;0;.00nan;0;0
192;34786;12;81;29;1;28;.966;3600000;0
193;262;35;0;0;0;0;.00nan;0;0
193;1430;35;83;36;3;33;.917;3600000;0
193;22601;26;41;31;6;25;.806;3127000;0
193;32754;26;55;6;0;6;1.000;473000;0
194;823;23;0;0;0;0;.00nan;0;0
194;4450;5;100;30;0;30;1.000;3600000;0
194;10274;23;58;51;6;45;.882;3600000;0
194;19823;5;0;0;0;0;.00nan;0;0
195;544;19;77;24;2;22;.917;3600000;0
195;1074;0;60;30;4;26;.867;3516000;0
195;31035;0;0;0;0;0;.00nan;0;0
195;31124;19;0;0;0;0;.00nan;0;0
196;724;11;0;0;0;0;.00nan;0;0
196;2058;28;70;38;4;34;.895;3600000;0
196;14061;28;0;0;0;0;.00nan;0;0
196;21522;11;100;38;1;37;.974;3600000;0
197;323;9;0;0;0;0;.00nan;0;0
197;20853;9;90;38;2;36;.947;3600000;0
197;27739;22;65;32;3;29;.906;3547000;0
197;28026;22;0;0;0;0;.00nan;0;0
198;51;21;0;0;0;0;.00nan;0;0
198;928;20;0;0;0;0;.00nan;0;0
198;18078;20;85;25;1;24;.960;3600000;0
198;25843;21;29;35;7;28;.800;3600000;0
199;61;31;56;18;3;15;.833;3005000;0
199;2423;15;88;28;1;27;.964;3600000;0
199;4106;15;0;0;0;0;.00nan;0;0
199;34797;31;22;4;3;1;.250;595000;0
200;1796;16;76;10;0;10;1.000;3600000;0
200;15437;16;0;0;0;0;.00nan;0;0
200;15464;32;0;0;0;0;.00nan;0;0
200;16006;32;70;37;4;33;.892;3600000;0
201;738;27;52;31;4;27;.871;3580000;0
201;4506;33;72;25;2;23;.920;3600000;0
201;26623;27;0;0;0;0;.00nan;0;0
201;34740;33;0;0;0;0;.00nan;0;0
202;335;18;0;0;0;0;.00nan;0;0
202;1614;25;78;22;1;21;.955;3600000;0
202;5001;18;67;42;4;38;.905;3600000;0
202;5182;25;0;0;0;0;.00nan;0;0
203;262;35;71;33;3;30;.909;3600000;0
203;500;4182;81;32;2;30;.938;3600000;0
203;1430;35;0;0;0;0;.00nan;0;0
203;25521;4182;0;0;0;0;.00nan;0;0
204;1572;4838;96;33;1;32;.970;3600000;0
204;1913;30;69;29;2;27;.931;3546000;0
204;2328;4838;0;0;0;0;.00nan;0;0
204;4826;30;0;0;0;0;.00nan;0;0
205;823;23;0;0;0;0;.00nan;0;0
205;5385;17;0;0;0;0;.00nan;0;0
205;10274;23;47;26;4;22;.846;3523000;0
205;34006;17;97;37;2;35;.946;3600000;0
206;544;19;0;0;0;0;.00nan;0;0
206;1821;3;0;0;0;0;.00nan;0;0
206;2054;3;100;36;0;36;1.000;3600000;0
206;31124;19;54;25;3;22;.880;3600000;0
207;1251;14;0;0;0;0;.00nan;0;0
207;10103;24;0;0;0;0;.00nan;0;0
207;13979;24;73;32;3;29;.906;3600000;0
207;25584;14;86;43;4;39;.907;3585000;0
208;13842;34;56;31;4;27;.871;3554000;0
208;15502;34;0;0;0;0;.00nan;0;0
208;27739;22;0;0;0;0;.00nan;0;0
208;28026;22;74;42;3;39;.929;3600000;0
209;15505;8;78;34;3;31;.912;3554000;0
209;22601;26;77;27;2;25;.926;3600000;0
209;25076;8;0;0;0;0;.00nan;0;0
209;32754;26;0;0;0;0;.00nan;0;0
210;1821;3;0;0;0;0;.00nan;0;0
210;2054;3;68;22;2;20;.909;3567000;0
210;5385;17;100;36;1;35;.972;3600000;0
210;34006;17;0;0;0;0;.00nan;0;0
211;2058;28;0;0;0;0;.00nan;0;0
211;2423;15;0;0;0;0;.00nan;0;0
211;4106;15;93;17;0;17;1.000;3600000;0
211;14061;28;74;32;3;29;.906;3600000;0
212;323;9;0;0;0;0;.00nan;0;0
212;1074;0;0;0;0;0;.00nan;0;0
212;20853;9;69;30;2;28;.933;3600000;0
212;31035;0;96;33;1;32;.970;3600000;0
213;61;31;96;31;1;30;.968;3600000;0
213;233;29;0;0;0;0;.00nan;0;0
213;18351;29;69;36;3;33;.917;3544000;0
213;34797;31;0;0;0;0;.00nan;0;0
214;51;21;94;34;2;32;.941;3634000;0
214;4450;5;77;25;1;24;.960;3634000;0
214;19823;5;0;0;0;0;.00nan;0;0
214;25843;21;0;0;0;0;.00nan;0;0
215;1796;16;54;30;3;27;.900;3900000;0
215;10103;24;100;49;3;46;.939;3900000;0
215;13979;24;0;0;0;0;.00nan;0;0
215;15437;16;0;0;0;0;.00nan;0;0
216;13842;34;0;0;0;0;.00nan;0;0
216;15502;34;85;50;4;46;.920;3596000;0
216;18104;10;0;0;0;0;.00nan;0;0
216;27488;10;71;31;3;28;.903;3600000;0
217;15464;32;0;0;0;0;.00nan;0;0
217;16006;32;100;28;0;28;1.000;3600000;0
217;22601;26;0;0;0;0;.00nan;0;0
217;32754;26;76;44;4;40;.909;3600000;0
218;445;12;98;50;3;47;.940;3600000;0
218;1251;14;100;29;0;29;1.000;3600000;0
218;25584;14;0;0;0;0;.00nan;0;0
218;34786;12;0;0;0;0;.00nan;0;0
219;724;11;74;29;3;26;.897;3600000;0
219;4506;33;100;36;0;36;1.000;3600000;0
219;21522;11;0;0;0;0;.00nan;0;0
219;34740;33;0;0;0;0;.00nan;0;0
220;738;27;63;38;4;34;.895;3530000;0
220;1614;25;81;38;2;36;.947;3600000;0
220;5182;25;0;0;0;0;.00nan;0;0
220;26623;27;0;0;0;0;.00nan;0;0
221;335;18;0;0;0;0;.00nan;0;0
221;500;4182;79;36;3;33;.917;3592000;0
221;5001;18;88;39;2;37;.949;3600000;0
221;25521;4182;0;0;0;0;.00nan;0;0
222;262;35;0;0;0;0;.00nan;0;0
222;1430;35;90;37;2;35;.946;3715000;0
222;1572;4838;72;31;3;28;.903;3715000;0
222;2328;4838;0;0;0;0;.00nan;0;0
223;1074;0;18;21;6;15;.714;2397000;0
223;4450;5;0;0;0;0;.00nan;0;0
223;19823;5;73;33;3;30;.909;3600000;0
223;31035;0;60;16;1;15;.938;1203000;0
224;544;19;76;24;1;23;.958;3600000;0
224;2058;28;98;48;2;46;.958;3543000;0
224;14061;28;0;0;0;0;.00nan;0;0
224;31124;19;0;0;0;0;.00nan;0;0
225;51;21;0;0;0;0;.00nan;0;0
225;18104;10;67;34;3;31;.912;3900000;0
225;25843;21;41;25;3;22;.880;3900000;0
225;27488;10;0;0;0;0;.00nan;0;0
226;2423;15;0;0;0;0;.00nan;0;0
226;4106;15;92;42;2;40;.952;3600000;0
226;27739;22;49;9;1;8;.889;1434000;0
226;28026;22;30;22;5;17;.773;2166000;0
227;823;23;0;0;0;0;.00nan;0;0
227;1796;16;0;0;0;0;.00nan;0;0
227;10274;23;100;50;3;47;.940;3600000;0
227;15437;16;57;32;4;28;.875;3600000;0
228;335;18;79;34;3;31;.912;3600000;0
228;1913;30;76;41;4;37;.902;3546000;0
228;4826;30;0;0;0;0;.00nan;0;0
228;5001;18;0;0;0;0;.00nan;0;0
229;233;29;0;0;0;0;.00nan;0;0
229;928;20;0;0;0;0;.00nan;0;0
229;18078;20;58;41;5;36;.878;3585000;0
229;18351;29;47;22;4;18;.818;3600000;0
230;323;9;0;0;0;0;.00nan;0;0
230;13842;34;0;0;0;0;.00nan;0;0
230;15502;34;37;33;5;28;.848;3600000;0
230;20853;9;83;41;2;39;.951;3600000;0
231;1821;3;0;0;0;0;.00nan;0;0
231;2054;3;72;19;1;18;.947;3600000;0
231;15464;32;40;2;1;1;.500;268000;0
231;16006;32;47;34;6;28;.824;3332000;0
232;61;31;99;46;3;43;.935;3900000;0
232;928;20;62;36;3;33;.917;3900000;0
232;18078;20;0;0;0;0;.00nan;0;0
232;34797;31;0;0;0;0;.00nan;0;0
233;51;21;0;0;0;0;.00nan;0;0
233;2058;28;66;49;5;44;.898;3600000;0
233;14061;28;0;0;0;0;.00nan;0;0
233;25843;21;67;25;2;23;.920;3600000;0
234;1074;0;0;0;0;0;.00nan;0;0
234;18104;10;81;30;2;28;.933;3600000;0
234;27488;10;0;0;0;0;.00nan;0;0
234;31035;0;60;28;3;25;.893;3560000;0
235;544;19;0;0;0;0;.00nan;0;0
235;1251;14;84;28;1;27;.964;3600000;0
235;25584;14;0;0;0;0;.00nan;0;0
235;31124;19;35;25;5;20;.800;3600000;0
236;2423;15;58;25;3;22;.880;3600000;0
236;4106;15;0;0;0;0;.00nan;0;0
236;5385;17;39;40;7;33;.825;3600000;0
236;34006;17;0;0;0;0;.00nan;0;0
237;1796;16;80;22;1;21;.955;3600000;0
237;15437;16;0;0;0;0;.00nan;0;0
237;22601;26;58;39;5;34;.872;3600000;0
237;32754;26;0;0;0;0;.00nan;0;0
238;323;9;25;31;6;25;.806;3600000;0
238;445;12;60;26;3;23;.885;3600000;0
238;20853;9;0;0;0;0;.00nan;0;0
238;34786;12;0;0;0;0;.00nan;0;0
239;262;35;0;0;0;0;.00nan;0;0
239;738;27;0;0;0;0;.00nan;0;0
239;1430;35;90;34;2;32;.941;3600000;0
239;26623;27;35;23;4;19;.826;3570000;0
240;823;23;0;0;0;0;.00nan;0;0
240;4506;33;76;20;1;19;.950;3600000;0
240;10274;23;39;22;4;18;.818;3600000;0
240;34740;33;0;0;0;0;.00nan;0;0
241;500;4182;100;25;0;25;1.000;3600000;0
241;10103;24;60;27;3;24;.889;3600000;0
241;13979;24;0;0;0;0;.00nan;0;0
241;25521;4182;0;0;0;0;.00nan;0;0
242;1913;30;86;46;4;42;.913;3598000;0
242;4826;30;0;0;0;0;.00nan;0;0
242;27739;22;0;0;0;0;.00nan;0;0
242;28026;22;100;45;2;43;.956;3600000;0
243;335;18;0;0;0;0;.00nan;0;0
243;1614;25;89;27;1;26;.963;3900000;0
243;5001;18;85;30;1;29;.967;3900000;0
243;5182;25;0;0;0;0;.00nan;0;0
244;724;11;0;0;0;0;.00nan;0;0
244;21522;11;74;35;3;32;.914;3600000;0
244;27739;22;37;23;5;18;.783;3551000;0
244;28026;22;0;0;0;0;.00nan;0;0
245;1572;4838;62;26;3;23;.885;3900000;0
245;2328;4838;0;0;0;0;.00nan;0;0
245;15505;8;55;30;3;27;.900;3900000;0
245;25076;8;0;0;0;0;.00nan;0;0
246;544;19;81;16;0;16;1.000;3600000;0
246;5385;17;97;44;2;42;.955;3580000;0
246;31124;19;0;0;0;0;.00nan;0;0
246;34006;17;0;0;0;0;.00nan;0;0
247;1821;3;0;0;0;0;.00nan;0;0
247;2054;3;62;17;2;15;.882;3600000;0
247;18104;10;0;0;0;0;.00nan;0;0
247;27488;10;65;44;5;39;.886;3600000;0
248;1074;0;0;0;0;0;.00nan;0;0
248;2423;15;0;0;0;0;.00nan;0;0
248;4106;15;89;35;1;34;.971;3900000;0
248;31035;0;86;35;1;34;.971;3900000;0
249;2058;28;84;38;3;35;.921;3900000;0
249;14061;28;0;0;0;0;.00nan;0;0
249;15464;32;63;28;3;25;.893;3900000;0
249;16006;32;0;0;0;0;.00nan;0;0
250;51;21;0;0;0;0;.00nan;0;0
250;61;31;60;35;5;30;.857;3600000;0
250;25843;21;100;48;1;47;.979;3600000;0
250;34797;31;0;0;0;0;.00nan;0;0
251;233;29;0;0;0;0;.00nan;0;0
251;1251;14;0;0;0;0;.00nan;0;0
251;18351;29;94;37;3;34;.919;3900000;0
251;25584;14;89;32;3;29;.906;3900000;0
252;738;27;45;32;5;27;.844;3544000;0
252;1796;16;58;30;4;26;.867;3600000;0
252;15437;16;0;0;0;0;.00nan;0;0
252;26623;27;0;0;0;0;.00nan;0;0
253;262;35;0;0;0;0;.00nan;0;0
253;376;12;69;10;0;10;1.000;1126000;0
253;1430;35;33;28;5;23;.821;3600000;0
253;34786;12;18;24;6;18;.750;2456000;0
254;823;23;64;36;4;32;.889;3600000;0
254;4506;33;78;26;1;25;.962;3600000;0
254;10274;23;0;0;0;0;.00nan;0;0
254;34740;33;0;0;0;0;.00nan;0;0
255;13842;34;0;0;0;0;.00nan;0;0
255;15502;34;75;37;3;34;.919;3600000;0
255;22601;26;86;29;1;28;.966;3600000;0
255;32754;26;0;0;0;0;.00nan;0;0
256;323;9;98;52;3;49;.942;3580000;0
256;500;4182;73;21;1;20;.952;3600000;0
256;20853;9;0;0;0;0;.00nan;0;0
256;25521;4182;0;0;0;0;.00nan;0;0
257;1913;30;83;52;5;47;.904;3600000;0
257;4826;30;0;0;0;0;.00nan;0;0
257;10103;24;0;0;0;0;.00nan;0;0
257;13979;24;86;33;2;31;.939;3600000;0
258;335;18;0;0;0;0;.00nan;0;0
258;4506;33;52;7;1;6;.857;1323000;0
258;5001;18;59;27;4;23;.852;3600000;0
258;34740;33;36;26;5;21;.808;2224000;0
259;1572;4838;0;0;0;0;.00nan;0;0
259;1614;25;71;29;2;27;.931;3600000;0
259;2328;4838;77;44;4;40;.909;3579000;0
259;5182;25;0;0;0;0;.00nan;0;0
260;1821;3;74;41;4;37;.902;3542000;0
260;2054;3;0;0;0;0;.00nan;0;0
260;2423;15;0;0;0;0;.00nan;0;0
260;4106;15;91;31;2;29;.935;3600000;0
261;1074;0;73;52;5;47;.904;3600000;0
261;15464;32;62;15;1;14;.933;3600000;0
261;16006;32;0;0;0;0;.00nan;0;0
261;31035;0;0;0;0;0;.00nan;0;0
262;2058;28;100;40;2;38;.950;3600000;0
262;14061;28;0;0;0;0;.00nan;0;0
262;18104;10;0;0;0;0;.00nan;0;0
262;27488;10;36;16;3;13;.813;3565000;0
263;51;21;0;0;0;0;.00nan;0;0
263;233;29;0;0;0;0;.00nan;0;0
263;18351;29;78;35;3;32;.914;3600000;0
263;25843;21;49;34;5;29;.853;3555000;0
264;61;31;0;0;0;0;.00nan;0;0
264;262;35;0;0;0;0;.00nan;0;0
264;1430;35;75;39;3;36;.923;3600000;0
264;34797;31;100;28;0;28;1.000;3600000;0
265;544;19;84;37;2;35;.946;3900000;0
265;928;20;0;0;0;0;.00nan;0;0
265;18078;20;78;26;2;24;.923;3900000;0
265;31124;19;0;0;0;0;.00nan;0;0
266;1251;14;48;16;3;13;.813;1222000;0
266;4450;5;0;0;0;0;.00nan;0;0
266;19823;5;90;24;1;23;.958;3600000;0
266;25584;14;36;29;6;23;.793;2378000;0
267;376;12;97;37;2;35;.946;3600000;0
267;1796;16;0;0;0;0;.00nan;0;0
267;15437;16;59;32;4;28;.875;3563000;0
267;34786;12;0;0;0;0;.00nan;0;0
268;823;23;0;0;0;0;.00nan;0;0
268;10274;23;67;32;3;29;.906;3600000;0
268;15505;8;0;0;0;0;.00nan;0;0
268;25076;8;44;35;6;29;.829;3600000;0
269;323;9;0;0;0;0;.00nan;0;0
269;20853;9;59;17;1;16;.941;3636000;0
269;22601;26;0;0;0;0;.00nan;0;0
269;32754;26;76;28;2;26;.929;3636000;0
270;500;4182;64;39;5;34;.872;3546000;0
270;13842;34;0;0;0;0;.00nan;0;0
270;15502;34;84;50;4;46;.920;3600000;0
270;25521;4182;0;0;0;0;.00nan;0;0
271;724;11;85;28;1;27;.964;3600000;0
271;10103;24;64;27;2;25;.926;3600000;0
271;13979;24;0;0;0;0;.00nan;0;0
271;21522;11;0;0;0;0;.00nan;0;0
272;738;27;99;31;2;29;.935;3900000;0
272;26623;27;0;0;0;0;.00nan;0;0
272;27739;22;90;40;2;38;.950;3900000;0
272;28026;22;0;0;0;0;.00nan;0;0
273;544;19;0;0;0;0;.00nan;0;0
273;4450;5;63;22;2;20;.909;3600000;0
273;19823;5;0;0;0;0;.00nan;0;0
273;31124;19;52;31;4;27;.871;3576000;0
274;233;29;33;26;5;21;.808;3600000;0
274;262;35;0;0;0;0;.00nan;0;0
274;1430;35;72;25;2;23;.920;3600000;0
274;18351;29;0;0;0;0;.00nan;0;0
275;928;20;79;32;2;30;.938;3900000;0
275;1821;3;0;0;0;0;.00nan;0;0
275;2054;3;99;37;2;35;.946;3900000;0
275;18078;20;0;0;0;0;.00nan;0;0
276;5385;17;84;25;1;24;.960;3600000;0
276;18104;10;57;28;3;25;.893;3600000;0
276;27488;10;0;0;0;0;.00nan;0;0
276;34006;17;0;0;0;0;.00nan;0;0
277;335;18;0;0;0;0;.00nan;0;0
277;5001;18;69;36;3;33;.917;3600000;0
277;15505;8;95;39;2;37;.949;3600000;0
277;25076;8;0;0;0;0;.00nan;0;0
278;724;11;0;0;0;0;.00nan;0;0
278;21522;11;70;38;4;34;.895;3554000;0
278;22601;26;70;30;3;27;.900;3600000;0
278;32754;26;0;0;0;0;.00nan;0;0
279;1572;4838;86;21;0;21;1.000;3600000;0
279;2328;4838;0;0;0;0;.00nan;0;0
279;27739;22;0;0;0;0;.00nan;0;0
279;28026;22;71;35;2;33;.943;3574000;0
280;5385;17;0;0;0;0;.00nan;0;0
280;13842;34;0;0;0;0;.00nan;0;0
280;15502;34;64;27;3;24;.889;3566000;0
280;34006;17;71;27;2;25;.926;3600000;0
281;500;4182;82;29;2;27;.931;3600000;0
281;1796;16;63;34;4;30;.882;3600000;0
281;15437;16;0;0;0;0;.00nan;0;0
281;25521;4182;0;0;0;0;.00nan;0;0
282;1913;30;20;22;6;16;.727;2073000;0
282;4826;30;63;12;0;12;1.000;1527000;0
282;15464;32;0;0;0;0;.00nan;0;0
282;16006;32;99;24;0;24;1.000;3600000;0
283;2423;15;83;31;2;29;.935;3600000;0
283;4106;15;0;0;0;0;.00nan;0;0
283;4506;33;56;20;3;17;.850;3543000;0
283;34740;33;0;0;0;0;.00nan;0;0
284;1614;25;76;30;3;27;.900;3900000;0
284;2058;28;92;50;3;47;.940;3900000;0
284;5182;25;0;0;0;0;.00nan;0;0
284;14061;28;0;0;0;0;.00nan;0;0
285;738;27;90;24;0;24;1.000;3600000;0
285;10103;24;0;0;0;0;.00nan;0;0
285;13979;24;87;28;1;27;.964;3600000;0
285;26623;27;0;0;0;0;.00nan;0;0
286;233;29;0;0;0;0;.00nan;0;0
286;1251;14;0;0;0;0;.00nan;0;0
286;18351;29;100;35;0;35;1.000;3600000;0
286;25584;14;46;22;3;19;.864;3600000;0
287;376;12;57;25;3;22;.880;3600000;0
287;823;23;0;0;0;0;.00nan;0;0
287;10274;23;77;42;4;38;.905;3599000;0
287;34786;12;0;0;0;0;.00nan;0;0
288;544;19;57;34;4;30;.882;3600000;0
288;15505;8;77;50;5;45;.900;3583000;0
288;25076;8;0;0;0;0;.00nan;0;0
288;31124;19;0;0;0;0;.00nan;0;0
289;4450;5;58;30;4;26;.867;3600000;0
289;5385;17;100;43;1;42;.977;3600000;0
289;19823;5;0;0;0;0;.00nan;0;0
289;34006;17;0;0;0;0;.00nan;0;0
290;323;9;0;0;0;0;.00nan;0;0
290;1796;16;0;0;0;0;.00nan;0;0
290;15437;16;68;32;3;29;.906;3900000;0
290;20853;9;72;32;3;29;.906;3900000;0
291;61;31;0;0;0;0;.00nan;0;0
291;1251;14;90;35;2;33;.943;3781000;0
291;25584;14;0;0;0;0;.00nan;0;0
291;34797;31;100;31;1;30;.968;3781000;0
292;51;21;0;0;0;0;.00nan;0;0
292;262;35;0;0;0;0;.00nan;0;0
292;1430;35;78;21;2;19;.905;3600000;0
292;25843;21;66;32;3;29;.906;3542000;0
293;928;20;61;28;4;24;.857;3600000;0
293;18078;20;0;0;0;0;.00nan;0;0
293;18104;10;0;0;0;0;.00nan;0;0
293;27488;10;45;36;5;31;.861;3598000;0
294;335;18;74;34;4;30;.882;2805000;0
294;2423;15;0;0;0;0;.00nan;0;0
294;4106;15;76;43;4;39;.907;3600000;0
294;5001;18;28;17;5;12;.706;795000;0
295;1074;0;0;0;0;0;.00nan;0;0
295;27739;22;57;6;0;6;1.000;762000;0
295;28026;22;30;28;6;22;.786;2838000;0
295;31035;0;74;37;3;34;.919;3600000;0
296;4506;33;79;22;1;21;.955;3900000;0
296;13842;34;0;0;0;0;.00nan;0;0
296;15502;34;100;38;1;37;.974;3900000;0
296;34740;33;0;0;0;0;.00nan;0;0
297;500;4182;59;20;2;18;.900;3600000;0
297;15464;32;0;0;0;0;.00nan;0;0
297;16006;32;83;39;3;36;.923;3600000;0
297;25521;4182;0;0;0;0;.00nan;0;0
298;1614;25;76;16;1;15;.938;3600000;0
298;1913;30;65;39;4;35;.897;3600000;0
298;4826;30;0;0;0;0;.00nan;0;0
298;5182;25;0;0;0;0;.00nan;0;0
299;823;23;100;26;0;26;1.000;3600000;0
299;10274;23;0;0;0;0;.00nan;0;0
299;22601;26;63;48;6;42;.875;3600000;0
299;32754;26;0;0;0;0;.00nan;0;0
300;724;11;86;44;3;41;.932;3596000;0
300;1821;3;0;0;0;0;.00nan;0;0
300;2054;3;72;31;2;29;.935;3600000;0
300;21522;11;0;0;0;0;.00nan;0;0
301;738;27;69;23;1;22;.957;3544000;0
301;2058;28;100;26;0;26;1.000;3600000;0
301;14061;28;0;0;0;0;.00nan;0;0
301;26623;27;0;0;0;0;.00nan;0;0
302;1572;4838;72;40;4;36;.900;3595000;0
302;2328;4838;0;0;0;0;.00nan;0;0
302;10103;24;0;0;0;0;.00nan;0;0
302;13979;24;57;24;3;21;.875;3600000;0
303;4450;5;0;0;0;0;.00nan;0;0
303;18104;10;67;40;5;35;.875;3600000;0
303;19823;5;81;35;2;33;.943;3600000;0
303;27488;10;0;0;0;0;.00nan;0;0
304;1074;0;0;0;0;0;.00nan;0;0
304;5385;17;99;37;1;36;.973;3600000;0
304;31035;0;66;26;2;24;.923;3572000;0
304;34006;17;0;0;0;0;.00nan;0;0
305;233;29;0;0;0;0;.00nan;0;0
305;1572;4838;47;26;4;22;.846;3600000;0
305;2328;4838;0;0;0;0;.00nan;0;0
305;18351;29;100;37;1;36;.973;3600000;0
306;928;20;0;0;0;0;.00nan;0;0
306;2423;15;0;0;0;0;.00nan;0;0
306;4106;15;96;42;3;39;.929;3554000;0
306;18078;20;76;26;1;25;.962;3600000;0
307;1251;14;0;0;0;0;.00nan;0;0
307;10103;24;39;31;5;26;.839;3600000;0
307;13979;24;0;0;0;0;.00nan;0;0
307;25584;14;83;34;2;32;.941;3600000;0
308;61;31;0;0;0;0;.00nan;0;0
308;27739;22;84;39;3;36;.923;3600000;0
308;28026;22;0;0;0;0;.00nan;0;0
308;34797;31;65;42;5;37;.881;3576000;0
309;335;18;0;0;0;0;.00nan;0;0
309;5001;18;72;22;2;20;.909;3600000;0
309;13842;34;0;0;0;0;.00nan;0;0
309;15502;34;64;47;6;41;.872;3600000;0
310;1796;16;82;32;2;30;.938;3900000;0
310;15437;16;0;0;0;0;.00nan;0;0
310;15505;8;92;42;2;40;.952;3900000;0
310;25076;8;0;0;0;0;.00nan;0;0
311;51;21;75;29;3;26;.897;3191000;0
311;15464;32;0;0;0;0;.00nan;0;0
311;16006;32;74;25;2;23;.920;3600000;0
311;25843;21;31;6;3;3;.500;409000;0
312;376;12;0;0;0;0;.00nan;0;0
312;445;12;57;36;4;32;.889;3600000;0
312;1614;25;81;30;2;28;.933;3600000;0
312;5182;25;0;0;0;0;.00nan;0;0
313;262;35;0;0;0;0;.00nan;0;0
313;1430;35;66;32;3;29;.906;3600000;0
313;4506;33;100;30;0;30;1.000;3600000;0
313;34740;33;0;0;0;0;.00nan;0;0
314;1913;30;91;50;5;45;.900;3600000;0
314;2058;28;40;18;4;14;.778;3600000;0
314;4826;30;0;0;0;0;.00nan;0;0
314;14061;28;0;0;0;0;.00nan;0;0
315;738;27;74;21;1;20;.952;3600000;0
315;1821;3;0;0;0;0;.00nan;0;0
315;2054;3;86;38;3;35;.921;3577000;0
315;26623;27;0;0;0;0;.00nan;0;0
316;323;9;0;0;0;0;.00nan;0;0
316;5385;17;88;20;0;20;1.000;1405000;0
316;20853;9;56;46;6;40;.870;3900000;0
316;34006;17;14;17;6;11;.647;2495000;0
317;61;31;80;23;1;22;.957;3900000;0
317;1572;4838;0;0;0;0;.00nan;0;0
317;2328;4838;96;41;1;40;.976;3900000;0
317;34797;31;0;0;0;0;.00nan;0;0
318;1074;0;47;32;4;28;.875;3556000;0
318;2423;15;93;30;1;29;.967;3600000;0
318;4106;15;0;0;0;0;.00nan;0;0
318;31035;0;0;0;0;0;.00nan;0;0
319;1796;16;0;0;0;0;.00nan;0;0
319;13842;34;30;33;6;27;.818;3316000;0
319;15437;16;53;23;3;20;.870;3600000;0
319;15502;34;49;2;0;2;1.000;284000;0
320;1614;25;85;36;2;34;.944;3600000;0
320;5182;25;0;0;0;0;.00nan;0;0
320;15464;32;75;39;3;36;.923;3548000;0
320;16006;32;0;0;0;0;.00nan;0;0
321;544;19;49;25;4;21;.840;3560000;0
321;4506;33;95;39;2;37;.949;3600000;0
321;31124;19;0;0;0;0;.00nan;0;0
321;34740;33;0;0;0;0;.00nan;0;0
322;376;12;64;25;3;22;.880;3600000;0
322;445;12;0;0;0;0;.00nan;0;0
322;22601;26;77;49;4;45;.918;3600000;0
322;32754;26;0;0;0;0;.00nan;0;0
323;500;4182;46;17;4;13;.765;3645000;0
323;823;23;74;31;3;28;.903;3645000;0
323;10274;23;0;0;0;0;.00nan;0;0
323;25521;4182;0;0;0;0;.00nan;0;0
324;724;11;65;31;3;28;.903;3900000;0
324;2058;28;0;0;0;0;.00nan;0;0
324;14061;28;61;22;3;19;.864;3900000;0
324;21522;11;0;0;0;0;.00nan;0;0
325;335;18;0;0;0;0;.00nan;0;0
325;4450;5;0;0;0;0;.00nan;0;0
325;5001;18;100;41;0;41;1.000;3600000;0
325;19823;5;65;27;2;25;.926;3573000;0
326;51;21;0;0;0;0;.00nan;0;0
326;1251;14;0;0;0;0;.00nan;0;0
326;25584;14;79;31;2;29;.935;3600000;0
326;25843;21;79;39;3;36;.923;3543000;0
327;928;20;0;0;0;0;.00nan;0;0
327;18078;20;91;29;1;28;.966;3632000;0
327;18104;10;76;28;2;26;.929;3632000;0
327;27488;10;0;0;0;0;.00nan;0;0
328;10103;24;0;0;0;0;.00nan;0;0
328;13979;24;60;27;3;24;.889;3581000;0
328;27739;22;0;0;0;0;.00nan;0;0
328;28026;22;98;38;2;36;.947;3600000;0
329;738;27;74;46;4;42;.913;3532000;0
329;15505;8;82;32;2;30;.938;3600000;0
329;25076;8;0;0;0;0;.00nan;0;0
329;26623;27;0;0;0;0;.00nan;0;0
330;233;29;0;0;0;0;.00nan;0;0
330;262;35;53;16;2;14;.875;1472000;0
330;1430;35;63;32;4;28;.875;2128000;0
330;18351;29;58;22;3;19;.864;3600000;0
331;1821;3;52;29;4;25;.862;3544000;0
331;1913;30;63;32;3;29;.906;3600000;0
331;2054;3;0;0;0;0;.00nan;0;0
331;4826;30;0;0;0;0;.00nan;0;0
332;1572;4838;76;29;2;27;.931;3600000;0
332;2328;4838;0;0;0;0;.00nan;0;0
332;5385;17;68;35;4;31;.886;3521000;0
332;34006;17;0;0;0;0;.00nan;0;0
333;335;18;0;0;0;0;.00nan;0;0
333;1074;0;0;0;0;0;.00nan;0;0
333;5001;18;72;28;3;25;.893;3546000;0
333;31035;0;97;39;2;37;.949;3600000;0
334;4506;33;100;26;0;26;1.000;3600000;0
334;22601;26;0;0;0;0;.00nan;0;0
334;32754;26;81;32;2;30;.938;3530000;0
334;34740;33;0;0;0;0;.00nan;0;0
335;544;19;65;18;2;16;.889;3600000;0
335;2423;15;81;49;5;44;.898;3600000;0
335;4106;15;0;0;0;0;.00nan;0;0
335;31124;19;0;0;0;0;.00nan;0;0
336;323;9;0;0;0;0;.00nan;0;0
336;4450;5;100;28;0;28;1.000;3600000;0
336;19823;5;0;0;0;0;.00nan;0;0
336;20853;9;86;39;3;36;.923;3600000;0
337;61;31;42;23;4;19;.826;3600000;0
337;27739;22;0;0;0;0;.00nan;0;0
337;28026;22;80;35;3;32;.914;3600000;0
337;34797;31;0;0;0;0;.00nan;0;0
338;51;21;0;0;0;0;.00nan;0;0
338;738;27;68;42;4;38;.905;3888000;0
338;25843;21;63;27;3;24;.889;3888000;0
338;26623;27;0;0;0;0;.00nan;0;0
339;928;20;0;0;0;0;.00nan;0;0
339;1251;14;0;0;0;0;.00nan;0;0
339;18078;20;58;16;2;14;.875;3570000;0
339;25584;14;79;27;1;26;.963;3600000;0
340;233;29;0;0;0;0;.00nan;0;0
340;1796;16;55;35;5;30;.857;3650000;0
340;15437;16;0;0;0;0;.00nan;0;0
340;18351;29;49;31;6;25;.806;3650000;0
341;13842;34;0;0;0;0;.00nan;0;0
341;15464;32;0;0;0;0;.00nan;0;0
341;15502;34;71;45;5;40;.889;3600000;0
341;16006;32;72;28;2;26;.929;3600000;0
342;376;12;62;18;2;16;.889;3600000;0
342;445;12;0;0;0;0;.00nan;0;0
342;10103;24;0;0;0;0;.00nan;0;0
342;13979;24;40;36;6;30;.833;3600000;0
343;262;35;0;0;0;0;.00nan;0;0
343;1430;35;100;26;0;26;1.000;3600000;0
343;22601;26;87;36;2;34;.944;3600000;0
343;32754;26;0;0;0;0;.00nan;0;0
344;724;11;0;0;0;0;.00nan;0;0
344;1913;30;23;27;6;21;.778;2582000;0
344;4826;30;65;9;0;9;1.000;1018000;0
344;21522;11;70;24;2;22;.917;3600000;0
345;1614;25;50;30;4;26;.867;3600000;0
345;1821;3;0;0;0;0;.00nan;0;0
345;2054;3;63;30;3;27;.900;3600000;0
345;5182;25;0;0;0;0;.00nan;0;0
346;335;18;0;0;0;0;.00nan;0;0
346;2058;28;89;51;3;48;.941;3600000;0
346;5001;18;60;20;2;18;.900;3600000;0
346;14061;28;0;0;0;0;.00nan;0;0
347;323;9;62;34;4;30;.882;3900000;0
347;1572;4838;0;0;0;0;.00nan;0;0
347;2328;4838;55;27;4;23;.852;3900000;0
347;20853;9;0;0;0;0;.00nan;0;0
348;1251;14;50;25;4;21;.840;3600000;0
348;18104;10;41;28;5;23;.821;3561000;0
348;25584;14;0;0;0;0;.00nan;0;0
348;27488;10;0;0;0;0;.00nan;0;0
349;823;23;0;0;0;0;.00nan;0;0
349;2423;15;0;0;0;0;.00nan;0;0
349;4106;15;45;26;4;22;.846;3600000;0
349;10274;23;89;37;2;35;.946;3600000;0
350;500;4182;63;11;1;10;.909;3600000;0
350;1913;30;0;0;0;0;.00nan;0;0
350;4826;30;67;52;5;47;.904;3600000;0
350;25521;4182;0;0;0;0;.00nan;0;0
351;1074;0;0;0;0;0;.00nan;0;0
351;1614;25;86;27;1;26;.963;3600000;0
351;5182;25;0;0;0;0;.00nan;0;0
351;31035;0;74;34;3;31;.912;3600000;0
352;233;29;0;0;0;0;.00nan;0;0
352;1796;16;0;0;0;0;.00nan;0;0
352;15437;16;85;33;2;31;.939;3613000;0
352;18351;29;87;37;3;34;.919;3613000;0
353;61;31;0;0;0;0;.00nan;0;0
353;5385;17;58;33;4;29;.879;3600000;0
353;34006;17;0;0;0;0;.00nan;0;0
353;34797;31;100;26;0;26;1.000;3600000;0
354;738;27;87;34;2;32;.941;3600000;0
354;928;20;54;23;3;20;.870;3544000;0
354;18078;20;0;0;0;0;.00nan;0;0
354;26623;27;0;0;0;0;.00nan;0;0
355;15505;8;90;55;5;50;.909;3600000;0
355;25076;8;0;0;0;0;.00nan;0;0
355;27739;22;0;0;0;0;.00nan;0;0
355;28026;22;58;20;2;18;.900;3600000;0
356;2058;28;53;2;0;2;1.000;157000;0
356;10103;24;0;0;0;0;.00nan;0;0
356;13979;24;90;33;2;31;.939;3600000;0
356;14061;28;66;32;4;28;.875;3359000;0
357;4450;5;33;33;6;27;.818;3600000;0
357;15464;32;0;0;0;0;.00nan;0;0
357;16006;32;61;19;2;17;.895;3600000;0
357;19823;5;0;0;0;0;.00nan;0;0
358;376;12;0;0;0;0;.00nan;0;0
358;445;12;74;27;2;25;.926;3562000;0
358;13842;34;0;0;0;0;.00nan;0;0
358;15502;34;100;53;0;53;1.000;3600000;0
359;51;21;0;0;0;0;.00nan;0;0
359;262;35;0;0;0;0;.00nan;0;0
359;1430;35;89;42;3;39;.929;3600000;0
359;25843;21;65;24;2;22;.917;3600000;0
360;544;19;73;32;2;30;.938;3600000;0
360;724;11;55;33;4;29;.879;3549000;0
360;21522;11;0;0;0;0;.00nan;0;0
360;31124;19;0;0;0;0;.00nan;0;0
361;738;27;0;0;0;0;.00nan;0;0
361;18104;10;0;0;0;0;.00nan;0;0
361;26623;27;47;28;4;24;.857;3600000;0
361;27488;10;100;26;0;26;1.000;3600000;0
362;51;21;86;30;1;29;.967;3900000;0
362;4506;33;83;33;1;32;.970;3900000;0
362;25843;21;0;0;0;0;.00nan;0;0
362;34740;33;0;0;0;0;.00nan;0;0
363;500;4182;75;25;2;23;.920;3600000;0
363;22601;26;0;0;0;0;.00nan;0;0
363;25521;4182;0;0;0;0;.00nan;0;0
363;32754;26;53;33;4;29;.879;3577000;0
364;544;19;0;0;0;0;.00nan;0;0
364;1913;30;80;36;3;33;.917;3600000;0
364;4826;30;0;0;0;0;.00nan;0;0
364;31124;19;81;42;4;38;.905;3551000;0
365;823;23;64;29;3;26;.897;3600000;0
365;1572;4838;100;40;0;40;1.000;3600000;0
365;2328;4838;0;0;0;0;.00nan;0;0
365;10274;23;0;0;0;0;.00nan;0;0
366;233;29;0;0;0;0;.00nan;0;0
366;4450;5;0;0;0;0;.00nan;0;0
366;18351;29;42;30;5;25;.833;3600000;0
366;19823;5;78;37;3;34;.919;3600000;0
367;1614;25;47;35;6;29;.829;3272000;0
367;2058;28;66;40;4;36;.900;3600000;0
367;5182;25;49;1;0;1;1.000;268000;0
367;14061;28;0;0;0;0;.00nan;0;0
368;323;9;0;0;0;0;.00nan;0;0
368;928;20;0;0;0;0;.00nan;0;0
368;18078;20;89;31;1;30;.968;3600000;0
368;20853;9;37;14;3;11;.786;3600000;0
369;61;31;0;0;0;0;.00nan;0;0
369;1796;16;74;33;3;30;.909;3900000;0
369;15437;16;0;0;0;0;.00nan;0;0
369;34797;31;68;36;3;33;.917;3900000;0
370;15505;8;99;39;2;37;.949;3840000;0
370;18104;10;0;0;0;0;.00nan;0;0
370;25076;8;0;0;0;0;.00nan;0;0
370;27488;10;77;36;3;33;.917;3840000;0
371;13842;34;0;0;0;0;.00nan;0;0
371;15502;34;74;40;5;35;.875;3600000;0
371;27739;22;0;0;0;0;.00nan;0;0
371;28026;22;70;18;1;17;.944;3600000;0
372;5385;17;73;32;3;29;.906;3600000;0
372;10103;24;0;0;0;0;.00nan;0;0
372;13979;24;26;24;6;18;.750;3600000;0
372;34006;17;0;0;0;0;.00nan;0;0
373;1074;0;0;0;0;0;.00nan;0;0
373;15464;32;0;0;0;0;.00nan;0;0
373;16006;32;87;29;1;28;.966;3600000;0
373;31035;0;93;40;2;38;.950;3591000;0
374;262;35;100;53;2;51;.962;3600000;0
374;1430;35;0;0;0;0;.00nan;0;0
374;1821;3;0;0;0;0;.00nan;0;0
374;2054;3;49;18;3;15;.833;3554000;0
375;335;18;54;16;2;14;.875;3600000;0
375;2423;15;52;5;1;4;.800;573000;0
375;4106;15;46;43;6;37;.860;3027000;0
375;5001;18;0;0;0;0;.00nan;0;0
376;233;29;0;0;0;0;.00nan;0;0
376;1251;14;0;0;0;0;.00nan;0;0
376;18351;29;74;36;4;32;.889;3900000;0
376;25584;14;44;28;4;24;.857;3900000;0
377;738;27;38;24;5;19;.792;3600000;0
377;13842;34;44;37;6;31;.838;3563000;0
377;15502;34;0;0;0;0;.00nan;0;0
377;26623;27;0;0;0;0;.00nan;0;0
378;928;20;62;25;3;22;.880;3600000;0
378;15505;8;0;0;0;0;.00nan;0;0
378;18078;20;0;0;0;0;.00nan;0;0
378;25076;8;56;45;6;39;.867;3600000;0
379;1821;3;0;0;0;0;.00nan;0;0
379;2054;3;83;24;1;23;.958;3600000;0
379;4506;33;73;25;2;23;.920;3565000;0
379;34740;33;0;0;0;0;.00nan;0;0
380;724;11;0;0;0;0;.00nan;0;0
380;823;23;0;0;0;0;.00nan;0;0
380;10274;23;64;34;4;30;.882;3600000;0
380;21522;11;81;20;1;19;.950;3600000;0
381;500;4182;99;24;0;24;1.000;3600000;0
381;544;19;89;42;3;39;.929;3600000;0
381;25521;4182;0;0;0;0;.00nan;0;0
381;31124;19;0;0;0;0;.00nan;0;0
382;1251;14;39;26;6;20;.769;3666000;0
382;1614;25;55;30;5;25;.833;3666000;0
382;5182;25;0;0;0;0;.00nan;0;0
382;25584;14;0;0;0;0;.00nan;0;0
383;1913;30;71;38;4;34;.895;3600000;0
383;4826;30;0;0;0;0;.00nan;0;0
383;27739;22;0;0;0;0;.00nan;0;0
383;28026;22;69;27;2;25;.926;3600000;0
384;376;12;0;0;0;0;.00nan;0;0
384;445;12;76;27;2;25;.926;3600000;0
384;22601;26;0;0;0;0;.00nan;0;0
384;32754;26;30;33;7;26;.788;3600000;0
385;335;18;0;0;0;0;.00nan;0;0
385;724;11;0;0;0;0;.00nan;0;0
385;5001;18;60;23;2;21;.913;3600000;0
385;21522;11;71;46;5;41;.891;3600000;0
386;1572;4838;86;38;2;36;.947;3515000;0
386;2328;4838;0;0;0;0;.00nan;0;0
386;2423;15;0;0;0;0;.00nan;0;0
386;4106;15;100;35;0;35;1.000;3600000;0
387;1913;30;0;0;0;0;.00nan;0;0
387;4826;30;84;33;2;31;.939;3900000;0
387;5385;17;81;33;2;31;.939;3900000;0
387;34006;17;0;0;0;0;.00nan;0;0
388;1821;3;0;0;0;0;.00nan;0;0
388;2054;3;53;36;5;31;.861;3600000;0
388;13842;34;0;0;0;0;.00nan;0;0
388;15502;34;96;32;1;31;.969;3600000;0
389;233;29;0;0;0;0;.00nan;0;0
389;1074;0;0;0;0;0;.00nan;0;0
389;18351;29;58;32;4;28;.875;3542000;0
389;31035;0;79;26;2;24;.923;3600000;0
390;928;20;0;0;0;0;.00nan;0;0
390;2058;28;74;50;6;44;.880;3600000;0
390;14061;28;0;0;0;0;.00nan;0;0
390;18078;20;92;33;1;32;.970;3600000;0
391;323;9;0;0;0;0;.00nan;0;0
391;15464;32;0;0;0;0;.00nan;0;0
391;16006;32;26;22;5;17;.773;3546000;0
391;20853;9;62;35;4;31;.886;3600000;0
392;15505;8;59;38;5;33;.868;3584000;0
392;18104;10;64;28;3;25;.893;3600000;0
392;25076;8;0;0;0;0;.00nan;0;0
392;27488;10;0;0;0;0;.00nan;0;0
393;61;31;0;0;0;0;.00nan;0;0
393;1796;16;77;29;2;27;.931;3600000;0
393;15437;16;0;0;0;0;.00nan;0;0
393;34797;31;63;26;3;23;.885;3552000;0
394;4506;33;58;42;6;36;.857;3600000;0
394;10103;24;63;29;3;26;.897;3600000;0
394;13979;24;0;0;0;0;.00nan;0;0
394;34740;33;0;0;0;0;.00nan;0;0
395;262;35;0;0;0;0;.00nan;0;0
395;823;23;0;0;0;0;.00nan;0;0
395;1430;35;56;41;5;36;.878;3600000;0
395;10274;23;40;28;6;22;.786;3572000;0
396;544;19;76;32;2;30;.938;3600000;0
396;738;27;85;44;4;40;.909;3573000;0
396;26623;27;0;0;0;0;.00nan;0;0
396;31124;19;0;0;0;0;.00nan;0;0
397;51;21;0;0;0;0;.00nan;0;0
397;1251;14;0;0;0;0;.00nan;0;0
397;25584;14;53;46;6;40;.870;3600000;0
397;25843;21;74;30;2;28;.933;3600000;0
398;1614;25;0;0;0;0;.00nan;0;0
398;5182;25;74;27;2;25;.926;3600000;0
398;18104;10;0;0;0;0;.00nan;0;0
398;27488;10;52;41;6;35;.854;3600000;0
399;335;18;0;0;0;0;.00nan;0;0
399;4450;5;39;25;5;20;.800;3550000;0
399;5001;18;62;36;4;32;.889;3600000;0
399;19823;5;0;0;0;0;.00nan;0;0
400;376;12;0;0;0;0;.00nan;0;0
400;445;12;75;39;4;35;.897;3600000;0
400;500;4182;80;25;1;24;.960;3600000;0
400;25521;4182;0;0;0;0;.00nan;0;0
401;233;29;0;0;0;0;.00nan;0;0
401;1821;3;0;0;0;0;.00nan;0;0
401;2054;3;95;31;1;30;.968;3600000;0
401;18351;29;55;35;6;29;.829;3600000;0
402;1074;0;0;0;0;0;.00nan;0;0
402;15505;8;83;36;3;33;.917;3600000;0
402;25076;8;0;0;0;0;.00nan;0;0
402;31035;0;59;31;4;27;.871;3580000;0
403;928;20;89;25;1;24;.960;3600000;0
403;15464;32;0;0;0;0;.00nan;0;0
403;16006;32;63;29;3;26;.897;3522000;0
403;18078;20;0;0;0;0;.00nan;0;0
404;1913;30;77;47;4;43;.915;3600000;0
404;4826;30;0;0;0;0;.00nan;0;0
404;13842;34;0;0;0;0;.00nan;0;0
404;15502;34;80;23;1;22;.957;3600000;0
405;323;9;0;0;0;0;.00nan;0;0
405;1796;16;100;26;0;26;1.000;3600000;0
405;15437;16;0;0;0;0;.00nan;0;0
405;20853;9;97;46;2;44;.957;3537000;0
406;544;19;0;0;0;0;.00nan;0;0
406;10103;24;40;24;4;20;.833;3600000;0
406;13979;24;0;0;0;0;.00nan;0;0
406;31124;19;75;25;1;24;.960;3600000;0
407;823;23;100;50;3;47;.940;3600000;0
407;4450;5;0;0;0;0;.00nan;0;0
407;10274;23;0;0;0;0;.00nan;0;0
407;19823;5;50;30;4;26;.867;3575000;0
408;376;12;0;0;0;0;.00nan;0;0
408;445;12;100;29;0;29;1.000;3600000;0
408;724;11;79;28;2;26;.929;3568000;0
408;21522;11;0;0;0;0;.00nan;0;0
409;262;35;0;0;0;0;.00nan;0;0
409;738;27;53;34;5;29;.853;3755000;0
409;1430;35;70;39;4;35;.897;3755000;0
409;26623;27;0;0;0;0;.00nan;0;0
410;1572;4838;85;19;0;19;1.000;3600000;0
410;2328;4838;0;0;0;0;.00nan;0;0
410;4506;33;79;44;3;41;.932;3600000;0
410;34740;33;0;0;0;0;.00nan;0;0
411;5385;17;55;32;3;29;.906;3573000;0
411;18104;10;0;0;0;0;.00nan;0;0
411;27488;10;82;24;1;23;.958;3600000;0
411;34006;17;0;0;0;0;.00nan;0;0
412;51;21;0;0;0;0;.00nan;0;0
412;15464;32;35;27;6;21;.778;2234000;0
412;16006;32;74;13;0;13;1.000;1330000;0
412;25843;21;56;31;4;27;.871;3600000;0
413;2423;15;0;0;0;0;.00nan;0;0
413;4106;15;74;51;6;45;.882;3600000;0
413;27739;22;0;0;0;0;.00nan;0;0
413;28026;22;87;23;1;22;.957;3600000;0
414;323;9;44;36;6;30;.833;3600000;0
414;1614;25;91;31;1;30;.968;3600000;0
414;5182;25;0;0;0;0;.00nan;0;0
414;20853;9;0;0;0;0;.00nan;0;0
415;61;31;0;0;0;0;.00nan;0;0
415;22601;26;99;36;1;35;.972;3600000;0
415;32754;26;0;0;0;0;.00nan;0;0
415;34797;31;56;20;2;18;.900;3600000;0
416;335;18;0;0;0;0;.00nan;0;0
416;4506;33;59;35;4;31;.886;3600000;0
416;5001;18;35;20;5;15;.750;3600000;0
416;34740;33;0;0;0;0;.00nan;0;0
417;500;4182;76;30;2;28;.933;3600000;0
417;1251;14;0;0;0;0;.00nan;0;0
417;25521;4182;0;0;0;0;.00nan;0;0
417;25584;14;83;34;3;31;.912;3595000;0
418;5385;17;0;0;0;0;.00nan;0;0
418;27739;22;0;0;0;0;.00nan;0;0
418;28026;22;49;23;3;20;.870;3547000;0
418;34006;17;59;17;2;15;.882;3600000;0
419;1821;3;0;0;0;0;.00nan;0;0
419;2054;3;90;46;3;43;.935;3600000;0
419;15505;8;45;33;5;28;.848;3563000;0
419;25076;8;0;0;0;0;.00nan;0;0
420;233;29;0;0;0;0;.00nan;0;0
420;2058;28;97;36;1;35;.972;3900000;0
420;14061;28;0;0;0;0;.00nan;0;0
420;18351;29;99;38;1;37;.974;3900000;0
421;51;21;56;31;4;27;.871;3600000;0
421;928;20;0;0;0;0;.00nan;0;0
421;18078;20;76;25;2;23;.920;3600000;0
421;25843;21;0;0;0;0;.00nan;0;0
422;1913;30;78;38;3;35;.921;3555000;0
422;2423;15;88;39;2;37;.949;3600000;0
422;4106;15;0;0;0;0;.00nan;0;0
422;4826;30;0;0;0;0;.00nan;0;0
423;1074;0;0;0;0;0;.00nan;0;0
423;1796;16;100;28;1;27;.964;3600000;0
423;15437;16;0;0;0;0;.00nan;0;0
423;31035;0;48;34;5;29;.853;3600000;0
424;544;19;83;38;4;34;.895;3600000;0
424;4450;5;34;17;4;13;.765;3571000;0
424;19823;5;0;0;0;0;.00nan;0;0
424;31124;19;0;0;0;0;.00nan;0;0
425;823;23;0;0;0;0;.00nan;0;0
425;10103;24;0;0;0;0;.00nan;0;0
425;10274;23;86;45;3;42;.933;3646000;0
425;13979;24;79;41;4;37;.902;3646000;0
426;1251;14;46;31;5;26;.839;3584000;0
426;22601;26;0;0;0;0;.00nan;0;0
426;25584;14;0;0;0;0;.00nan;0;0
426;32754;26;65;29;3;26;.897;3600000;0
427;262;35;0;0;0;0;.00nan;0;0
427;724;11;0;0;0;0;.00nan;0;0
427;1430;35;65;32;4;28;.875;3579000;0
427;21522;11;61;17;2;15;.882;3600000;0
428;376;12;0;0;0;0;.00nan;0;0
428;445;12;76;42;4;38;.905;3600000;0
428;738;27;64;18;1;17;.944;3600000;0
428;26623;27;0;0;0;0;.00nan;0;0
429;1572;4838;49;23;4;19;.826;3600000;0
429;2328;4838;0;0;0;0;.00nan;0;0
429;13842;34;0;0;0;0;.00nan;0;0
429;15502;34;95;58;5;53;.914;3595000;0
430;15464;32;35;26;5;21;.808;3550000;0
430;16006;32;0;0;0;0;.00nan;0;0
430;18104;10;86;42;4;38;.905;3600000;0
430;27488;10;0;0;0;0;.00nan;0;0
431;1796;16;0;0;0;0;.00nan;0;0
431;1913;30;79;33;2;31;.939;3600000;0
431;4826;30;0;0;0;0;.00nan;0;0
431;15437;16;29;33;6;27;.818;3600000;0
432;61;31;95;51;3;48;.941;3576000;0
432;1614;25;82;27;2;25;.926;3600000;0
432;5182;25;0;0;0;0;.00nan;0;0
432;34797;31;0;0;0;0;.00nan;0;0
433;335;18;0;0;0;0;.00nan;0;0
433;5001;18;68;28;3;25;.893;3600000;0
433;10103;24;57;39;5;34;.872;3599000;0
433;13979;24;0;0;0;0;.00nan;0;0
434;262;35;59;27;3;24;.889;3600000;0
434;500;4182;64;40;5;35;.875;3562000;0
434;1430;35;0;0;0;0;.00nan;0;0
434;25521;4182;0;0;0;0;.00nan;0;0
435;544;19;47;20;3;17;.850;3600000;0
435;15505;8;92;34;1;33;.971;3600000;0
435;25076;8;0;0;0;0;.00nan;0;0
435;31124;19;0;0;0;0;.00nan;0;0
436;500;4182;25;32;6;26;.813;3600000;0
436;4450;5;0;0;0;0;.00nan;0;0
436;19823;5;73;38;4;34;.895;3600000;0
436;25521;4182;0;0;0;0;.00nan;0;0
437;323;9;0;0;0;0;.00nan;0;0
437;928;20;0;0;0;0;.00nan;0;0
437;18078;20;39;32;5;27;.844;3551000;0
437;20853;9;83;38;3;35;.921;3600000;0
438;233;29;0;0;0;0;.00nan;0;0
438;724;11;100;31;0;31;1.000;3600000;0
438;18351;29;49;28;4;24;.857;3600000;0
438;21522;11;0;0;0;0;.00nan;0;0
439;61;31;0;0;0;0;.00nan;0;0
439;2058;28;68;36;4;32;.889;3537000;0
439;14061;28;0;0;0;0;.00nan;0;0
439;34797;31;86;30;2;28;.933;3600000;0
440;51;21;0;0;0;0;.00nan;0;0
440;1251;14;0;0;0;0;.00nan;0;0
440;25584;14;76;44;4;40;.909;3543000;0
440;25843;21;64;27;3;24;.889;3600000;0
441;1074;0;0;0;0;0;.00nan;0;0
441;2423;15;0;0;0;0;.00nan;0;0
441;4106;15;67;33;4;29;.879;3544000;0
441;31035;0;63;27;3;24;.889;3600000;0
442;544;19;66;22;3;19;.864;3600000;0
442;15464;32;56;5;0;5;1.000;911000;0
442;16006;32;49;27;6;21;.778;2689000;0
442;31124;19;0;0;0;0;.00nan;0;0
443;376;12;0;0;0;0;.00nan;0;0
443;445;12;98;24;0;24;1.000;3600000;0
443;1796;16;43;32;5;27;.844;3600000;0
443;15437;16;0;0;0;0;.00nan;0;0
444;262;35;0;0;0;0;.00nan;0;0
444;1430;35;84;26;1;25;.962;3600000;0
444;10103;24;0;0;0;0;.00nan;0;0
444;13979;24;81;24;2;22;.917;3544000;0
445;4506;33;100;25;0;25;1.000;3600000;0
445;5385;17;59;34;4;30;.882;3600000;0
445;34006;17;0;0;0;0;.00nan;0;0
445;34740;33;0;0;0;0;.00nan;0;0
446;1614;25;78;25;2;23;.920;3600000;0
446;5182;25;0;0;0;0;.00nan;0;0
446;18104;10;57;40;5;35;.875;3600000;0
446;27488;10;0;0;0;0;.00nan;0;0
447;823;23;54;27;4;23;.852;3547000;0
447;1821;3;0;0;0;0;.00nan;0;0
447;2054;3;57;25;3;22;.880;3600000;0
447;10274;23;0;0;0;0;.00nan;0;0
448;335;18;45;29;5;24;.828;3600000;0
448;5001;18;0;0;0;0;.00nan;0;0
448;13842;34;0;0;0;0;.00nan;0;0
448;15502;34;97;39;1;38;.974;3600000;0
449;738;27;86;45;3;42;.933;3900000;0
449;1572;4838;83;36;3;33;.917;3900000;0
449;2328;4838;0;0;0;0;.00nan;0;0
449;26623;27;0;0;0;0;.00nan;0;0
450;15505;8;0;0;0;0;.00nan;0;0
450;25076;8;60;35;4;31;.886;3600000;0
450;27739;22;58;28;4;24;.857;3129000;0
450;28026;22;29;8;3;5;.625;471000;0
451;18104;10;0;0;0;0;.00nan;0;0
451;22601;26;64;39;5;34;.872;3600000;0
451;27488;10;81;26;1;25;.962;3600000;0
451;32754;26;0;0;0;0;.00nan;0;0
452;1572;4838;0;0;0;0;.00nan;0;0
452;1913;30;60;33;4;29;.879;3600000;0
452;2328;4838;85;31;1;30;.968;3600000;0
452;4826;30;0;0;0;0;.00nan;0;0
453;1074;0;48;5;1;4;.800;398000;0
453;1251;14;0;0;0;0;.00nan;0;0
453;25584;14;42;34;6;28;.824;3600000;0
453;31035;0;36;34;6;28;.824;3149000;0
454;233;29;0;0;0;0;.00nan;0;0
454;2058;28;76;29;3;26;.897;3586000;0
454;14061;28;0;0;0;0;.00nan;0;0
454;18351;29;80;27;2;25;.926;3600000;0
455;61;31;0;0;0;0;.00nan;0;0
455;724;11;84;34;2;32;.941;3600000;0
455;21522;11;0;0;0;0;.00nan;0;0
455;34797;31;62;27;3;24;.889;3582000;0
456;51;21;0;0;0;0;.00nan;0;0
456;500;4182;31;26;6;20;.769;2569000;0
456;25521;4182;58;8;0;8;1.000;1031000;0
456;25843;21;67;33;3;30;.909;3600000;0
457;928;20;87;39;2;37;.949;3600000;0
457;4450;5;79;35;3;32;.914;3543000;0
457;18078;20;0;0;0;0;.00nan;0;0
457;19823;5;0;0;0;0;.00nan;0;0
458;323;9;0;0;0;0;.00nan;0;0
458;10103;24;0;0;0;0;.00nan;0;0
458;13979;24;86;26;1;25;.962;3600000;0
458;20853;9;76;34;2;32;.941;3547000;0
459;1614;25;45;29;4;25;.862;3600000;0
459;5182;25;0;0;0;0;.00nan;0;0
459;15464;32;58;13;1;12;.923;1221000;0
459;16006;32;55;26;4;22;.846;2372000;0
460;262;35;0;0;0;0;.00nan;0;0
460;1430;35;63;42;5;37;.881;3600000;0
460;5385;17;92;34;2;32;.941;3600000;0
460;34006;17;0;0;0;0;.00nan;0;0
461;544;19;74;36;3;33;.917;3600000;0
461;1821;3;0;0;0;0;.00nan;0;0
461;2054;3;60;36;4;32;.889;3586000;0
461;31124;19;0;0;0;0;.00nan;0;0
462;823;23;0;0;0;0;.00nan;0;0
462;10274;23;86;33;2;31;.939;3578000;0
462;13842;34;0;0;0;0;.00nan;0;0
462;15502;34;100;31;1;30;.968;3600000;0
463;335;18;0;0;0;0;.00nan;0;0
463;738;27;60;31;4;27;.871;3541000;0
463;5001;18;80;39;3;36;.923;3600000;0
463;26623;27;0;0;0;0;.00nan;0;0
464;500;4182;69;27;2;25;.926;3600000;0
464;18104;10;55;31;4;27;.871;3532000;0
464;25521;4182;0;0;0;0;.00nan;0;0
464;27488;10;0;0;0;0;.00nan;0;0
465;2423;15;0;0;0;0;.00nan;0;0
465;4106;15;60;29;3;26;.897;3600000;0
465;5385;17;46;32;5;27;.844;3532000;0
465;34006;17;0;0;0;0;.00nan;0;0
466;15464;32;71;20;1;19;.950;3600000;0
466;15505;8;26;17;5;12;.706;1002000;0
466;16006;32;0;0;0;0;.00nan;0;0
466;25076;8;75;21;0;21;1.000;2598000;0
467;376;12;0;0;0;0;.00nan;0;0
467;445;12;69;33;2;31;.939;3900000;0
467;1796;16;86;25;2;23;.920;3900000;0
467;15437;16;0;0;0;0;.00nan;0;0
468;4506;33;56;31;4;27;.871;3515000;0
468;27739;22;0;0;0;0;.00nan;0;0
468;28026;22;74;28;2;26;.929;3600000;0
468;34740;33;0;0;0;0;.00nan;0;0
469;1913;30;42;30;5;25;.833;3600000;0
469;4826;30;0;0;0;0;.00nan;0;0
469;22601;26;84;32;2;30;.938;3600000;0
469;32754;26;0;0;0;0;.00nan;0;0
470;1074;0;0;0;0;0;.00nan;0;0
470;4450;5;39;25;5;20;.800;3600000;0
470;19823;5;0;0;0;0;.00nan;0;0
470;31035;0;93;43;2;41;.953;3600000;0
471;51;21;0;0;0;0;.00nan;0;0
471;323;9;0;0;0;0;.00nan;0;0
471;20853;9;68;32;3;29;.906;3570000;0
471;25843;21;78;26;2;24;.923;3600000;0
472;1251;14;0;0;0;0;.00nan;0;0
472;2058;28;0;0;0;0;.00nan;0;0
472;14061;28;23;30;7;23;.767;3600000;0
472;25584;14;68;35;3;32;.914;3600000;0
473;724;11;0;0;0;0;.00nan;0;0
473;10103;24;0;0;0;0;.00nan;0;0
473;13979;24;59;22;2;20;.909;3600000;0
473;21522;11;72;34;3;31;.912;3600000;0
474;376;12;63;20;2;18;.900;3600000;0
474;445;12;0;0;0;0;.00nan;0;0
474;15505;8;64;38;4;34;.895;3576000;0
474;25076;8;0;0;0;0;.00nan;0;0
475;61;31;0;0;0;0;.00nan;0;0
475;262;35;0;0;0;0;.00nan;0;0
475;1430;35;43;29;5;24;.828;3526000;0
475;34797;31;90;43;3;40;.930;3600000;0
476;233;29;0;0;0;0;.00nan;0;0
476;1614;25;75;30;3;27;.900;3600000;0
476;5182;25;0;0;0;0;.00nan;0;0
476;18351;29;75;46;5;41;.891;3600000;0
477;544;19;79;34;3;31;.912;3600000;0
477;13842;34;0;0;0;0;.00nan;0;0
477;15502;34;100;35;0;35;1.000;3600000;0
477;31124;19;0;0;0;0;.00nan;0;0
478;335;18;0;0;0;0;.00nan;0;0
478;1821;3;0;0;0;0;.00nan;0;0
478;2054;3;90;43;3;40;.930;3588000;0
478;5001;18;70;22;2;20;.909;3600000;0
479;823;23;100;37;1;36;.973;3600000;0
479;1572;4838;96;46;4;42;.913;3600000;0
479;2328;4838;0;0;0;0;.00nan;0;0
479;10274;23;0;0;0;0;.00nan;0;0
480;2058;28;100;33;0;33;1.000;3600000;0
480;4450;5;0;0;0;0;.00nan;0;0
480;14061;28;0;0;0;0;.00nan;0;0
480;19823;5;75;29;2;27;.931;3566000;0
481;51;21;100;30;0;30;1.000;3600000;0
481;2423;15;0;0;0;0;.00nan;0;0
481;4106;15;67;28;3;25;.893;3600000;0
481;25843;21;0;0;0;0;.00nan;0;0
482;500;4182;47;27;4;23;.852;3548000;0
482;928;20;0;0;0;0;.00nan;0;0
482;18078;20;79;33;3;30;.909;3600000;0
482;25521;4182;0;0;0;0;.00nan;0;0
483;724;11;36;43;7;36;.837;3583000;0
483;21522;11;0;0;0;0;.00nan;0;0
483;27739;22;0;0;0;0;.00nan;0;0
483;28026;22;36;29;5;24;.828;3600000;0
484;10103;24;48;19;3;16;.842;3588000;0
484;13979;24;0;0;0;0;.00nan;0;0
484;15464;32;0;0;0;0;.00nan;0;0
484;16006;32;94;36;2;34;.944;3600000;0
485;1796;16;52;15;2;13;.867;2953000;0
485;4506;33;78;38;3;35;.921;3600000;0
485;15437;16;22;4;3;1;.250;568000;0
485;34740;33;0;0;0;0;.00nan;0;0
486;335;18;78;21;1;20;.952;3600000;0
486;5001;18;0;0;0;0;.00nan;0;0
486;22601;26;0;0;0;0;.00nan;0;0
486;32754;26;72;40;4;36;.900;3600000;0
487;1572;4838;0;0;0;0;.00nan;0;0
487;1821;3;99;37;1;36;.973;3600000;0
487;2054;3;0;0;0;0;.00nan;0;0
487;2328;4838;85;28;2;26;.929;3579000;0
488;5385;17;95;35;1;34;.971;3900000;0
488;13842;34;0;0;0;0;.00nan;0;0
488;15502;34;89;40;1;39;.975;3900000;0
488;34006;17;0;0;0;0;.00nan;0;0
489;323;9;65;44;5;39;.886;3600000;0
489;1614;25;71;25;1;24;.960;3600000;0
489;5182;25;0;0;0;0;.00nan;0;0
489;20853;9;0;0;0;0;.00nan;0;0
490;928;20;53;18;2;16;.889;3600000;0
490;1074;0;0;0;0;0;.00nan;0;0
490;18078;20;0;0;0;0;.00nan;0;0
490;31035;0;63;33;4;29;.879;3520000;0
491;262;35;0;0;0;0;.00nan;0;0
491;376;12;0;0;0;0;.00nan;0;0
491;445;12;100;26;0;26;1.000;3854000;0
491;1430;35;88;35;1;34;.971;3854000;0
492;823;23;82;21;1;20;.952;3600000;0
492;1913;30;86;41;4;37;.902;3600000;0
492;4826;30;0;0;0;0;.00nan;0;0
492;10274;23;0;0;0;0;.00nan;0;0
493;4450;5;0;0;0;0;.00nan;0;0
493;10103;24;0;0;0;0;.00nan;0;0
493;13979;24;74;40;3;37;.925;3900000;0
493;19823;5;81;29;3;26;.897;3900000;0
494;1796;16;24;6;3;3;.500;430000;0
494;2058;28;90;37;2;35;.946;3600000;0
494;14061;28;0;0;0;0;.00nan;0;0
494;15437;16;56;27;3;24;.889;3170000;0
495;1251;14;0;0;0;0;.00nan;0;0
495;25584;14;74;42;4;38;.905;3600000;0
495;27739;22;0;0;0;0;.00nan;0;0
495;28026;22;70;20;1;19;.950;3600000;0
496;51;21;83;29;1;28;.966;3600000;0
496;2423;15;40;34;6;28;.824;3600000;0
496;4106;15;0;0;0;0;.00nan;0;0
496;25843;21;0;0;0;0;.00nan;0;0
497;61;31;0;0;0;0;.00nan;0;0
497;15505;8;0;0;0;0;.00nan;0;0
497;25076;8;97;42;2;40;.952;3600000;0
497;34797;31;61;29;3;26;.897;3563000;0
498;4506;33;97;41;2;39;.951;3571000;0
498;15464;32;0;0;0;0;.00nan;0;0
498;16006;32;78;22;1;21;.955;3600000;0
498;34740;33;0;0;0;0;.00nan;0;0
499;544;19;0;0;0;0;.00nan;0;0
499;1913;30;0;0;0;0;.00nan;0;0
499;4826;30;65;47;5;42;.894;3600000;0
499;31124;19;56;17;2;15;.882;3600000;0
500;233;29;0;0;0;0;.00nan;0;0
500;500;4182;0;0;0;0;.00nan;0;0
500;18351;29;71;38;4;34;.895;3570000;0
500;25521;4182;67;31;3;28;.903;3600000;0
501;335;18;0;0;0;0;.00nan;0;0
501;738;27;100;40;3;37;.925;3900000;0
501;5001;18;86;46;3;43;.935;3900000;0
501;26623;27;0;0;0;0;.00nan;0;0
502;1572;4838;78;42;3;39;.929;3600000;0
502;2328;4838;0;0;0;0;.00nan;0;0
502;22601;26;59;23;2;21;.913;3600000;0
502;32754;26;0;0;0;0;.00nan;0;0
503;1614;25;0;0;0;0;.00nan;0;0
503;5182;25;80;26;2;24;.923;3600000;0
503;5385;17;55;45;7;38;.844;3304000;0
503;34006;17;55;4;0;4;1.000;296000;0
504;1074;0;0;0;0;0;.00nan;0;0
504;18104;10;77;24;2;22;.917;3600000;0
504;27488;10;0;0;0;0;.00nan;0;0
504;31035;0;65;47;6;41;.872;3600000;0
505;376;12;0;0;0;0;.00nan;0;0
505;445;12;68;25;2;23;.920;3600000;0
505;4506;33;60;26;3;23;.885;3543000;0
505;34740;33;0;0;0;0;.00nan;0;0
506;724;11;58;41;5;36;.878;3600000;0
506;823;23;0;0;0;0;.00nan;0;0
506;10274;23;100;38;1;37;.974;3600000;0
506;21522;11;0;0;0;0;.00nan;0;0
507;1614;25;76;50;5;45;.900;3600000;0
507;4450;5;0;0;0;0;.00nan;0;0
507;5182;25;0;0;0;0;.00nan;0;0
507;19823;5;63;25;2;23;.920;3600000;0
508;1796;16;66;30;3;27;.900;3554000;0
508;1821;3;0;0;0;0;.00nan;0;0
508;2054;3;92;39;2;37;.949;3600000;0
508;15437;16;0;0;0;0;.00nan;0;0
509;2058;28;96;39;2;37;.949;3564000;0
509;10103;24;0;0;0;0;.00nan;0;0
509;13979;24;66;17;1;16;.941;3600000;0
509;14061;28;0;0;0;0;.00nan;0;0
510;61;31;0;0;0;0;.00nan;0;0
510;15464;32;0;0;0;0;.00nan;0;0
510;16006;32;78;47;4;43;.915;3532000;0
510;34797;31;76;30;2;28;.933;3600000;0
511;51;21;0;0;0;0;.00nan;0;0
511;1074;0;60;21;2;19;.905;3600000;0
511;25843;21;46;20;3;17;.850;3561000;0
511;31035;0;0;0;0;0;.00nan;0;0
512;928;20;0;0;0;0;.00nan;0;0
512;18078;20;67;25;2;23;.920;3600000;0
512;27739;22;0;0;0;0;.00nan;0;0
512;28026;22;56;42;5;37;.881;3600000;0
513;1251;14;0;0;0;0;.00nan;0;0
513;2423;15;0;0;0;0;.00nan;0;0
513;4106;15;85;30;1;29;.967;3600000;0
513;25584;14;61;23;2;21;.913;3552000;0
514;5385;17;98;40;1;39;.975;3600000;0
514;13842;34;0;0;0;0;.00nan;0;0
514;15502;34;72;23;2;21;.913;3600000;0
514;34006;17;0;0;0;0;.00nan;0;0
515;376;12;99;39;1;38;.974;3600000;0
515;445;12;0;0;0;0;.00nan;0;0
515;15505;8;52;23;3;20;.870;3556000;0
515;25076;8;0;0;0;0;.00nan;0;0
516;262;35;0;0;0;0;.00nan;0;0
516;323;9;91;34;1;33;.971;3600000;0
516;1430;35;60;40;5;35;.875;3600000;0
516;20853;9;0;0;0;0;.00nan;0;0
517;544;19;70;30;3;27;.900;3600000;0
517;1572;4838;60;32;4;28;.875;3596000;0
517;2328;4838;0;0;0;0;.00nan;0;0
517;31124;19;0;0;0;0;.00nan;0;0
518;233;29;0;0;0;0;.00nan;0;0
518;18351;29;70;34;4;30;.882;3600000;0
518;22601;26;69;40;5;35;.875;3556000;0
518;32754;26;0;0;0;0;.00nan;0;0
519;335;18;0;0;0;0;.00nan;0;0
519;1913;30;78;39;3;36;.923;3554000;0
519;4826;30;0;0;0;0;.00nan;0;0
519;5001;18;89;33;2;31;.939;3600000;0
520;500;4182;73;29;3;26;.897;3900000;0
520;724;11;0;0;0;0;.00nan;0;0
520;21522;11;65;32;3;29;.906;3900000;0
520;25521;4182;0;0;0;0;.00nan;0;0
521;738;27;50;29;4;25;.862;3600000;0
521;823;23;41;35;6;29;.829;2092000;0
521;10274;23;41;16;3;13;.813;1508000;0
521;26623;27;0;0;0;0;.00nan;0;0
522;2423;15;0;0;0;0;.00nan;0;0
522;4106;15;97;59;5;54;.915;3600000;0
522;4450;5;0;0;0;0;.00nan;0;0
522;19823;5;51;26;4;22;.846;3600000;0
523;928;20;83;22;1;21;.955;3900000;0
523;5385;17;0;0;0;0;.00nan;0;0
523;18078;20;0;0;0;0;.00nan;0;0
523;34006;17;100;39;1;38;.974;3900000;0
524;323;9;86;35;3;32;.914;3900000;0
524;18104;10;88;33;3;30;.909;3894000;0
524;20853;9;0;0;0;0;.00nan;0;0
524;27488;10;0;0;0;0;.00nan;0;0
525;2058;28;44;29;5;24;.828;3548000;0
525;14061;28;0;0;0;0;.00nan;0;0
525;27739;22;0;0;0;0;.00nan;0;0
525;28026;22;50;24;4;20;.833;3600000;0
526;61;31;0;0;0;0;.00nan;0;0
526;10103;24;0;0;0;0;.00nan;0;0
526;13979;24;71;41;6;35;.854;3722000;0
526;34797;31;63;45;5;40;.889;3722000;0
527;1821;3;0;0;0;0;.00nan;0;0
527;2054;3;85;44;3;41;.932;3600000;0
527;13842;34;0;0;0;0;.00nan;0;0
527;15502;34;92;21;0;21;1.000;3600000;0
528;51;21;0;0;0;0;.00nan;0;0
528;1796;16;0;0;0;0;.00nan;0;0
528;15437;16;72;24;1;23;.958;3600000;0
528;25843;21;64;32;3;29;.906;3600000;0
529;376;12;0;0;0;0;.00nan;0;0
529;445;12;77;39;2;37;.949;3600000;0
529;15464;32;0;0;0;0;.00nan;0;0
529;16006;32;71;24;1;23;.958;3600000;0
530;262;35;0;0;0;0;.00nan;0;0
530;1430;35;92;31;1;30;.968;3900000;0
530;4506;33;82;23;1;22;.957;3900000;0
530;34740;33;0;0;0;0;.00nan;0;0
531;544;19;86;49;4;45;.918;3728000;0
531;823;23;0;0;0;0;.00nan;0;0
531;10274;23;69;34;3;31;.912;3728000;0
531;31124;19;0;0;0;0;.00nan;0;0
532;724;11;80;29;1;28;.966;3600000;0
532;21522;11;0;0;0;0;.00nan;0;0
532;22601;26;100;33;0;33;1.000;3600000;0
532;32754;26;0;0;0;0;.00nan;0;0
533;335;18;0;0;0;0;.00nan;0;0
533;1572;4838;98;52;4;48;.923;3600000;0
533;2328;4838;0;0;0;0;.00nan;0;0
533;5001;18;71;21;1;20;.952;3600000;0
534;500;4182;49;24;4;20;.833;3600000;0
534;1614;25;43;23;4;19;.826;3578000;0
534;5182;25;0;0;0;0;.00nan;0;0
534;25521;4182;0;0;0;0;.00nan;0;0
535;738;27;69;19;1;18;.947;3600000;0
535;1913;30;0;0;0;0;.00nan;0;0
535;4826;30;49;36;6;30;.833;3600000;0
535;26623;27;0;0;0;0;.00nan;0;0
536;233;29;0;0;0;0;.00nan;0;0
536;1074;0;0;0;0;0;.00nan;0;0
536;18351;29;81;19;1;18;.947;3600000;0
536;31035;0;34;28;6;22;.786;3600000;0
537;13842;34;0;0;0;0;.00nan;0;0
537;15502;34;47;32;5;27;.844;3600000;0
537;15505;8;86;35;2;33;.943;3600000;0
537;25076;8;0;0;0;0;.00nan;0;0
538;500;4182;0;0;0;0;.00nan;0;0
538;724;11;0;0;0;0;.00nan;0;0
538;21522;11;100;40;0;40;1.000;3600000;0
538;25521;4182;76;34;4;30;.882;3600000;0
539;738;27;0;0;0;0;.00nan;0;0
539;22601;26;91;35;2;33;.943;3577000;0
539;26623;27;83;27;1;26;.963;3600000;0
539;32754;26;0;0;0;0;.00nan;0;0
540;51;21;0;0;0;0;.00nan;0;0
540;5385;17;47;32;5;27;.844;3600000;0
540;25843;21;71;26;1;25;.962;3600000;0
540;34006;17;0;0;0;0;.00nan;0;0
541;1821;3;0;0;0;0;.00nan;0;0
541;2054;3;95;34;1;33;.971;3600000;0
541;2423;15;98;47;3;44;.936;3541000;0
541;4106;15;0;0;0;0;.00nan;0;0
542;2058;28;70;47;5;42;.894;3600000;0
542;4450;5;98;26;0;26;1.000;3600000;0
542;14061;28;0;0;0;0;.00nan;0;0
542;19823;5;0;0;0;0;.00nan;0;0
543;61;31;48;31;5;26;.839;3600000;0
543;18104;10;86;29;1;28;.966;3600000;0
543;27488;10;0;0;0;0;.00nan;0;0
543;34797;31;0;0;0;0;.00nan;0;0
544;323;9;49;27;4;23;.852;3600000;0
544;928;20;0;0;0;0;.00nan;0;0
544;18078;20;73;25;1;24;.960;3600000;0
544;20853;9;0;0;0;0;.00nan;0;0
545;15464;32;55;28;3;25;.893;3561000;0
545;16006;32;0;0;0;0;.00nan;0;0
545;27739;22;0;0;0;0;.00nan;0;0
545;28026;22;96;37;2;35;.946;3600000;0
546;823;23;69;18;1;17;.944;3600000;0
546;1796;16;82;30;2;28;.933;3584000;0
546;10274;23;0;0;0;0;.00nan;0;0
546;15437;16;0;0;0;0;.00nan;0;0
547;4506;33;71;24;2;22;.917;3600000;0
547;15505;8;0;0;0;0;.00nan;0;0
547;25076;8;38;39;7;32;.821;3600000;0
547;34740;33;0;0;0;0;.00nan;0;0
548;376;12;0;0;0;0;.00nan;0;0
548;445;12;58;37;5;32;.865;3835000;0
548;1614;25;51;28;4;24;.857;3835000;0
548;5182;25;0;0;0;0;.00nan;0;0
549;335;18;39;26;5;21;.808;3600000;0
549;1913;30;64;9;0;9;1.000;774000;0
549;4826;30;28;31;6;25;.806;2784000;0
549;5001;18;0;0;0;0;.00nan;0;0
550;1251;14;0;0;0;0;.00nan;0;0
550;1572;4838;65;41;4;37;.902;3570000;0
550;2328;4838;0;0;0;0;.00nan;0;0
550;25584;14;59;20;2;18;.900;3600000;0
551;61;31;0;0;0;0;.00nan;0;0
551;233;29;0;0;0;0;.00nan;0;0
551;18351;29;100;34;0;34;1.000;3600000;0
551;34797;31;89;37;2;35;.946;3515000;0
552;928;20;47;27;4;23;.852;3566000;0
552;5385;17;79;40;3;37;.925;3600000;0
552;18078;20;0;0;0;0;.00nan;0;0
552;34006;17;0;0;0;0;.00nan;0;0
553;1074;0;0;0;0;0;.00nan;0;0
553;10103;24;0;0;0;0;.00nan;0;0
553;13979;24;82;29;1;28;.966;3600000;0
553;31035;0;77;36;3;33;.917;3576000;0
554;13842;34;0;0;0;0;.00nan;0;0
554;15464;32;0;0;0;0;.00nan;0;0
554;15502;34;83;29;1;28;.966;3600000;0
554;16006;32;85;35;2;33;.943;3547000;0
555;335;18;0;0;0;0;.00nan;0;0
555;724;11;0;0;0;0;.00nan;0;0
555;5001;18;95;32;1;31;.969;3600000;0
555;21522;11;73;37;3;34;.919;3515000;0
556;738;27;79;25;1;24;.960;3600000;0
556;1251;14;0;0;0;0;.00nan;0;0
556;25584;14;55;24;3;21;.875;3600000;0
556;26623;27;0;0;0;0;.00nan;0;0
557;544;19;77;31;3;28;.903;3600000;0
557;1572;4838;0;0;0;0;.00nan;0;0
557;2328;4838;56;41;5;36;.878;3600000;0
557;31124;19;0;0;0;0;.00nan;0;0
558;2058;28;59;29;3;26;.897;3537000;0
558;2423;15;81;29;1;28;.966;3600000;0
558;4106;15;0;0;0;0;.00nan;0;0
558;14061;28;0;0;0;0;.00nan;0;0
559;323;9;76;39;3;36;.923;3600000;0
559;20853;9;0;0;0;0;.00nan;0;0
559;27739;22;0;0;0;0;.00nan;0;0
559;28026;22;32;29;6;23;.793;3600000;0
560;233;29;0;0;0;0;.00nan;0;0
560;18104;10;93;45;3;42;.933;3600000;0
560;18351;29;77;28;2;26;.929;3600000;0
560;27488;10;0;0;0;0;.00nan;0;0
561;51;21;0;0;0;0;.00nan;0;0
561;823;23;100;37;1;36;.973;3600000;0
561;10274;23;0;0;0;0;.00nan;0;0
561;25843;21;61;29;4;25;.862;3600000;0
562;376;12;0;0;0;0;.00nan;0;0
562;445;12;96;34;1;33;.971;3600000;0
562;1614;25;71;25;2;23;.920;3572000;0
562;5182;25;0;0;0;0;.00nan;0;0
563;544;19;66;28;3;25;.893;3572000;0
563;4506;33;90;36;2;34;.944;3600000;0
563;31124;19;0;0;0;0;.00nan;0;0
563;34740;33;0;0;0;0;.00nan;0;0
564;500;4182;90;19;0;19;1.000;3600000;0
564;1913;30;0;0;0;0;.00nan;0;0
564;4826;30;86;43;2;41;.953;3528000;0
564;25521;4182;0;0;0;0;.00nan;0;0
565;4450;5;92;16;0;16;1.000;3600000;0
565;5385;17;97;49;2;47;.959;3520000;0
565;19823;5;0;0;0;0;.00nan;0;0
565;34006;17;0;0;0;0;.00nan;0;0
566;1821;3;0;0;0;0;.00nan;0;0
566;2054;3;53;26;4;22;.846;3683000;0
566;2058;28;77;36;3;33;.917;3683000;0
566;14061;28;0;0;0;0;.00nan;0;0
567;61;31;0;0;0;0;.00nan;0;0
567;1074;0;0;0;0;0;.00nan;0;0
567;31035;0;75;34;3;31;.912;3671000;0
567;34797;31;75;27;2;25;.926;3671000;0
568;823;23;0;0;0;0;.00nan;0;0
568;928;20;0;0;0;0;.00nan;0;0
568;10274;23;94;54;3;51;.944;3727000;0
568;18078;20;77;29;2;27;.931;3727000;0
569;10103;24;0;0;0;0;.00nan;0;0
569;13842;34;0;0;0;0;.00nan;0;0
569;13979;24;75;32;3;29;.906;3600000;0
569;15502;34;71;36;4;32;.889;3600000;0
570;15464;32;0;0;0;0;.00nan;0;0
570;15505;8;79;51;3;48;.941;3600000;0
570;16006;32;100;22;0;22;1.000;3600000;0
570;25076;8;0;0;0;0;.00nan;0;0
571;262;35;64;44;6;38;.864;3600000;0
571;1430;35;0;0;0;0;.00nan;0;0
571;1796;16;0;0;0;0;.00nan;0;0
571;15437;16;54;27;3;24;.889;3600000;0
572;724;11;29;13;4;9;.692;1306000;0
572;1251;14;0;0;0;0;.00nan;0;0
572;21522;11;50;28;4;24;.857;2294000;0
572;25584;14;59;22;3;19;.864;3600000;0
573;335;18;65;36;4;32;.889;3600000;0
573;1572;4838;50;29;6;23;.793;3600000;0
573;2328;4838;0;0;0;0;.00nan;0;0
573;5001;18;0;0;0;0;.00nan;0;0
574;323;9;0;0;0;0;.00nan;0;0
574;4450;5;74;22;1;21;.955;3600000;0
574;19823;5;0;0;0;0;.00nan;0;0
574;20853;9;29;29;6;23;.793;3600000;0
575;233;29;0;0;0;0;.00nan;0;0
575;18104;10;89;33;1;32;.970;3600000;0
575;18351;29;54;24;3;21;.875;3600000;0
575;27488;10;0;0;0;0;.00nan;0;0
576;738;27;98;26;0;26;1.000;3600000;0
576;2423;15;0;0;0;0;.00nan;0;0
576;4106;15;90;42;3;39;.929;3600000;0
576;26623;27;0;0;0;0;.00nan;0;0
577;51;21;0;0;0;0;.00nan;0;0
577;25843;21;62;35;4;31;.886;3600000;0
577;27739;22;45;33;5;28;.848;3591000;0
577;28026;22;0;0;0;0;.00nan;0;0
578;544;19;80;24;1;23;.958;3600000;0
578;15505;8;0;0;0;0;.00nan;0;0
578;25076;8;36;27;5;22;.815;3600000;0
578;31124;19;0;0;0;0;.00nan;0;0
579;1614;25;70;21;2;19;.905;3600000;0
579;1913;30;86;44;3;41;.932;3599000;0
579;4826;30;0;0;0;0;.00nan;0;0
579;5182;25;0;0;0;0;.00nan;0;0
580;376;12;0;0;0;0;.00nan;0;0
580;445;12;74;31;2;29;.935;3552000;0
580;22601;26;92;23;0;23;1.000;3600000;0
580;32754;26;0;0;0;0;.00nan;0;0
581;500;4182;77;22;1;21;.955;3600000;0
581;4506;33;75;30;2;28;.933;3600000;0
581;25521;4182;0;0;0;0;.00nan;0;0
581;34740;33;0;0;0;0;.00nan;0;0
582;1821;3;0;0;0;0;.00nan;0;0
582;2054;3;81;41;3;38;.927;3600000;0
582;10103;24;0;0;0;0;.00nan;0;0
582;13979;24;58;35;5;30;.857;3536000;0
583;262;35;0;0;0;0;.00nan;0;0
583;1430;35;90;29;1;28;.966;3600000;0
583;2058;28;0;0;0;0;.00nan;0;0
583;14061;28;67;33;3;30;.909;3600000;0
584;823;23;47;33;5;28;.848;3600000;0
584;10274;23;0;0;0;0;.00nan;0;0
584;18104;10;0;0;0;0;.00nan;0;0
584;27488;10;92;26;1;25;.962;3600000;0
585;51;21;0;0;0;0;.00nan;0;0
585;4450;5;56;5;0;5;1.000;668000;0
585;19823;5;38;30;6;24;.800;2895000;0
585;25843;21;73;44;5;39;.886;3600000;0
586;1074;0;0;0;0;0;.00nan;0;0
586;27739;22;0;0;0;0;.00nan;0;0
586;28026;22;55;25;3;22;.880;3600000;0
586;31035;0;83;49;4;45;.918;3593000;0
587;323;9;72;35;4;31;.886;3600000;0
587;738;27;100;30;0;30;1.000;3600000;0
587;20853;9;0;0;0;0;.00nan;0;0
587;26623;27;0;0;0;0;.00nan;0;0
588;61;31;25;21;5;16;.762;3564000;0
588;544;19;97;36;3;33;.917;3600000;0
588;31124;19;0;0;0;0;.00nan;0;0
588;34797;31;0;0;0;0;.00nan;0;0
589;233;29;0;0;0;0;.00nan;0;0
589;13842;34;0;0;0;0;.00nan;0;0
589;15502;34;49;40;6;34;.850;3600000;0
589;18351;29;75;26;1;25;.962;3600000;0
590;1614;25;26;13;4;9;.692;1140000;0
590;5182;25;61;15;1;14;.933;2460000;0
590;15505;8;93;36;2;34;.944;3600000;0
590;25076;8;0;0;0;0;.00nan;0;0
591;4506;33;56;26;3;23;.885;3581000;0
591;22601;26;64;20;2;18;.900;3600000;0
591;32754;26;0;0;0;0;.00nan;0;0
591;34740;33;0;0;0;0;.00nan;0;0
592;500;4182;76;34;3;31;.912;3600000;0
592;15464;32;0;0;0;0;.00nan;0;0
592;16006;32;46;30;5;25;.833;3516000;0
592;25521;4182;0;0;0;0;.00nan;0;0
593;1251;14;0;0;0;0;.00nan;0;0
593;1913;30;72;45;4;41;.911;3900000;0
593;4826;30;0;0;0;0;.00nan;0;0
593;25584;14;61;36;4;32;.889;3900000;0
594;928;20;0;0;0;0;.00nan;0;0
594;1572;4838;76;38;4;34;.895;3900000;0
594;2328;4838;0;0;0;0;.00nan;0;0
594;18078;20;44;26;4;22;.846;3900000;0
595;823;23;93;33;1;32;.970;3600000;0
595;1821;3;0;0;0;0;.00nan;0;0
595;2054;3;37;18;4;14;.778;3600000;0
595;10274;23;0;0;0;0;.00nan;0;0
596;1796;16;0;0;0;0;.00nan;0;0
596;2423;15;0;0;0;0;.00nan;0;0
596;4106;15;91;47;2;45;.957;3600000;0
596;15437;16;70;37;4;33;.892;3600000;0
597;335;18;0;0;0;0;.00nan;0;0
597;928;20;52;36;5;31;.861;3598000;0
597;5001;18;78;32;3;29;.906;3600000;0
597;18078;20;0;0;0;0;.00nan;0;0
598;262;35;0;0;0;0;.00nan;0;0
598;1430;35;83;48;3;45;.938;3546000;0
598;4450;5;74;26;2;24;.923;3600000;0
598;19823;5;0;0;0;0;.00nan;0;0
599;5385;17;74;37;3;34;.919;3600000;0
599;20717;27;0;0;0;0;.00nan;0;0
599;26623;27;52;35;6;29;.829;3600000;0
599;34006;17;0;0;0;0;.00nan;0;0
600;1074;0;0;0;0;0;.00nan;0;0
600;1821;3;0;0;0;0;.00nan;0;0
600;2054;3;78;33;2;31;.939;3571000;0
600;31035;0;77;29;1;28;.966;3600000;0
601;233;29;67;25;2;23;.920;3600000;0
601;544;19;0;0;0;0;.00nan;0;0
601;18351;29;0;0;0;0;.00nan;0;0
601;31124;19;67;36;3;33;.917;3600000;0
602;51;21;0;0;0;0;.00nan;0;0
602;13842;34;68;14;0;14;1.000;1596000;0
602;15502;34;59;30;4;26;.867;2004000;0
602;25843;21;95;31;1;30;.968;3600000;0
603;1251;14;0;0;0;0;.00nan;0;0
603;2423;15;74;33;3;30;.909;3627000;0
603;4106;15;0;0;0;0;.00nan;0;0
603;25584;14;69;39;4;35;.897;3627000;0
604;61;31;0;0;0;0;.00nan;0;0
604;376;12;86;37;2;35;.946;3900000;0
604;445;12;0;0;0;0;.00nan;0;0
604;34797;31;88;38;2;36;.947;3900000;0
605;1614;25;84;27;1;26;.963;3900000;0
605;4506;33;100;46;1;45;.978;3900000;0
605;5182;25;0;0;0;0;.00nan;0;0
605;34740;33;0;0;0;0;.00nan;0;0
606;15505;8;84;41;3;38;.927;3552000;0
606;22601;26;73;30;2;28;.933;3600000;0
606;25076;8;0;0;0;0;.00nan;0;0
606;32754;26;0;0;0;0;.00nan;0;0
607;500;4182;70;33;3;30;.909;3600000;0
607;18104;10;57;37;5;32;.865;3556000;0
607;25521;4182;0;0;0;0;.00nan;0;0
607;27488;10;0;0;0;0;.00nan;0;0
608;323;9;42;20;4;16;.800;3555000;0
608;1913;30;74;31;2;29;.935;3600000;0
608;4826;30;0;0;0;0;.00nan;0;0
608;20853;9;0;0;0;0;.00nan;0;0
609;724;11;96;36;2;34;.944;3600000;0
609;15464;32;0;0;0;0;.00nan;0;0
609;16006;32;80;38;3;35;.921;3600000;0
609;21522;11;0;0;0;0;.00nan;0;0
610;1572;4838;59;35;4;31;.886;3852000;0
610;2058;28;84;40;3;37;.925;3852000;0
610;2328;4838;0;0;0;0;.00nan;0;0
610;14061;28;0;0;0;0;.00nan;0;0
611;544;19;47;33;5;28;.848;3542000;0
611;10103;24;0;0;0;0;.00nan;0;0
611;13979;24;70;26;3;23;.885;3600000;0
611;31124;19;0;0;0;0;.00nan;0;0
612;1796;16;94;26;1;25;.962;3600000;0
612;15437;16;0;0;0;0;.00nan;0;0
612;27739;22;76;51;4;47;.922;3600000;0
612;28026;22;0;0;0;0;.00nan;0;0
613;1074;0;0;0;0;0;.00nan;0;0
613;5385;17;86;37;2;35;.946;3628000;0
613;31035;0;76;33;3;30;.909;3628000;0
613;34006;17;0;0;0;0;.00nan;0;0
614;233;29;0;0;0;0;.00nan;0;0
614;4450;5;0;0;0;0;.00nan;0;0
614;18351;29;100;40;1;39;.975;3600000;0
614;19823;5;66;23;2;21;.913;3578000;0
615;1251;14;56;26;3;23;.885;3560000;0
615;20717;27;85;37;2;35;.946;3600000;0
615;25584;14;0;0;0;0;.00nan;0;0
615;26623;27;0;0;0;0;.00nan;0;0
616;61;31;0;0;0;0;.00nan;0;0
616;10103;24;81;39;3;36;.923;3900000;0
616;13979;24;0;0;0;0;.00nan;0;0
616;34797;31;92;40;3;37;.925;3900000;0
617;51;21;0;0;0;0;.00nan;0;0
617;13842;34;83;54;4;50;.926;3863000;0
617;15502;34;0;0;0;0;.00nan;0;0
617;25843;21;50;23;4;19;.826;3900000;0
618;376;12;0;0;0;0;.00nan;0;0
618;445;12;89;36;2;34;.944;3600000;0
618;2423;15;88;39;3;36;.923;3552000;0
618;4106;15;0;0;0;0;.00nan;0;0
619;262;35;67;23;2;21;.913;2009000;0
619;1430;35;21;20;5;15;.750;1591000;0
619;27739;22;0;0;0;0;.00nan;0;0
619;28026;22;47;23;4;19;.826;3600000;0
620;1572;4838;0;0;0;0;.00nan;0;0
620;2328;4838;51;31;4;27;.871;3600000;0
620;4506;33;37;31;5;26;.839;3543000;0
620;34740;33;0;0;0;0;.00nan;0;0
621;1614;25;100;35;2;33;.943;3600000;0
621;1821;3;0;0;0;0;.00nan;0;0
621;2054;3;78;37;3;34;.919;3585000;0
621;5182;25;0;0;0;0;.00nan;0;0
622;823;23;75;46;5;41;.891;3600000;0
622;928;20;98;17;0;17;1.000;3600000;0
622;10274;23;0;0;0;0;.00nan;0;0
622;18078;20;0;0;0;0;.00nan;0;0
623;15464;32;0;0;0;0;.00nan;0;0
623;16006;32;43;17;3;14;.824;3600000;0
623;22601;26;91;18;0;18;1.000;3600000;0
623;32754;26;0;0;0;0;.00nan;0;0
624;335;18;0;0;0;0;.00nan;0;0
624;2058;28;57;35;4;31;.886;3600000;0
624;5001;18;85;19;0;19;1.000;3600000;0
624;14061;28;0;0;0;0;.00nan;0;0
625;500;4182;86;37;3;34;.919;3600000;0
625;15505;8;72;45;5;40;.889;3583000;0
625;25076;8;0;0;0;0;.00nan;0;0
625;25521;4182;0;0;0;0;.00nan;0;0
626;1913;30;89;39;2;37;.949;3572000;0
626;4826;30;0;0;0;0;.00nan;0;0
626;18104;10;0;0;0;0;.00nan;0;0
626;27488;10;64;17;1;16;.941;3600000;0
627;323;9;79;46;5;41;.891;3600000;0
627;724;11;0;0;0;0;.00nan;0;0
627;20853;9;0;0;0;0;.00nan;0;0
627;21522;11;100;27;0;27;1.000;3600000;0
628;376;12;48;40;6;34;.850;3600000;0
628;445;12;0;0;0;0;.00nan;0;0
628;1796;16;90;32;1;31;.969;3600000;0
628;15437;16;0;0;0;0;.00nan;0;0
629;1074;0;0;0;0;0;.00nan;0;0
629;13842;34;0;0;0;0;.00nan;0;0
629;15502;34;99;23;0;23;1.000;3600000;0
629;31035;0;66;24;2;22;.917;3550000;0
630;51;21;0;0;0;0;.00nan;0;0
630;233;29;0;0;0;0;.00nan;0;0
630;18351;29;71;16;1;15;.938;3588000;0
630;25843;21;86;15;0;15;1.000;3600000;0
631;4450;5;72;37;4;33;.892;3540000;0
631;19823;5;0;0;0;0;.00nan;0;0
631;27739;22;0;0;0;0;.00nan;0;0
631;28026;22;60;32;3;29;.906;3600000;0
632;262;35;77;41;5;36;.878;3600000;0
632;1430;35;0;0;0;0;.00nan;0;0
632;4506;33;83;29;2;27;.931;3600000;0
632;34740;33;0;0;0;0;.00nan;0;0
633;1572;4838;82;45;4;41;.911;3600000;0
633;1614;25;66;17;1;16;.941;3600000;0
633;2328;4838;0;0;0;0;.00nan;0;0
633;5182;25;0;0;0;0;.00nan;0;0
634;823;23;0;0;0;0;.00nan;0;0
634;2058;28;40;34;6;28;.824;3119000;0
634;10274;23;84;26;2;24;.923;3600000;0
634;14061;28;55;3;0;3;1.000;481000;0
635;724;11;0;0;0;0;.00nan;0;0
635;18104;10;0;0;0;0;.00nan;0;0
635;21522;11;58;40;5;35;.875;3539000;0
635;27488;10;70;34;3;31;.912;3600000;0
636;233;29;0;0;0;0;.00nan;0;0
636;5385;17;69;23;2;21;.913;3570000;0
636;18351;29;83;30;1;29;.967;3600000;0
636;34006;17;0;0;0;0;.00nan;0;0
637;61;31;100;47;0;47;1.000;3600000;0
637;335;18;0;0;0;0;.00nan;0;0
637;5001;18;56;26;4;22;.846;3600000;0
637;34797;31;0;0;0;0;.00nan;0;0
638;1251;14;0;0;0;0;.00nan;0;0
638;10103;24;0;0;0;0;.00nan;0;0
638;13979;24;69;45;7;38;.844;3600000;0
638;25584;14;78;26;2;24;.923;3600000;0
639;13842;34;0;0;0;0;.00nan;0;0
639;15502;34;54;24;3;21;.875;3535000;0
639;15505;8;99;39;1;38;.974;3600000;0
639;25076;8;0;0;0;0;.00nan;0;0
640;1614;25;0;0;0;0;.00nan;0;0
640;5182;25;64;27;3;24;.889;3600000;0
640;15464;32;51;48;7;41;.854;3600000;0
640;16006;32;0;0;0;0;.00nan;0;0
641;544;19;55;33;4;29;.879;3577000;0
641;928;20;92;35;2;33;.943;3600000;0
641;18078;20;0;0;0;0;.00nan;0;0
641;31124;19;0;0;0;0;.00nan;0;0
642;500;4182;100;25;0;25;1.000;3600000;0
642;1821;3;0;0;0;0;.00nan;0;0
642;2054;3;85;44;5;39;.886;3600000;0
642;25521;4182;0;0;0;0;.00nan;0;0
643;1913;30;0;0;0;0;.00nan;0;0
643;2423;15;65;20;2;18;.900;3600000;0
643;4106;15;0;0;0;0;.00nan;0;0
643;4826;30;88;49;3;46;.939;3544000;0
644;323;9;65;33;4;29;.879;3547000;0
644;20717;27;0;0;0;0;.00nan;0;0
644;20853;9;0;0;0;0;.00nan;0;0
644;26623;27;92;31;2;29;.935;3600000;0
645;1074;0;0;0;0;0;.00nan;0;0
645;4450;5;0;0;0;0;.00nan;0;0
645;19823;5;82;23;1;22;.957;3600000;0
645;31035;0;76;45;5;40;.889;3600000;0
646;376;12;0;0;0;0;.00nan;0;0
646;445;12;98;45;3;42;.933;3523000;0
646;1572;4838;94;31;1;30;.968;3600000;0
646;2328;4838;0;0;0;0;.00nan;0;0
647;262;35;0;0;0;0;.00nan;0;0
647;823;23;68;43;5;38;.884;3521000;0
647;1430;35;95;45;3;42;.933;3600000;0
647;10274;23;0;0;0;0;.00nan;0;0
648;1821;3;0;0;0;0;.00nan;0;0
648;2054;3;49;23;4;19;.826;3550000;0
648;22601;26;99;42;3;39;.929;3600000;0
648;32754;26;0;0;0;0;.00nan;0;0
649;1251;14;0;0;0;0;.00nan;0;0
649;4450;5;29;21;5;16;.762;3538000;0
649;19823;5;0;0;0;0;.00nan;0;0
649;25584;14;70;28;3;25;.893;3600000;0
650;323;9;57;24;3;21;.875;3900000;0
650;2553;9;0;0;0;0;.00nan;0;0
650;4506;33;77;33;3;30;.909;3900000;0
650;34740;33;0;0;0;0;.00nan;0;0
651;233;29;0;0;0;0;.00nan;0;0
651;335;18;84;35;2;33;.943;3600000;0
651;5001;18;0;0;0;0;.00nan;0;0
651;18351;29;61;31;5;26;.839;3600000;0
652;51;21;0;0;0;0;.00nan;0;0
652;928;20;65;30;3;27;.900;3600000;0
652;18078;20;0;0;0;0;.00nan;0;0
652;25843;21;100;25;0;25;1.000;3600000;0
653;10103;24;0;0;0;0;.00nan;0;0
653;13842;34;0;0;0;0;.00nan;0;0
653;13979;24;56;26;3;23;.885;3600000;0
653;15502;34;83;41;4;37;.902;3600000;0
654;1074;0;35;31;6;25;.806;3600000;0
654;15505;8;65;38;4;34;.895;3600000;0
654;25076;8;0;0;0;0;.00nan;0;0
654;31035;0;0;0;0;0;.00nan;0;0
655;1572;4838;0;0;0;0;.00nan;0;0
655;1796;16;0;0;0;0;.00nan;0;0
655;2328;4838;72;34;3;31;.912;3900000;0
655;15437;16;78;35;3;32;.914;3900000;0
656;5385;17;72;33;3;30;.909;3600000;0
656;15464;32;0;0;0;0;.00nan;0;0
656;16006;32;38;22;4;18;.818;3577000;0
656;34006;17;0;0;0;0;.00nan;0;0
657;544;19;61;23;2;21;.913;3600000;0
657;2058;28;67;38;4;34;.895;3600000;0
657;14061;28;0;0;0;0;.00nan;0;0
657;31124;19;0;0;0;0;.00nan;0;0
658;724;11;0;0;0;0;.00nan;0;0
658;2423;15;38;31;6;25;.806;3140000;0
658;4106;15;47;6;1;5;.833;460000;0
658;21522;11;78;35;2;33;.943;3600000;0
659;18104;10;90;32;2;30;.938;3900000;0
659;20717;27;0;0;0;0;.00nan;0;0
659;26623;27;76;34;2;32;.941;3900000;0
659;27488;10;0;0;0;0;.00nan;0;0
660;61;31;100;40;2;38;.950;3821000;0
660;376;12;0;0;0;0;.00nan;0;0
660;445;12;68;32;3;29;.906;3821000;0
660;34797;31;0;0;0;0;.00nan;0;0
661;262;35;0;0;0;0;.00nan;0;0
661;1430;35;24;27;6;21;.778;3586000;0
661;1913;30;77;44;4;40;.909;3600000;0
661;4826;30;0;0;0;0;.00nan;0;0
662;1614;25;75;32;3;29;.906;3630000;0
662;5182;25;0;0;0;0;.00nan;0;0
662;22601;26;80;46;4;42;.913;3630000;0
662;32754;26;0;0;0;0;.00nan;0;0
663;500;4182;55;24;3;21;.875;3600000;0
663;823;23;0;0;0;0;.00nan;0;0
663;10274;23;79;54;5;49;.907;3558000;0
663;25521;4182;0;0;0;0;.00nan;0;0
664;4450;5;69;28;3;25;.893;3600000;0
664;15464;32;0;0;0;0;.00nan;0;0
664;16006;32;85;42;4;38;.905;3555000;0
664;19823;5;0;0;0;0;.00nan;0;0
665;51;21;0;0;0;0;.00nan;0;0
665;1074;0;0;0;0;0;.00nan;0;0
665;25843;21;83;26;1;25;.962;3816000;0
665;31035;0;84;33;2;31;.939;3816000;0
666;323;9;72;21;2;19;.905;3590000;0
666;2553;9;0;0;0;0;.00nan;0;0
666;5385;17;65;17;1;16;.941;3600000;0
666;34006;17;0;0;0;0;.00nan;0;0
667;233;29;0;0;0;0;.00nan;0;0
667;376;12;88;36;1;35;.972;3587000;0
667;445;12;0;0;0;0;.00nan;0;0
667;18351;29;100;23;0;23;1.000;3600000;0
668;61;31;0;0;0;0;.00nan;0;0
668;13842;34;56;28;3;25;.893;3540000;0
668;15502;34;0;0;0;0;.00nan;0;0
668;34797;31;100;38;1;37;.974;3600000;0
669;928;20;93;23;0;23;1.000;3600000;0
669;18078;20;0;0;0;0;.00nan;0;0
669;27739;22;54;40;6;34;.850;3600000;0
669;28026;22;0;0;0;0;.00nan;0;0
670;1251;14;0;0;0;0;.00nan;0;0
670;18104;10;41;41;7;34;.829;3600000;0
670;25584;14;61;26;3;23;.885;3600000;0
670;27488;10;0;0;0;0;.00nan;0;0
671;335;18;0;0;0;0;.00nan;0;0
671;5001;18;94;27;1;26;.963;3600000;0
671;10103;24;0;0;0;0;.00nan;0;0
671;13979;24;61;36;4;32;.889;3600000;0
672;1913;30;90;36;2;34;.944;3838000;0
672;4826;30;0;0;0;0;.00nan;0;0
672;15505;8;0;0;0;0;.00nan;0;0
672;25076;8;76;34;3;31;.912;3877000;0
673;1796;16;84;27;2;25;.926;3600000;0
673;1821;3;0;0;0;0;.00nan;0;0
673;2054;3;83;43;3;40;.930;3600000;0
673;15437;16;0;0;0;0;.00nan;0;0
674;2058;28;74;27;2;25;.926;3600000;0
674;4506;33;72;34;3;31;.912;3563000;0
674;14061;28;0;0;0;0;.00nan;0;0
674;34740;33;0;0;0;0;.00nan;0;0
675;500;4182;22;18;5;13;.722;3600000;0
675;544;19;81;37;2;35;.946;3600000;0
675;25521;4182;0;0;0;0;.00nan;0;0
675;31124;19;0;0;0;0;.00nan;0;0
676;1614;25;0;0;0;0;.00nan;0;0
676;5182;25;92;29;1;28;.966;3600000;0
676;22601;26;74;32;3;29;.906;2553000;0
676;32754;26;28;15;4;11;.733;1047000;0
677;738;27;92;51;3;48;.941;3900000;0
677;2423;15;67;24;3;21;.875;3900000;0
677;4106;15;0;0;0;0;.00nan;0;0
677;26623;27;0;0;0;0;.00nan;0;0
678;724;11;0;0;0;0;.00nan;0;0
678;1572;4838;98;37;1;36;.973;3563000;0
678;2328;4838;0;0;0;0;.00nan;0;0
678;21522;11;100;27;0;27;1.000;3600000;0
679;335;18;0;0;0;0;.00nan;0;0
679;5001;18;43;29;5;24;.828;3900000;0
679;27739;22;0;0;0;0;.00nan;0;0
679;28026;22;67;48;5;43;.896;3900000;0
680;823;23;86;36;3;33;.917;3545000;0
680;4506;33;0;0;0;0;.00nan;0;0
680;10274;23;0;0;0;0;.00nan;0;0
680;34740;33;78;31;2;29;.935;3600000;0
681;323;9;57;37;4;33;.892;3600000;0
681;2553;9;0;0;0;0;.00nan;0;0
681;5385;17;5;21;7;14;.667;2230000;0
681;34006;17;50;12;2;10;.833;1370000;0
682;51;21;0;0;0;0;.00nan;0;0
682;1821;3;52;4;0;4;1.000;694000;0
682;2054;3;2;24;8;16;.667;2906000;0
682;25843;21;65;32;3;29;.906;3600000;0
683;928;20;58;23;2;21;.913;3600000;0
683;1251;14;0;0;0;0;.00nan;0;0
683;18078;20;0;0;0;0;.00nan;0;0
683;25584;14;69;26;3;23;.885;3600000;0
684;1796;16;72;29;2;27;.931;3600000;0
684;15437;16;0;0;0;0;.00nan;0;0
684;15464;32;0;0;0;0;.00nan;0;0
684;16006;32;32;32;6;26;.813;3600000;0
685;262;35;0;0;0;0;.00nan;0;0
685;1430;35;86;36;2;34;.944;3545000;0
685;1614;25;71;22;1;21;.955;3600000;0
685;4716;25;0;0;0;0;.00nan;0;0
686;1074;0;0;0;0;0;.00nan;0;0
686;22601;26;72;31;3;28;.903;3576000;0
686;31035;0;76;31;2;29;.935;3600000;0
686;32754;26;0;0;0;0;.00nan;0;0
687;500;4182;50;26;4;22;.846;3644000;0
687;2423;15;83;42;3;39;.929;3644000;0
687;4106;15;0;0;0;0;.00nan;0;0
687;25521;4182;0;0;0;0;.00nan;0;0
688;724;11;0;0;0;0;.00nan;0;0
688;738;27;0;0;0;0;.00nan;0;0
688;21522;11;68;33;3;30;.909;3600000;0
688;26623;27;81;41;4;37;.902;3551000;0
689;1572;4838;75;28;2;26;.929;3573000;0
689;2328;4838;0;0;0;0;.00nan;0;0
689;15505;8;92;31;1;30;.968;3600000;0
689;25076;8;0;0;0;0;.00nan;0;0
690;4450;5;100;28;0;28;1.000;3600000;0
690;10103;24;54;4;0;4;1.000;612000;0
690;13979;24;58;48;6;42;.875;2988000;0
690;19823;5;0;0;0;0;.00nan;0;0
691;2058;28;83;26;1;25;.962;3600000;0
691;5385;17;55;25;3;22;.880;2494000;0
691;14061;28;0;0;0;0;.00nan;0;0
691;34006;17;36;19;4;15;.789;1106000;0
692;928;20;0;0;0;0;.00nan;0;0
692;13842;34;41;32;5;27;.844;3600000;0
692;15502;34;0;0;0;0;.00nan;0;0
692;18078;20;98;28;1;27;.964;3600000;0
693;323;9;58;26;3;23;.885;3600000;0
693;1251;14;79;23;2;21;.913;3600000;0
693;2553;9;0;0;0;0;.00nan;0;0
693;25584;14;0;0;0;0;.00nan;0;0
694;4506;33;28;27;6;21;.778;3600000;0
694;27739;22;0;0;0;0;.00nan;0;0
694;28026;22;88;45;2;43;.956;3600000;0
694;34740;33;0;0;0;0;.00nan;0;0
695;335;18;0;0;0;0;.00nan;0;0
695;5001;18;68;30;3;27;.900;3560000;0
695;15464;32;66;24;2;22;.917;3600000;0
695;16006;32;0;0;0;0;.00nan;0;0
696;376;12;0;0;0;0;.00nan;0;0
696;445;12;62;21;2;19;.905;3600000;0
696;1074;0;0;0;0;0;.00nan;0;0
696;31035;0;58;45;6;39;.867;3600000;0
697;61;31;54;32;5;27;.844;3600000;0
697;544;19;89;31;1;30;.968;3600000;0
697;31124;19;0;0;0;0;.00nan;0;0
697;34797;31;0;0;0;0;.00nan;0;0
698;823;23;0;0;0;0;.00nan;0;0
698;10274;23;71;40;4;36;.900;3600000;0
698;15505;8;0;0;0;0;.00nan;0;0
698;25076;8;48;36;5;31;.861;3576000;0
699;233;29;0;0;0;0;.00nan;0;0
699;724;11;92;42;3;39;.929;3546000;0
699;18351;29;70;23;2;21;.913;3600000;0
699;21522;11;0;0;0;0;.00nan;0;0
700;51;21;0;0;0;0;.00nan;0;0
700;22601;26;85;29;1;28;.966;3600000;0
700;25843;21;72;27;2;25;.926;3600000;0
700;32754;26;0;0;0;0;.00nan;0;0
701;1821;3;0;0;0;0;.00nan;0;0
701;2054;3;49;38;5;33;.868;3555000;0
701;18104;10;0;0;0;0;.00nan;0;0
701;27488;10;52;30;4;26;.867;3600000;0
702;1614;25;78;22;2;20;.909;3900000;0
702;1913;30;97;58;2;56;.966;3900000;0
702;4716;25;0;0;0;0;.00nan;0;0
702;4826;30;0;0;0;0;.00nan;0;0
703;4450;5;60;29;4;25;.862;3532000;0
703;19823;5;0;0;0;0;.00nan;0;0
703;27739;22;0;0;0;0;.00nan;0;0
703;28026;22;81;39;2;37;.949;3600000;0
704;376;12;0;0;0;0;.00nan;0;0
704;445;12;73;35;3;32;.914;3600000;0
704;5385;17;43;28;5;23;.821;2156000;0
704;34006;17;63;9;0;9;1.000;1392000;0
705;1251;14;66;10;0;10;1.000;1235000;0
705;13842;34;0;0;0;0;.00nan;0;0
705;15502;34;76;33;3;30;.909;3600000;0
705;25584;14;40;23;4;19;.826;2333000;0
706;2058;28;56;32;4;28;.875;3600000;0
706;2423;15;0;0;0;0;.00nan;0;0
706;4106;15;58;12;1;11;.917;3600000;0
706;14061;28;0;0;0;0;.00nan;0;0
707;4506;33;86;24;1;23;.958;3600000;0
707;15464;32;0;0;0;0;.00nan;0;0
707;16006;32;63;24;3;21;.875;3555000;0
707;34740;33;0;0;0;0;.00nan;0;0
708;61;31;0;0;0;0;.00nan;0;0
708;823;23;0;0;0;0;.00nan;0;0
708;10274;23;80;42;4;38;.905;3598000;0
708;34797;31;100;54;3;51;.944;3600000;0
709;500;4182;48;21;4;17;.810;3600000;0
709;1074;0;72;17;1;16;.941;650000;0
709;25521;4182;0;0;0;0;.00nan;0;0
709;31035;0;47;33;6;27;.818;2950000;0
710;724;11;0;0;0;0;.00nan;0;0
710;1614;25;0;0;0;0;.00nan;0;0
710;4716;25;55;29;4;25;.862;3600000;0
710;21522;11;80;42;3;39;.929;3600000;0
711;738;27;61;23;3;20;.870;3583000;0
711;1572;4838;99;50;1;49;.980;3600000;0
711;2328;4838;0;0;0;0;.00nan;0;0
711;26623;27;0;0;0;0;.00nan;0;0
712;323;9;46;27;4;23;.852;3900000;0
712;376;12;0;0;0;0;.00nan;0;0
712;445;12;64;31;4;27;.871;3900000;0
712;20853;9;0;0;0;0;.00nan;0;0
713;928;20;68;18;1;17;.944;3600000;0
713;18078;20;0;0;0;0;.00nan;0;0
713;22601;26;68;44;5;39;.886;3600000;0
713;32754;26;0;0;0;0;.00nan;0;0
714;10103;24;0;0;0;0;.00nan;0;0
714;13979;24;99;31;1;30;.968;3600000;0
714;18104;10;0;0;0;0;.00nan;0;0
714;27488;10;95;40;3;37;.925;3543000;0
715;2423;15;97;41;1;40;.976;3558000;0
715;4106;15;0;0;0;0;.00nan;0;0
715;13842;34;100;29;0;29;1.000;3600000;0
715;15502;34;0;0;0;0;.00nan;0;0
716;262;35;0;0;0;0;.00nan;0;0
716;1430;35;74;47;4;43;.915;3528000;0
716;15505;8;97;42;2;40;.952;3600000;0
716;25076;8;0;0;0;0;.00nan;0;0
717;61;31;89;45;4;41;.911;3630000;0
717;335;18;0;0;0;0;.00nan;0;0
717;5001;18;64;38;5;33;.868;3630000;0
717;34797;31;0;0;0;0;.00nan;0;0
718;233;29;41;14;3;11;.786;3035000;0
718;1913;30;61;36;4;32;.889;3600000;0
718;4826;30;0;0;0;0;.00nan;0;0
718;18351;29;25;7;3;4;.571;545000;0
719;1572;4838;0;0;0;0;.00nan;0;0
719;1796;16;38;29;5;24;.828;3600000;0
719;2328;4838;81;34;2;32;.941;3600000;0
719;15437;16;0;0;0;0;.00nan;0;0
720;4450;5;94;30;1;29;.967;3600000;0
720;4506;33;87;39;2;37;.949;3544000;0
720;19823;5;0;0;0;0;.00nan;0;0
720;34740;33;0;0;0;0;.00nan;0;0
721;1251;14;0;0;0;0;.00nan;0;0
721;5385;17;0;0;0;0;.00nan;0;0
721;25584;14;62;24;2;22;.917;3900000;0
721;34006;17;74;27;2;25;.926;3877000;0
722;928;20;0;0;0;0;.00nan;0;0
722;1821;3;0;0;0;0;.00nan;0;0
722;2054;3;74;40;3;37;.925;3560000;0
722;18078;20;72;25;2;23;.920;3600000;0
723;51;21;0;0;0;0;.00nan;0;0
723;10103;24;0;0;0;0;.00nan;0;0
723;13979;24;60;31;4;27;.871;3600000;0
723;25843;21;20;25;6;19;.760;3600000;0
724;18104;10;100;43;0;43;1.000;3900000;0
724;22601;26;0;0;0;0;.00nan;0;0
724;27488;10;0;0;0;0;.00nan;0;0
724;32754;26;96;30;0;30;1.000;3900000;0
725;2058;28;73;39;3;36;.923;3900000;0
725;14061;28;0;0;0;0;.00nan;0;0
725;27739;22;81;39;3;36;.923;3900000;0
725;28026;22;0;0;0;0;.00nan;0;0
726;323;9;0;0;0;0;.00nan;0;0
726;15464;32;98;34;1;33;.971;3600000;0
726;16006;32;0;0;0;0;.00nan;0;0
726;20853;9;64;31;3;28;.903;3542000;0
727;262;35;75;32;3;29;.906;3600000;0
727;1430;35;0;0;0;0;.00nan;0;0
727;15505;8;66;25;2;23;.920;3111000;0
727;25076;8;35;10;3;7;.700;477000;0
728;1074;0;0;0;0;0;.00nan;0;0
728;1614;25;60;28;3;25;.893;3600000;0
728;4716;25;0;0;0;0;.00nan;0;0
728;31035;0;100;43;2;41;.953;3600000;0
729;544;19;0;0;0;0;.00nan;0;0
729;823;23;0;0;0;0;.00nan;0;0
729;10274;23;80;35;3;32;.914;3551000;0
729;31124;19;71;21;1;20;.952;3600000;0
730;233;29;0;0;0;0;.00nan;0;0
730;738;27;40;35;6;29;.829;3534000;0
730;18351;29;44;24;4;20;.833;3600000;0
730;26623;27;0;0;0;0;.00nan;0;0
731;51;21;90;27;1;26;.963;3600000;0
731;724;11;0;0;0;0;.00nan;0;0
731;21522;11;54;36;5;31;.861;3600000;0
731;25843;21;0;0;0;0;.00nan;0;0
732;2423;15;68;29;3;26;.897;3600000;0
732;4106;15;0;0;0;0;.00nan;0;0
732;4506;33;55;32;4;28;.875;3553000;0
732;34740;33;0;0;0;0;.00nan;0;0
733;2058;28;68;29;3;26;.897;3600000;0
733;13842;34;37;38;6;32;.842;3016000;0
733;14061;28;0;0;0;0;.00nan;0;0
733;15502;34;58;5;0;5;1.000;584000;0
734;335;18;58;34;4;30;.882;3600000;0
734;1796;16;68;21;1;20;.952;3600000;0
734;5001;18;0;0;0;0;.00nan;0;0
734;15437;16;0;0;0;0;.00nan;0;0
735;61;31;0;0;0;0;.00nan;0;0
735;1572;4838;42;36;6;30;.833;3075000;0
735;2328;4838;58;7;0;7;1.000;525000;0
735;34797;31;65;20;2;18;.900;3600000;0
736;1913;30;48;36;6;30;.833;2676000;0
736;4450;5;83;19;0;19;1.000;3600000;0
736;4826;30;67;13;0;13;1.000;924000;0
736;19823;5;0;0;0;0;.00nan;0;0
737;724;11;0;0;0;0;.00nan;0;0
737;18104;10;0;0;0;0;.00nan;0;0
737;21522;11;88;34;4;30;.882;3642000;0
737;27488;10;63;27;3;24;.889;3642000;0
738;376;12;0;0;0;0;.00nan;0;0
738;445;12;46;14;2;12;.857;3600000;0
738;1251;14;71;13;0;13;1.000;1408000;0
738;25584;14;31;30;6;24;.800;2192000;0
739;500;4182;80;28;1;27;.964;3600000;0
739;25521;4182;0;0;0;0;.00nan;0;0
739;27739;22;30;16;4;12;.750;1505000;0
739;28026;22;62;21;2;19;.905;2095000;0
740;262;35;0;0;0;0;.00nan;0;0
740;1074;0;0;0;0;0;.00nan;0;0
740;1430;35;57;23;3;20;.870;3585000;0
740;31035;0;74;31;2;29;.935;3600000;0
741;1614;25;53;37;5;32;.865;3600000;0
741;4716;25;0;0;0;0;.00nan;0;0
741;15505;8;82;39;3;36;.923;3600000;0
741;25076;8;0;0;0;0;.00nan;0;0
742;544;19;65;26;2;24;.923;3565000;0
742;1796;16;0;0;0;0;.00nan;0;0
742;15437;16;93;31;1;30;.968;3600000;0
742;31124;19;0;0;0;0;.00nan;0;0
743;2058;28;0;0;0;0;.00nan;0;0
743;5385;17;0;0;0;0;.00nan;0;0
743;14061;28;83;43;4;39;.907;3538000;0
743;34006;17;91;39;2;37;.949;3600000;0
744;51;21;0;0;0;0;.00nan;0;0
744;376;12;96;37;2;35;.946;3600000;0
744;445;12;0;0;0;0;.00nan;0;0
744;25843;21;64;23;3;20;.870;3594000;0
745;928;20;62;26;2;24;.923;3600000;0
745;1251;14;0;0;0;0;.00nan;0;0
745;18078;20;0;0;0;0;.00nan;0;0
745;25584;14;22;31;7;24;.774;3600000;0
746;2423;15;66;34;4;30;.882;3600000;0
746;4106;15;0;0;0;0;.00nan;0;0
746;22601;26;0;0;0;0;.00nan;0;0
746;32754;26;49;44;6;38;.864;3594000;0
747;500;4182;0;0;0;0;.00nan;0;0
747;10103;24;0;0;0;0;.00nan;0;0
747;13979;24;62;41;5;36;.878;3900000;0
747;25521;4182;44;34;5;29;.853;3900000;0
748;61;31;0;0;0;0;.00nan;0;0
748;4506;33;62;28;3;25;.893;3600000;0
748;34740;33;0;0;0;0;.00nan;0;0
748;34797;31;96;38;2;36;.947;3600000;0
749;335;18;0;0;0;0;.00nan;0;0
749;823;23;79;41;3;38;.927;3600000;0
749;5001;18;100;34;1;33;.971;3600000;0
749;10274;23;0;0;0;0;.00nan;0;0
750;1572;4838;54;38;5;33;.868;3600000;0
750;2328;4838;0;0;0;0;.00nan;0;0
750;15464;32;100;24;0;24;1.000;3600000;0
750;16006;32;0;0;0;0;.00nan;0;0
751;1821;3;0;0;0;0;.00nan;0;0
751;1913;30;81;48;4;44;.917;3900000;0
751;2054;3;31;17;4;13;.765;3900000;0
751;4826;30;0;0;0;0;.00nan;0;0
752;323;9;51;32;4;28;.875;3549000;0
752;15505;8;79;37;3;34;.919;3600000;0
752;20853;9;0;0;0;0;.00nan;0;0
752;25076;8;0;0;0;0;.00nan;0;0
753;738;27;62;40;5;35;.875;3900000;0
753;26623;27;0;0;0;0;.00nan;0;0
753;27739;22;0;0;0;0;.00nan;0;0
753;28026;22;39;28;5;23;.821;3900000;0
754;544;19;48;30;5;25;.833;3547000;0
754;13842;34;0;0;0;0;.00nan;0;0
754;15502;34;79;49;4;45;.918;3600000;0
754;31124;19;0;0;0;0;.00nan;0;0
755;1614;25;58;29;4;25;.862;3574000;0
755;4450;5;79;32;2;30;.938;3600000;0
755;4716;25;0;0;0;0;.00nan;0;0
755;19823;5;0;0;0;0;.00nan;0;0
756;1074;0;82;25;1;24;.960;3600000;0
756;1913;30;0;0;0;0;.00nan;0;0
756;4826;30;20;29;7;22;.759;3600000;0
756;31035;0;0;0;0;0;.00nan;0;0
757;2058;28;87;52;3;49;.942;3600000;0
757;10103;24;0;0;0;0;.00nan;0;0
757;13979;24;74;35;4;31;.886;3562000;0
757;14061;28;0;0;0;0;.00nan;0;0
758;51;21;0;0;0;0;.00nan;0;0
758;233;29;0;0;0;0;.00nan;0;0
758;18351;29;84;29;2;27;.931;3600000;0
758;25843;21;76;33;4;29;.879;3526000;0
759;61;31;100;26;0;26;1.000;3600000;0
759;500;4182;65;30;3;27;.900;3600000;0
759;25521;4182;0;0;0;0;.00nan;0;0
759;34797;31;0;0;0;0;.00nan;0;0
760;724;11;0;0;0;0;.00nan;0;0
760;928;20;74;32;3;29;.906;3552000;0
760;18078;20;0;0;0;0;.00nan;0;0
760;21522;11;79;29;2;27;.931;3600000;0
761;1572;4838;0;0;0;0;.00nan;0;0
761;2328;4838;96;53;3;50;.943;3900000;0
761;2423;15;59;25;3;22;.880;3900000;0
761;4106;15;0;0;0;0;.00nan;0;0
762;13842;34;80;33;2;31;.939;3573000;0
762;15502;34;0;0;0;0;.00nan;0;0
762;18104;10;0;0;0;0;.00nan;0;0
762;27488;10;98;22;0;22;1.000;3600000;0
763;544;19;0;0;0;0;.00nan;0;0
763;1796;16;41;23;4;19;.826;3600000;0
763;15437;16;0;0;0;0;.00nan;0;0
763;31124;19;99;49;1;48;.980;3600000;0
764;335;18;65;30;3;27;.900;3600000;0
764;4506;33;71;38;4;34;.895;3548000;0
764;5001;18;0;0;0;0;.00nan;0;0
764;34740;33;0;0;0;0;.00nan;0;0
765;823;23;0;0;0;0;.00nan;0;0
765;10274;23;64;38;4;34;.895;3745000;0
765;15464;32;56;23;3;20;.870;3745000;0
765;16006;32;0;0;0;0;.00nan;0;0
766;262;35;0;0;0;0;.00nan;0;0
766;1430;35;78;24;1;23;.958;3600000;0
766;18104;10;80;31;2;29;.935;3600000;0
766;27488;10;0;0;0;0;.00nan;0;0
767;323;9;69;38;4;34;.895;3600000;0
767;2423;15;0;0;0;0;.00nan;0;0
767;4106;15;100;27;0;27;1.000;3600000;0
767;20853;9;0;0;0;0;.00nan;0;0
768;1614;25;62;18;1;17;.944;3600000;0
768;4716;25;0;0;0;0;.00nan;0;0
768;15505;8;74;41;4;37;.902;3600000;0
768;25076;8;0;0;0;0;.00nan;0;0
769;376;12;0;0;0;0;.00nan;0;0
769;445;12;75;38;3;35;.921;3600000;0
769;27739;22;0;0;0;0;.00nan;0;0
769;28026;22;80;32;2;30;.938;3600000;0
770;4450;5;63;22;2;20;.909;3888000;0
770;19823;5;0;0;0;0;.00nan;0;0
770;22601;26;61;28;3;25;.893;3888000;0
770;32754;26;0;0;0;0;.00nan;0;0
771;823;23;0;0;0;0;.00nan;0;0
771;1074;0;0;0;0;0;.00nan;0;0
771;10274;23;53;29;4;25;.862;3529000;0
771;31035;0;84;35;2;33;.943;3600000;0
772;1913;30;72;27;3;24;.889;3600000;0
772;2058;28;28;17;4;13;.765;938000;0
772;4826;30;0;0;0;0;.00nan;0;0
772;14061;28;83;21;1;20;.952;2593000;0
773;323;9;0;0;0;0;.00nan;0;0
773;1821;3;0;0;0;0;.00nan;0;0
773;2054;3;55;22;3;19;.864;3600000;0
773;20853;9;79;39;4;35;.897;3591000;0
774;233;29;0;0;0;0;.00nan;0;0
774;500;4182;40;29;5;24;.828;3600000;0
774;18351;29;80;21;1;20;.952;3600000;0
774;25521;4182;0;0;0;0;.00nan;0;0
775;61;31;82;17;1;16;.941;3600000;0
775;738;27;83;51;4;47;.922;3600000;0
775;26623;27;0;0;0;0;.00nan;0;0
775;34797;31;0;0;0;0;.00nan;0;0
776;928;20;65;20;1;19;.950;3600000;0
776;1572;4838;83;46;4;42;.913;3600000;0
776;2328;4838;0;0;0;0;.00nan;0;0
776;18078;20;0;0;0;0;.00nan;0;0
777;724;11;0;0;0;0;.00nan;0;0
777;1251;14;94;42;2;40;.952;3644000;0
777;21522;11;86;35;3;32;.914;3644000;0
777;25584;14;0;0;0;0;.00nan;0;0
778;51;21;0;0;0;0;.00nan;0;0
778;10103;24;0;0;0;0;.00nan;0;0
778;13979;24;62;36;4;32;.889;3518000;0
778;25843;21;94;34;2;32;.941;3600000;0
779;1796;16;81;26;1;25;.962;3600000;0
779;4506;33;76;31;3;28;.903;3528000;0
779;15437;16;0;0;0;0;.00nan;0;0
779;34740;33;0;0;0;0;.00nan;0;0
780;335;18;0;0;0;0;.00nan;0;0
780;544;19;32;32;6;26;.813;3600000;0
780;5001;18;70;31;3;28;.903;3600000;0
780;31124;19;0;0;0;0;.00nan;0;0
781;5385;17;0;0;0;0;.00nan;0;0
781;22601;26;0;0;0;0;.00nan;0;0
781;32754;26;46;27;4;23;.852;3643000;0
781;34006;17;46;30;5;25;.833;3643000;0
782;1074;0;89;30;1;29;.967;3600000;0
782;13842;34;0;0;0;0;.00nan;0;0
782;15502;34;98;46;2;44;.957;3547000;0
782;31035;0;0;0;0;0;.00nan;0;0
783;262;35;0;0;0;0;.00nan;0;0
783;928;20;0;0;0;0;.00nan;0;0
783;1430;35;94;41;2;39;.951;3900000;0
783;18078;20;55;12;1;11;.917;3900000;0
784;1572;4838;0;0;0;0;.00nan;0;0
784;2328;4838;90;43;2;41;.953;3578000;0
784;18104;10;0;0;0;0;.00nan;0;0
784;27488;10;82;16;0;16;1.000;3600000;0
785;724;11;41;29;5;24;.828;3900000;0
785;2423;15;0;0;0;0;.00nan;0;0
785;4106;15;42;35;5;30;.857;3900000;0
785;21522;11;0;0;0;0;.00nan;0;0
786;738;27;79;37;3;34;.919;3600000;0
786;10103;24;80;20;1;19;.950;3600000;0
786;13979;24;0;0;0;0;.00nan;0;0
786;26623;27;0;0;0;0;.00nan;0;0
787;1796;16;0;0;0;0;.00nan;0;0
787;15437;16;69;21;1;20;.952;3600000;0
787;15505;8;84;52;5;47;.904;3600000;0
787;25076;8;0;0;0;0;.00nan;0;0
788;376;12;0;0;0;0;.00nan;0;0
788;445;12;86;53;3;50;.943;3600000;0
788;4450;5;22;12;5;7;.583;1648000;0
788;19823;5;51;10;1;9;.900;1952000;0
789;1614;25;43;19;3;16;.842;3566000;0
789;4716;25;0;0;0;0;.00nan;0;0
789;5385;17;100;42;1;41;.976;3600000;0
789;34006;17;0;0;0;0;.00nan;0;0
790;823;23;60;18;2;16;.889;3600000;0
790;2058;28;52;34;6;28;.824;3600000;0
790;10274;23;0;0;0;0;.00nan;0;0
790;14061;28;0;0;0;0;.00nan;0;0
791;323;9;0;0;0;0;.00nan;0;0
791;1913;30;86;33;2;31;.939;3616000;0
791;4826;30;0;0;0;0;.00nan;0;0
791;20853;9;69;18;1;17;.944;3616000;0
792;61;31;89;26;1;25;.962;3600000;0
792;13842;34;66;26;3;23;.885;3544000;0
792;15502;34;0;0;0;0;.00nan;0;0
792;34797;31;0;0;0;0;.00nan;0;0
793;335;18;0;0;0;0;.00nan;0;0
793;5001;18;57;32;4;28;.875;3600000;0
793;15505;8;0;0;0;0;.00nan;0;0
793;25076;8;82;34;2;32;.941;3600000;0
794;1572;4838;51;51;7;44;.863;3600000;0
794;2328;4838;0;0;0;0;.00nan;0;0
794;4450;5;0;0;0;0;.00nan;0;0
794;19823;5;66;21;1;20;.952;3600000;0
795;1074;0;0;0;0;0;.00nan;0;0
795;1796;16;0;0;0;0;.00nan;0;0
795;15437;16;51;25;3;22;.880;3563000;0
795;31035;0;90;38;1;37;.974;3600000;0
796;233;29;0;0;0;0;.00nan;0;0
796;738;27;80;43;5;38;.884;3600000;0
796;18351;29;80;26;2;24;.923;3600000;0
796;26623;27;0;0;0;0;.00nan;0;0
797;51;21;0;0;0;0;.00nan;0;0
797;1821;3;0;0;0;0;.00nan;0;0
797;2054;3;90;45;3;42;.933;3600000;0
797;25843;21;84;31;1;30;.968;3600000;0
798;928;20;97;34;2;32;.941;3900000;0
798;2058;28;0;0;0;0;.00nan;0;0
798;14061;28;89;35;2;33;.943;3900000;0
798;18078;20;0;0;0;0;.00nan;0;0
799;61;31;0;0;0;0;.00nan;0;0
799;18104;10;49;24;4;20;.833;3600000;0
799;27488;10;0;0;0;0;.00nan;0;0
799;34797;31;100;42;0;42;1.000;3600000;0
800;1251;14;68;41;4;37;.902;3600000;0
800;4506;33;100;25;0;25;1.000;3600000;0
800;25584;14;0;0;0;0;.00nan;0;0
800;34740;33;0;0;0;0;.00nan;0;0
801;2423;15;90;42;3;39;.929;3600000;0
801;4106;15;0;0;0;0;.00nan;0;0
801;27739;22;0;0;0;0;.00nan;0;0
801;28026;22;84;24;1;23;.958;3600000;0
802;335;18;67;36;4;32;.889;3520000;0
802;5001;18;0;0;0;0;.00nan;0;0
802;15464;32;80;35;2;33;.943;3600000;0
802;16006;32;0;0;0;0;.00nan;0;0
803;376;12;0;0;0;0;.00nan;0;0
803;445;12;39;23;4;19;.826;3556000;0
803;544;19;81;34;2;32;.941;3600000;0
803;31124;19;0;0;0;0;.00nan;0;0
804;1614;25;93;33;2;31;.939;3900000;0
804;4716;25;0;0;0;0;.00nan;0;0
804;22601;26;100;51;2;49;.961;3900000;0
804;32754;26;0;0;0;0;.00nan;0;0
805;500;4182;66;15;1;14;.933;3600000;0
805;5385;17;0;0;0;0;.00nan;0;0
805;25521;4182;0;0;0;0;.00nan;0;0
805;34006;17;60;49;6;43;.878;3600000;0
806;323;9;78;39;3;36;.923;3566000;0
806;724;11;0;0;0;0;.00nan;0;0
806;20853;9;0;0;0;0;.00nan;0;0
806;21522;11;72;28;2;26;.929;3600000;0
807;823;23;64;40;5;35;.875;3557000;0
807;10274;23;0;0;0;0;.00nan;0;0
807;27739;22;59;30;4;26;.867;3600000;0
807;28026;22;0;0;0;0;.00nan;0;0
808;262;35;0;0;0;0;.00nan;0;0
808;1430;35;83;42;4;38;.905;3600000;0
808;15505;8;49;38;6;32;.842;3551000;0
808;25076;8;0;0;0;0;.00nan;0;0
809;544;19;0;0;0;0;.00nan;0;0
809;22601;26;0;0;0;0;.00nan;0;0
809;31124;19;46;27;4;23;.852;3900000;0
809;32754;26;55;28;4;24;.857;3900000;0
810;323;9;68;36;3;33;.917;3562000;0
810;1251;14;0;0;0;0;.00nan;0;0
810;20853;9;0;0;0;0;.00nan;0;0
810;25584;14;82;32;2;30;.938;3600000;0
811;823;23;79;31;3;28;.903;3600000;0
811;7139;29;0;0;0;0;.00nan;0;0
811;10274;23;0;0;0;0;.00nan;0;0
811;18351;29;60;20;2;18;.900;3600000;0
812;376;12;0;0;0;0;.00nan;0;0
812;445;12;71;36;3;33;.917;3598000;0
812;4506;33;88;28;1;27;.964;3600000;0
812;34740;33;0;0;0;0;.00nan;0;0
813;724;11;0;0;0;0;.00nan;0;0
813;21522;11;93;35;1;34;.971;3600000;0
813;22601;26;98;41;2;39;.951;3600000;0
813;32754;26;0;0;0;0;.00nan;0;0
814;262;35;0;0;0;0;.00nan;0;0
814;1430;35;84;44;3;41;.932;3600000;0
814;1821;3;0;0;0;0;.00nan;0;0
814;2054;3;48;21;4;17;.810;3556000;0
815;61;31;0;0;0;0;.00nan;0;0
815;13842;34;0;0;0;0;.00nan;0;0
815;15502;34;76;31;3;28;.903;3580000;0
815;34797;31;72;16;1;15;.938;3600000;0
816;51;21;0;0;0;0;.00nan;0;0
816;2423;15;73;33;3;30;.909;3545000;0
816;4106;15;0;0;0;0;.00nan;0;0
816;25843;21;64;23;2;21;.913;3600000;0
817;18104;10;65;30;3;27;.900;3800000;0
817;27488;10;0;0;0;0;.00nan;0;0
817;27739;22;0;0;0;0;.00nan;0;0
817;28026;22;77;45;4;41;.911;3800000;0
818;376;12;0;0;0;0;.00nan;0;0
818;445;12;100;29;0;29;1.000;3600000;0
818;15464;32;81;29;2;27;.931;3600000;0
818;16006;32;0;0;0;0;.00nan;0;0
819;335;18;54;25;4;21;.840;3523000;0
819;544;19;72;33;3;30;.909;3600000;0
819;5001;18;0;0;0;0;.00nan;0;0
819;31124;19;0;0;0;0;.00nan;0;0
820;738;27;84;25;1;24;.960;3900000;0
820;928;20;84;28;1;27;.964;3900000;0
820;18078;20;0;0;0;0;.00nan;0;0
820;26623;27;0;0;0;0;.00nan;0;0
821;1572;4838;81;52;5;47;.904;3900000;0
821;2328;4838;0;0;0;0;.00nan;0;0
821;4450;5;44;30;5;25;.833;3900000;0
821;19823;5;0;0;0;0;.00nan;0;0
822;10103;24;0;0;0;0;.00nan;0;0
822;13842;34;75;38;3;35;.921;3566000;0
822;13979;24;93;29;1;28;.966;3600000;0
822;15502;34;0;0;0;0;.00nan;0;0
823;51;21;56;20;2;18;.900;3600000;0
823;15505;8;83;52;5;47;.904;3600000;0
823;25076;8;0;0;0;0;.00nan;0;0
823;25843;21;0;0;0;0;.00nan;0;0
824;1796;16;32;21;5;16;.762;3545000;0
824;5385;17;0;0;0;0;.00nan;0;0
824;14321;16;0;0;0;0;.00nan;0;0
824;34006;17;86;52;4;48;.923;3600000;0
825;1614;25;75;36;4;32;.889;3900000;0
825;4506;33;57;31;4;27;.871;3900000;0
825;4716;25;0;0;0;0;.00nan;0;0
825;34740;33;0;0;0;0;.00nan;0;0
826;500;4182;60;21;2;19;.905;3900000;0
826;22601;26;97;44;2;42;.955;3900000;0
826;25521;4182;0;0;0;0;.00nan;0;0
826;32754;26;0;0;0;0;.00nan;0;0
827;724;11;0;0;0;0;.00nan;0;0
827;1913;30;100;45;1;44;.978;3600000;0
827;4826;30;0;0;0;0;.00nan;0;0
827;21522;11;47;32;5;27;.844;3600000;0
828;323;9;0;0;0;0;.00nan;0;0
828;1821;3;97;45;2;43;.956;3545000;0
828;2054;3;0;0;0;0;.00nan;0;0
828;20853;9;95;33;1;32;.970;3600000;0
829;1074;0;0;0;0;0;.00nan;0;0
829;2058;28;61;24;3;21;.875;3548000;0
829;26824;28;0;0;0;0;.00nan;0;0
829;31035;0;77;36;2;34;.944;3600000;0
830;61;31;0;0;0;0;.00nan;0;0
830;823;23;0;0;0;0;.00nan;0;0
830;10274;23;90;39;2;37;.949;3600000;0
830;34797;31;89;52;4;48;.923;3568000;0
831;1251;14;0;0;0;0;.00nan;0;0
831;26865;14;61;25;3;22;.880;3593000;0
831;27739;22;0;0;0;0;.00nan;0;0
831;28026;22;84;31;2;29;.935;3600000;0
832;2423;15;0;0;0;0;.00nan;0;0
832;4106;15;73;29;3;26;.897;3600000;0
832;18104;10;43;37;6;31;.838;3600000;0
832;27488;10;0;0;0;0;.00nan;0;0
833;7139;29;0;0;0;0;.00nan;0;0
833;15464;32;69;24;2;22;.917;3900000;0
833;16006;32;0;0;0;0;.00nan;0;0
833;18351;29;95;47;2;45;.957;3900000;0
834;262;35;0;0;0;0;.00nan;0;0
834;544;19;0;0;0;0;.00nan;0;0
834;1430;35;95;46;2;44;.957;3900000;0
834;31124;19;90;33;2;31;.939;3900000;0
835;500;4182;95;22;0;22;1.000;3600000;0
835;1614;25;0;0;0;0;.00nan;0;0
835;4716;25;67;25;2;23;.920;3541000;0
835;25521;4182;0;0;0;0;.00nan;0;0
836;724;11;67;33;4;29;.879;3882000;0
836;928;20;69;29;3;26;.897;3882000;0
836;18078;20;0;0;0;0;.00nan;0;0
836;21522;11;0;0;0;0;.00nan;0;0
837;738;27;100;41;1;40;.976;3600000;0
837;4450;5;0;0;0;0;.00nan;0;0
837;19823;5;66;21;2;19;.905;3563000;0
837;26623;27;0;0;0;0;.00nan;0;0
838;335;18;66;27;3;24;.889;3536000;0
838;5001;18;0;0;0;0;.00nan;0;0
838;18104;10;100;30;1;29;.967;3600000;0
838;27488;10;0;0;0;0;.00nan;0;0
839;823;23;78;37;3;34;.919;3600000;0
839;10103;24;0;0;0;0;.00nan;0;0
839;10274;23;0;0;0;0;.00nan;0;0
839;13979;24;77;39;4;35;.897;3561000;0
840;2423;15;47;26;4;22;.846;2217000;0
840;4106;15;59;10;1;9;.900;1383000;0
840;13842;34;0;0;0;0;.00nan;0;0
840;15502;34;78;30;2;28;.933;3600000;0
841;1796;16;69;32;3;29;.906;3662000;0
841;14321;16;0;0;0;0;.00nan;0;0
841;15505;8;55;27;4;23;.852;3662000;0
841;25076;8;0;0;0;0;.00nan;0;0
842;376;12;0;0;0;0;.00nan;0;0
842;445;12;46;26;4;22;.846;3600000;0
842;5385;17;0;0;0;0;.00nan;0;0
842;34006;17;40;42;7;35;.833;3600000;0
843;4506;33;71;29;2;27;.931;3600000;0
843;22601;26;94;48;3;45;.938;3566000;0
843;32754;26;0;0;0;0;.00nan;0;0
843;34740;33;0;0;0;0;.00nan;0;0
844;928;20;0;0;0;0;.00nan;0;0
844;1913;30;88;44;3;41;.932;3600000;0
844;4826;30;0;0;0;0;.00nan;0;0
844;18078;20;50;35;5;30;.857;3600000;0
845;738;27;0;0;0;0;.00nan;0;0
845;1572;4838;86;37;3;34;.919;3587000;0
845;2328;4838;0;0;0;0;.00nan;0;0
845;26623;27;65;16;1;15;.938;3600000;0
846;51;21;0;0;0;0;.00nan;0;0
846;335;18;0;0;0;0;.00nan;0;0
846;5001;18;57;29;3;26;.897;3600000;0
846;25843;21;63;33;4;29;.879;3559000;0
847;1251;14;0;0;0;0;.00nan;0;0
847;1796;16;0;0;0;0;.00nan;0;0
847;14321;16;88;30;1;29;.967;3600000;0
847;26865;14;55;18;2;16;.889;3600000;0
848;1821;3;0;0;0;0;.00nan;0;0
848;2054;3;83;29;1;28;.966;3600000;0
848;27739;22;0;0;0;0;.00nan;0;0
848;28026;22;76;42;4;38;.905;3600000;0
849;724;11;0;0;0;0;.00nan;0;0
849;4450;5;72;31;2;29;.935;3549000;0
849;19823;5;0;0;0;0;.00nan;0;0
849;21522;11;100;44;1;43;.977;3600000;0
850;323;9;0;0;0;0;.00nan;0;0
850;10103;24;0;0;0;0;.00nan;0;0
850;13979;24;58;19;2;17;.895;3671000;0
850;20853;9;83;32;3;29;.906;3671000;0
851;2058;28;79;30;2;28;.933;3600000;0
851;7139;29;0;0;0;0;.00nan;0;0
851;18351;29;57;32;4;28;.875;3600000;0
851;26824;28;0;0;0;0;.00nan;0;0
852;823;23;0;0;0;0;.00nan;0;0
852;1251;14;53;21;3;18;.857;3534000;0
852;10274;23;81;21;1;20;.952;3600000;0
852;26865;14;0;0;0;0;.00nan;0;0
853;51;21;0;0;0;0;.00nan;0;0
853;13842;34;0;0;0;0;.00nan;0;0
853;15502;34;81;31;2;29;.935;3600000;0
853;25843;21;69;34;3;31;.912;3570000;0
854;262;35;0;0;0;0;.00nan;0;0
854;544;19;75;24;2;22;.917;3600000;0
854;1430;35;78;38;4;34;.895;3565000;0
854;31124;19;0;0;0;0;.00nan;0;0
855;1074;0;0;0;0;0;.00nan;0;0
855;4506;33;97;23;0;23;1.000;3600000;0
855;31035;0;68;40;4;36;.900;3600000;0
855;34740;33;0;0;0;0;.00nan;0;0
856;928;20;100;28;0;28;1.000;3600000;0
856;1614;25;68;34;3;31;.912;3600000;0
856;4716;25;0;0;0;0;.00nan;0;0
856;18078;20;0;0;0;0;.00nan;0;0
857;500;4182;53;20;3;17;.850;3900000;0
857;738;27;100;59;3;56;.949;3900000;0
857;25521;4182;0;0;0;0;.00nan;0;0
857;26623;27;0;0;0;0;.00nan;0;0
858;1913;30;30;9;3;6;.667;430000;0
858;4450;5;0;0;0;0;.00nan;0;0
858;4826;30;81;41;3;38;.927;3170000;0
858;19823;5;100;34;0;34;1.000;3600000;0
859;1821;3;0;0;0;0;.00nan;0;0
859;2054;3;78;43;4;39;.907;3900000;0
859;5385;17;70;42;4;38;.905;3900000;0
859;34006;17;0;0;0;0;.00nan;0;0
860;1796;16;85;28;2;26;.929;3600000;0
860;14321;16;0;0;0;0;.00nan;0;0
860;18104;10;30;17;4;13;.765;3585000;0
860;27488;10;0;0;0;0;.00nan;0;0
861;376;12;0;0;0;0;.00nan;0;0
861;445;12;90;28;1;27;.964;3600000;0
861;724;11;0;0;0;0;.00nan;0;0
861;21522;11;76;31;2;29;.935;3595000;0
862;1572;4838;62;50;5;45;.900;3600000;0
862;2328;4838;0;0;0;0;.00nan;0;0
862;15464;32;75;30;3;27;.900;3600000;0
862;16006;32;0;0;0;0;.00nan;0;0
863;2423;15;0;0;0;0;.00nan;0;0
863;4106;15;99;41;1;40;.976;3600000;0
863;7139;29;0;0;0;0;.00nan;0;0
863;18351;29;49;26;4;22;.846;3600000;0
864;61;31;0;0;0;0;.00nan;0;0
864;2058;28;71;48;6;42;.875;3600000;0
864;26824;28;0;0;0;0;.00nan;0;0
864;34797;31;68;20;2;18;.900;3600000;0
865;335;18;0;0;0;0;.00nan;0;0
865;928;20;97;41;2;39;.951;3600000;0
865;5001;18;60;26;3;23;.885;3549000;0
865;18078;20;0;0;0;0;.00nan;0;0
866;262;35;0;0;0;0;.00nan;0;0
866;1251;14;0;0;0;0;.00nan;0;0
866;1430;35;69;31;3;28;.903;3555000;0
866;26865;14;94;37;2;35;.946;3600000;0
867;10103;24;0;0;0;0;.00nan;0;0
867;13979;24;57;34;4;30;.882;3525000;0
867;27739;22;70;26;2;24;.923;3600000;0
867;28026;22;0;0;0;0;.00nan;0;0
868;823;23;90;26;1;25;.962;3600000;0
868;10274;23;0;0;0;0;.00nan;0;0
868;15505;8;0;0;0;0;.00nan;0;0
868;25076;8;81;47;4;43;.915;3600000;0
869;544;19;0;0;0;0;.00nan;0;0
869;1074;0;63;46;6;40;.870;3600000;0
869;31035;0;0;0;0;0;.00nan;0;0
869;31124;19;79;36;3;33;.917;3600000;0
870;1614;25;78;38;3;35;.921;3567000;0
870;4716;25;0;0;0;0;.00nan;0;0
870;22601;26;100;45;2;43;.956;3600000;0
870;32754;26;0;0;0;0;.00nan;0;0
871;500;4182;0;0;0;0;.00nan;0;0
871;4450;5;0;0;0;0;.00nan;0;0
871;19823;5;82;31;1;30;.968;3543000;0
871;25521;4182;100;26;0;26;1.000;3600000;0
872;262;35;0;0;0;0;.00nan;0;0
872;1430;35;53;31;4;27;.871;3569000;0
872;5385;17;0;0;0;0;.00nan;0;0
872;34006;17;68;28;3;25;.893;3600000;0
873;323;9;0;0;0;0;.00nan;0;0
873;7139;29;58;24;3;21;.875;3600000;0
873;18351;29;0;0;0;0;.00nan;0;0
873;20853;9;67;35;4;31;.886;3566000;0
874;51;21;0;0;0;0;.00nan;0;0
874;18104;10;0;0;0;0;.00nan;0;0
874;25843;21;69;30;3;27;.900;3600000;0
874;27488;10;64;43;5;38;.884;3554000;0
875;2423;15;72;36;3;33;.917;3581000;0
875;4106;15;0;0;0;0;.00nan;0;0
875;10103;24;94;37;1;36;.973;3600000;0
875;13979;24;0;0;0;0;.00nan;0;0
876;724;11;0;0;0;0;.00nan;0;0
876;13842;34;0;0;0;0;.00nan;0;0
876;15502;34;79;29;2;27;.931;3600000;0
876;21522;11;53;36;5;31;.861;3600000;0
877;376;12;0;0;0;0;.00nan;0;0
877;445;12;94;33;1;32;.970;3900000;0
877;4506;33;95;31;1;30;.968;3900000;0
877;34740;33;0;0;0;0;.00nan;0;0
878;500;4182;88;31;2;29;.935;3900000;0
878;1913;30;87;39;2;37;.949;3900000;0
878;4826;30;0;0;0;0;.00nan;0;0
878;25521;4182;0;0;0;0;.00nan;0;0
879;335;18;0;0;0;0;.00nan;0;0
879;1821;3;0;0;0;0;.00nan;0;0
879;2054;3;81;48;4;44;.917;3582000;0
879;5001;18;75;35;3;32;.914;3600000;0
880;61;31;0;0;0;0;.00nan;0;0
880;323;9;41;36;6;30;.833;3600000;0
880;20853;9;0;0;0;0;.00nan;0;0
880;34797;31;100;32;0;32;1.000;3600000;0
881;928;20;71;24;2;22;.917;3600000;0
881;1796;16;83;36;3;33;.917;3549000;0
881;14321;16;0;0;0;0;.00nan;0;0
881;18078;20;0;0;0;0;.00nan;0;0
882;1251;14;63;15;1;14;.933;3279000;0
882;15505;8;0;0;0;0;.00nan;0;0
882;25076;8;91;45;2;43;.956;3600000;0
882;25584;14;31;13;3;10;.769;299000;0
883;1572;4838;88;52;4;48;.923;3600000;0
883;2328;4838;0;0;0;0;.00nan;0;0
883;27739;22;0;0;0;0;.00nan;0;0
883;28026;22;78;19;1;18;.947;3600000;0
884;4450;5;0;0;0;0;.00nan;0;0
884;13842;34;86;38;2;36;.947;3900000;0
884;15502;34;0;0;0;0;.00nan;0;0
884;19823;5;74;25;2;23;.920;3900000;0
885;544;19;77;47;4;43;.915;3567000;0
885;1614;25;62;28;3;25;.893;3600000;0
885;4716;25;0;0;0;0;.00nan;0;0
885;31124;19;0;0;0;0;.00nan;0;0
886;823;23;0;0;0;0;.00nan;0;0
886;1074;0;50;37;6;31;.838;3600000;0
886;10274;23;66;36;4;32;.889;3600000;0
886;31035;0;0;0;0;0;.00nan;0;0
887;2058;28;58;27;3;24;.889;3560000;0
887;22601;26;0;0;0;0;.00nan;0;0
887;26824;28;0;0;0;0;.00nan;0;0
887;32754;26;98;42;2;40;.952;3600000;0
888;738;27;47;40;6;34;.850;3555000;0
888;15464;32;66;38;4;34;.895;3600000;0
888;16006;32;0;0;0;0;.00nan;0;0
888;26623;27;0;0;0;0;.00nan;0;0
889;724;11;0;0;0;0;.00nan;0;0
889;5385;17;93;20;0;20;1.000;3600000;0
889;21522;11;46;24;4;20;.833;3600000;0
889;34006;17;0;0;0;0;.00nan;0;0
890;51;21;0;0;0;0;.00nan;0;0
890;1796;16;99;22;0;22;1.000;3600000;0
890;14321;16;0;0;0;0;.00nan;0;0
890;25843;21;68;29;3;26;.897;3600000;0
891;1572;4838;96;46;3;43;.935;3571000;0
891;2328;4838;0;0;0;0;.00nan;0;0
891;10103;24;0;0;0;0;.00nan;0;0
891;13979;24;100;35;1;34;.971;3600000;0
892;7139;29;0;0;0;0;.00nan;0;0
892;15505;8;99;40;2;38;.950;3600000;0
892;18351;29;48;28;4;24;.857;3564000;0
892;25076;8;0;0;0;0;.00nan;0;0
893;262;35;91;36;2;34;.944;3600000;0
893;376;12;54;23;3;20;.870;3576000;0
893;445;12;0;0;0;0;.00nan;0;0
893;1430;35;0;0;0;0;.00nan;0;0
894;4506;33;100;31;0;31;1.000;3600000;0
894;18104;10;74;21;1;20;.952;3600000;0
894;27488;10;0;0;0;0;.00nan;0;0
894;34740;33;0;0;0;0;.00nan;0;0
895;500;4182;100;25;0;25;1.000;3600000;0
895;2058;28;0;0;0;0;.00nan;0;0
895;25521;4182;0;0;0;0;.00nan;0;0
895;26824;28;98;49;2;47;.959;3600000;0
896;738;27;0;0;0;0;.00nan;0;0
896;1913;30;50;35;5;30;.857;3600000;0
896;4826;30;0;0;0;0;.00nan;0;0
896;26623;27;81;31;2;29;.935;3600000;0
897;724;11;0;0;0;0;.00nan;0;0
897;4450;5;0;0;0;0;.00nan;0;0
897;19823;5;76;24;2;22;.917;3600000;0
897;21522;11;98;54;4;50;.926;3600000;0
898;61;31;0;0;0;0;.00nan;0;0
898;5385;17;73;36;3;33;.917;3582000;0
898;34006;17;0;0;0;0;.00nan;0;0
898;34797;31;91;40;2;38;.950;3600000;0
899;928;20;0;0;0;0;.00nan;0;0
899;1614;25;92;36;1;35;.972;3600000;0
899;4716;25;0;0;0;0;.00nan;0;0
899;18078;20;38;28;5;23;.821;3600000;0
900;1821;3;0;0;0;0;.00nan;0;0
900;2054;3;66;25;2;23;.920;3600000;0
900;13842;34;0;0;0;0;.00nan;0;0
900;15502;34;91;50;3;47;.940;3543000;0
901;1572;4838;85;52;5;47;.904;3600000;0
901;1821;3;76;18;1;17;.944;3600000;0
901;2054;3;0;0;0;0;.00nan;0;0
901;2328;4838;0;0;0;0;.00nan;0;0
902;323;9;0;0;0;0;.00nan;0;0
902;20853;9;91;47;2;45;.957;3600000;0
902;22601;26;0;0;0;0;.00nan;0;0
902;32754;26;46;24;4;20;.833;3577000;0
903;51;21;63;27;3;24;.889;3584000;0
903;1614;25;65;16;2;14;.875;3600000;0
903;4716;25;0;0;0;0;.00nan;0;0
903;25843;21;0;0;0;0;.00nan;0;0
904;500;4182;67;25;4;21;.840;3600000;0
904;1251;14;71;45;5;40;.889;3595000;0
904;25521;4182;0;0;0;0;.00nan;0;0
904;25584;14;0;0;0;0;.00nan;0;0
905;61;31;72;24;2;22;.917;3600000;0
905;2423;15;0;0;0;0;.00nan;0;0
905;4106;15;77;50;5;45;.900;3600000;0
905;34797;31;0;0;0;0;.00nan;0;0
906;1913;30;46;38;6;32;.842;3178000;0
906;4826;30;65;9;0;9;1.000;422000;0
906;15505;8;0;0;0;0;.00nan;0;0
906;25076;8;57;25;3;22;.880;3600000;0
907;1796;16;79;33;2;31;.939;3600000;0
907;2058;28;0;0;0;0;.00nan;0;0
907;14321;16;0;0;0;0;.00nan;0;0
907;26824;28;67;28;3;25;.893;3600000;0
908;376;12;0;0;0;0;.00nan;0;0
908;445;12;86;35;2;33;.943;3600000;0
908;15464;32;46;26;4;22;.846;3556000;0
908;16006;32;0;0;0;0;.00nan;0;0
909;262;35;0;0;0;0;.00nan;0;0
909;1430;35;82;44;4;40;.909;3600000;0
909;18104;10;56;22;3;19;.864;3600000;0
909;27488;10;0;0;0;0;.00nan;0;0
910;4506;33;100;34;0;34;1.000;3600000;0
910;7139;29;0;0;0;0;.00nan;0;0
910;18351;29;75;23;1;22;.957;3563000;0
910;34740;33;0;0;0;0;.00nan;0;0
911;544;19;0;0;0;0;.00nan;0;0
911;27739;22;0;0;0;0;.00nan;0;0
911;28026;22;74;27;2;25;.926;3600000;0
911;31124;19;50;37;5;32;.865;3600000;0
912;823;23;0;0;0;0;.00nan;0;0
912;10274;23;99;50;3;47;.940;3600000;0
912;27739;22;54;36;5;31;.861;3551000;0
912;28026;22;0;0;0;0;.00nan;0;0
913;335;18;68;19;1;18;.947;3600000;0
913;1074;0;60;39;5;34;.872;3600000;0
913;5001;18;0;0;0;0;.00nan;0;0
913;31035;0;0;0;0;0;.00nan;0;0
914;4450;5;61;29;3;26;.897;3575000;0
914;15505;8;0;0;0;0;.00nan;0;0
914;19823;5;0;0;0;0;.00nan;0;0
914;25076;8;79;29;2;27;.931;3600000;0
915;500;4182;62;32;4;28;.875;3832000;0
915;5385;17;0;0;0;0;.00nan;0;0
915;25521;4182;0;0;0;0;.00nan;0;0
915;34006;17;92;46;3;43;.935;3832000;0
916;1821;3;64;33;4;29;.879;3600000;0
916;2054;3;0;0;0;0;.00nan;0;0
916;22601;26;31;35;7;28;.800;3600000;0
916;32754;26;0;0;0;0;.00nan;0;0
917;1572;4838;100;30;0;30;1.000;3600000;0
917;2058;28;54;31;5;26;.839;3600000;0
917;2328;4838;0;0;0;0;.00nan;0;0
917;26824;28;0;0;0;0;.00nan;0;0
918;262;35;0;0;0;0;.00nan;0;0
918;323;9;98;25;0;25;1.000;3600000;0
918;1430;35;55;33;5;28;.848;3600000;0
918;20853;9;0;0;0;0;.00nan;0;0
919;61;31;0;0;0;0;.00nan;0;0
919;1251;14;0;0;0;0;.00nan;0;0
919;25584;14;100;27;0;27;1.000;3600000;0
919;34797;31;41;28;5;23;.821;3600000;0
920;51;21;0;0;0;0;.00nan;0;0
920;4506;33;57;32;4;28;.875;3590000;0
920;25843;21;78;38;3;35;.921;3600000;0
920;34740;33;0;0;0;0;.00nan;0;0
921;928;20;82;25;1;24;.960;3600000;0
921;2423;15;97;44;2;42;.955;3547000;0
921;4106;15;0;0;0;0;.00nan;0;0
921;18078;20;0;0;0;0;.00nan;0;0
922;1614;25;81;26;1;25;.962;3600000;0
922;4716;25;0;0;0;0;.00nan;0;0
922;10103;24;42;3;1;2;.667;527000;0
922;13979;24;69;51;6;45;.882;3073000;0
923;1796;16;98;32;2;30;.938;3579000;0
923;14321;16;0;0;0;0;.00nan;0;0
923;18104;10;75;23;1;22;.957;3600000;0
923;27488;10;0;0;0;0;.00nan;0;0
924;1913;30;86;41;3;38;.927;3565000;0
924;4826;30;0;0;0;0;.00nan;0;0
924;15464;32;78;26;1;25;.962;3600000;0
924;16006;32;0;0;0;0;.00nan;0;0
925;544;19;0;0;0;0;.00nan;0;0
925;7139;29;0;0;0;0;.00nan;0;0
925;18351;29;64;27;3;24;.889;3600000;0
925;31124;19;56;37;5;32;.865;3600000;0
926;724;11;57;3;0;3;1.000;406000;0
926;738;27;28;25;6;19;.760;3335000;0
926;21522;11;49;48;7;41;.854;3154000;0
926;26623;27;57;2;0;2;1.000;265000;0
927;928;20;0;0;0;0;.00nan;0;0
927;4506;33;98;42;1;41;.976;3900000;0
927;18078;20;85;28;1;27;.964;3900000;0
927;34740;33;0;0;0;0;.00nan;0;0
928;500;4182;0;0;0;0;.00nan;0;0
928;2423;15;0;0;0;0;.00nan;0;0
928;4106;15;78;40;3;37;.925;3600000;0
928;25521;4182;79;14;0;14;1.000;3600000;0
929;262;35;75;37;4;33;.892;3600000;0
929;1430;35;0;0;0;0;.00nan;0;0
929;13842;34;0;0;0;0;.00nan;0;0
929;15502;34;73;21;2;19;.905;3600000;0
930;335;18;0;0;0;0;.00nan;0;0
930;5001;18;63;32;3;29;.906;3518000;0
930;27739;22;0;0;0;0;.00nan;0;0
930;28026;22;89;30;1;29;.967;3600000;0
931;4450;5;0;0;0;0;.00nan;0;0
931;19823;5;89;40;4;36;.900;3608000;0
931;22601;26;83;36;3;33;.917;3608000;0
931;32754;26;0;0;0;0;.00nan;0;0
932;1074;0;60;27;3;24;.889;3568000;0
932;1572;4838;91;41;1;40;.976;3600000;0
932;2328;4838;0;0;0;0;.00nan;0;0
932;31035;0;0;0;0;0;.00nan;0;0
933;2058;28;52;38;5;33;.868;3600000;0
933;15505;8;0;0;0;0;.00nan;0;0
933;25076;8;98;32;1;31;.969;3600000;0
933;26824;28;0;0;0;0;.00nan;0;0
934;51;21;0;0;0;0;.00nan;0;0
934;1913;30;29;28;6;22;.786;2382000;0
934;4826;30;53;11;1;10;.909;1218000;0
934;25843;21;60;26;3;23;.885;3600000;0
935;1251;14;0;0;0;0;.00nan;0;0
935;10103;24;0;0;0;0;.00nan;0;0
935;13979;24;88;48;4;44;.917;3592000;0
935;25584;14;78;28;2;26;.929;3600000;0
936;1796;16;97;38;1;37;.974;3579000;0
936;14321;16;0;0;0;0;.00nan;0;0
936;15464;32;98;25;0;25;1.000;3600000;0
936;16006;32;0;0;0;0;.00nan;0;0
937;376;12;0;0;0;0;.00nan;0;0
937;445;12;86;37;3;34;.919;3600000;0
937;18104;10;89;21;0;21;1.000;3600000;0
937;27488;10;0;0;0;0;.00nan;0;0
938;323;9;70;27;2;25;.926;3600000;0
938;544;19;45;24;4;20;.833;2312000;0
938;20853;9;0;0;0;0;.00nan;0;0
938;31124;19;59;7;0;7;1.000;1251000;0
939;823;23;0;0;0;0;.00nan;0;0
939;7139;29;0;0;0;0;.00nan;0;0
939;10274;23;68;48;5;43;.896;3900000;0
939;18351;29;79;40;5;35;.875;3900000;0
940;724;11;0;0;0;0;.00nan;0;0
940;738;27;0;0;0;0;.00nan;0;0
940;21522;11;76;35;3;32;.914;3600000;0
940;26623;27;68;37;4;33;.892;3543000;0
941;1821;3;58;17;2;15;.882;3600000;0
941;2054;3;0;0;0;0;.00nan;0;0
941;5385;17;68;38;5;33;.868;3600000;0
941;34006;17;0;0;0;0;.00nan;0;0
942;928;20;49;21;3;18;.857;3600000;0
942;1913;30;39;34;6;28;.824;3600000;0
942;4826;30;0;0;0;0;.00nan;0;0
942;18078;20;0;0;0;0;.00nan;0;0
943;1074;0;0;0;0;0;.00nan;0;0
943;1251;14;54;18;2;16;.889;3900000;0
943;25584;14;0;0;0;0;.00nan;0;0
943;31035;0;100;44;2;42;.955;3900000;0
944;2423;15;63;39;5;34;.872;3581000;0
944;4106;15;0;0;0;0;.00nan;0;0
944;10103;24;66;32;4;28;.875;3600000;0
944;13979;24;0;0;0;0;.00nan;0;0
945;500;4182;0;0;0;0;.00nan;0;0
945;13842;34;0;0;0;0;.00nan;0;0
945;15502;34;66;43;5;38;.884;3900000;0
945;25521;4182;35;26;5;21;.808;3900000;0
946;1796;16;0;0;0;0;.00nan;0;0
946;4506;33;71;35;3;32;.914;3600000;0
946;14321;16;93;22;0;22;1.000;3600000;0
946;34740;33;0;0;0;0;.00nan;0;0
947;262;35;0;0;0;0;.00nan;0;0
947;1430;35;80;29;2;27;.931;3600000;0
947;15464;32;71;43;5;38;.884;3600000;0
947;16006;32;0;0;0;0;.00nan;0;0
948;544;19;61;44;5;39;.886;3598000;0
948;1614;25;0;0;0;0;.00nan;0;0
948;4716;25;61;26;3;23;.885;3600000;0
948;31124;19;0;0;0;0;.00nan;0;0
949;335;18;0;0;0;0;.00nan;0;0
949;5001;18;78;23;1;22;.957;3600000;0
949;7139;29;22;32;7;25;.781;3179000;0
949;18351;29;64;6;0;6;1.000;421000;0
950;61;31;0;0;0;0;.00nan;0;0
950;724;11;73;32;3;29;.906;3534000;0
950;21522;11;0;0;0;0;.00nan;0;0
950;34797;31;93;32;1;31;.969;3600000;0
951;2058;28;0;0;0;0;.00nan;0;0
951;22601;26;74;22;2;20;.909;3600000;0
951;26824;28;73;36;3;33;.917;3543000;0
951;32754;26;0;0;0;0;.00nan;0;0
952;376;12;58;6;0;6;1.000;336000;0
952;445;12;44;33;6;27;.818;3264000;0
952;1821;3;0;0;0;0;.00nan;0;0
952;2054;3;93;33;1;32;.970;3600000;0
953;1074;0;0;0;0;0;.00nan;0;0
953;22601;26;0;0;0;0;.00nan;0;0
953;31035;0;86;40;2;38;.950;3600000;0
953;32754;26;55;28;3;25;.893;3567000;0
954;1913;30;97;45;2;43;.956;3586000;0
954;4826;30;0;0;0;0;.00nan;0;0
954;18104;10;81;16;0;16;1.000;3600000;0
954;27488;10;0;0;0;0;.00nan;0;0
955;928;20;80;29;2;27;.931;3662000;0
955;18078;20;0;0;0;0;.00nan;0;0
955;27739;22;56;25;3;22;.880;3662000;0
955;28026;22;0;0;0;0;.00nan;0;0
956;4450;5;0;0;0;0;.00nan;0;0
956;15505;8;97;52;1;51;.981;3900000;0
956;19823;5;94;22;1;21;.955;3900000;0
956;25076;8;0;0;0;0;.00nan;0;0
957;2423;15;72;30;3;27;.900;3600000;0
957;4106;15;0;0;0;0;.00nan;0;0
957;15464;32;54;32;4;28;.875;3600000;0
957;16006;32;0;0;0;0;.00nan;0;0
958;500;4182;100;21;0;21;1.000;3600000;0
958;4506;33;96;53;2;51;.962;3571000;0
958;25521;4182;0;0;0;0;.00nan;0;0
958;34740;33;0;0;0;0;.00nan;0;0
959;323;9;72;43;4;39;.907;3885000;0
959;823;23;0;0;0;0;.00nan;0;0
959;10274;23;63;33;3;30;.909;3885000;0
959;20853;9;0;0;0;0;.00nan;0;0
960;51;21;0;0;0;0;.00nan;0;0
960;335;18;0;0;0;0;.00nan;0;0
960;5001;18;76;37;3;34;.919;3600000;0
960;25843;21;100;34;0;34;1.000;3600000;0
961;724;11;0;0;0;0;.00nan;0;0
961;1614;25;83;29;2;27;.931;3600000;0
961;4716;25;0;0;0;0;.00nan;0;0
961;21522;11;68;39;4;35;.897;3594000;0
962;61;31;55;32;4;28;.875;3551000;0
962;738;27;84;37;3;34;.919;3600000;0
962;26623;27;0;0;0;0;.00nan;0;0
962;34797;31;0;0;0;0;.00nan;0;0
963;2058;28;55;23;3;20;.870;3625000;0
963;13842;34;87;37;2;35;.946;3625000;0
963;15502;34;0;0;0;0;.00nan;0;0
963;26824;28;0;0;0;0;.00nan;0;0
964;262;35;0;0;0;0;.00nan;0;0
964;1430;35;69;45;5;40;.889;3582000;0
964;4450;5;45;20;3;17;.850;3600000;0
964;19823;5;0;0;0;0;.00nan;0;0
965;51;21;0;0;0;0;.00nan;0;0
965;544;19;0;0;0;0;.00nan;0;0
965;25843;21;77;28;2;26;.929;3600000;0
965;31124;19;100;29;0;29;1.000;3600000;0
966;1572;4838;0;0;0;0;.00nan;0;0
966;2328;4838;71;40;4;36;.900;3569000;0
966;7139;29;0;0;0;0;.00nan;0;0
966;18351;29;85;36;3;33;.917;3600000;0
967;1821;3;0;0;0;0;.00nan;0;0
967;2054;3;74;29;3;26;.897;3600000;0
967;10103;24;56;43;5;38;.884;3600000;0
967;13979;24;0;0;0;0;.00nan;0;0
968;376;12;0;0;0;0;.00nan;0;0
968;445;12;91;17;0;17;1.000;3600000;0
968;1074;0;92;43;3;40;.930;3600000;0
968;31035;0;0;0;0;0;.00nan;0;0
969;1251;14;0;0;0;0;.00nan;0;0
969;15464;32;98;24;0;24;1.000;3600000;0
969;16006;32;0;0;0;0;.00nan;0;0
969;25584;14;88;33;1;32;.970;3600000;0
970;13842;34;0;0;0;0;.00nan;0;0
970;15502;34;68;43;5;38;.884;3600000;0
970;27739;22;0;0;0;0;.00nan;0;0
970;28026;22;85;29;1;28;.966;3600000;0
971;1796;16;0;0;0;0;.00nan;0;0
971;2423;15;0;0;0;0;.00nan;0;0
971;4106;15;100;49;2;47;.959;3600000;0
971;14321;16;39;23;5;18;.783;3600000;0
972;823;23;0;0;0;0;.00nan;0;0
972;5385;17;100;39;0;39;1.000;3600000;0
972;10274;23;70;28;2;26;.929;3600000;0
972;34006;17;0;0;0;0;.00nan;0;0
973;323;9;95;47;1;46;.979;3900000;0
973;335;18;0;0;0;0;.00nan;0;0
973;5001;18;80;21;1;20;.952;3900000;0
973;20853;9;0;0;0;0;.00nan;0;0
974;61;31;76;22;1;21;.955;1718000;0
974;500;4182;82;25;2;23;.920;3600000;0
974;25521;4182;0;0;0;0;.00nan;0;0
974;34797;31;36;23;5;18;.783;1882000;0
975;724;11;0;0;0;0;.00nan;0;0
975;738;27;0;0;0;0;.00nan;0;0
975;21522;11;75;32;2;30;.938;3900000;0
975;26623;27;75;27;2;25;.926;3900000;0
976;1251;14;79;23;1;22;.957;3600000;0
976;2058;28;0;0;0;0;.00nan;0;0
976;25584;14;0;0;0;0;.00nan;0;0
976;26824;28;65;44;5;39;.886;3600000;0
977;10103;24;0;0;0;0;.00nan;0;0
977;13979;24;43;28;5;23;.821;3600000;0
977;27739;22;51;35;6;29;.829;3281000;0
977;28026;22;49;1;0;1;1.000;291000;0
978;4450;5;0;0;0;0;.00nan;0;0
978;4506;33;0;0;0;0;.00nan;0;0
978;19823;5;60;25;3;22;.880;3900000;0
978;34740;33;79;45;3;42;.933;3884000;0
979;544;19;0;0;0;0;.00nan;0;0
979;5385;17;100;41;0;41;1.000;3600000;0
979;31124;19;61;26;3;23;.885;3600000;0
979;34006;17;0;0;0;0;.00nan;0;0
980;61;31;0;0;0;0;.00nan;0;0
980;1913;30;0;0;0;0;.00nan;0;0
980;4826;30;74;47;5;42;.894;3600000;0
980;34797;31;100;34;1;33;.971;3600000;0
981;738;27;87;47;4;43;.915;3600000;0
981;1614;25;98;30;1;29;.967;3600000;0
981;4716;25;0;0;0;0;.00nan;0;0
981;26623;27;0;0;0;0;.00nan;0;0
982;1074;0;0;0;0;0;.00nan;0;0
982;2058;28;46;36;5;31;.861;3900000;0
982;26824;28;0;0;0;0;.00nan;0;0
982;31035;0;54;35;5;30;.857;3900000;0
983;7139;29;0;0;0;0;.00nan;0;0
983;18104;10;100;45;2;43;.956;3600000;0
983;18351;29;34;22;5;17;.773;3600000;0
983;27488;10;0;0;0;0;.00nan;0;0
984;376;12;0;0;0;0;.00nan;0;0
984;445;12;21;31;7;24;.774;3600000;0
984;928;20;74;18;1;17;.944;3600000;0
984;18078;20;0;0;0;0;.00nan;0;0
985;1796;16;92;26;1;25;.962;3900000;0
985;13842;34;75;33;1;32;.970;3900000;0
985;14321;16;0;0;0;0;.00nan;0;0
985;15502;34;0;0;0;0;.00nan;0;0
986;1821;3;86;39;2;37;.949;3552000;0
986;2054;3;0;0;0;0;.00nan;0;0
986;15464;32;93;29;1;28;.966;3600000;0
986;16006;32;0;0;0;0;.00nan;0;0
987;262;35;0;0;0;0;.00nan;0;0
987;1430;35;96;57;4;53;.930;3600000;0
987;25076;8;0;0;0;0;.00nan;0;0
987;34788;8;82;21;1;20;.952;3600000;0
988;51;21;0;0;0;0;.00nan;0;0
988;823;23;0;0;0;0;.00nan;0;0
988;10274;23;87;31;1;30;.968;3600000;0
988;25843;21;48;25;4;21;.840;3600000;0
989;335;18;0;0;0;0;.00nan;0;0
989;544;19;74;37;3;34;.919;3600000;0
989;5001;18;75;32;2;30;.938;3600000;0
989;31124;19;0;0;0;0;.00nan;0;0
990;2423;15;40;34;6;28;.824;3565000;0
990;4106;15;0;0;0;0;.00nan;0;0
990;22601;26;61;37;5;32;.865;3600000;0
990;32754;26;0;0;0;0;.00nan;0;0
991;500;4182;0;0;0;0;.00nan;0;0
991;724;11;0;0;0;0;.00nan;0;0
991;21522;11;85;47;4;43;.915;3600000;0
991;25521;4182;91;27;1;26;.963;3600000;0
992;323;9;0;0;0;0;.00nan;0;0
992;1572;4838;74;29;2;27;.931;3600000;0
992;2328;4838;0;0;0;0;.00nan;0;0
992;20853;9;68;38;4;34;.895;3535000;0
993;928;20;0;0;0;0;.00nan;0;0
993;1251;14;0;0;0;0;.00nan;0;0
993;18078;20;80;26;2;24;.923;3600000;0
993;25584;14;71;37;3;34;.919;3552000;0
994;376;12;89;38;3;35;.921;3600000;0
994;445;12;0;0;0;0;.00nan;0;0
994;27739;22;54;4;0;4;1.000;414000;0
994;28026;22;41;24;5;19;.792;3186000;0
995;10103;24;0;0;0;0;.00nan;0;0
995;13979;24;98;33;1;32;.970;3600000;0
995;18104;10;15;11;5;6;.545;894000;0
995;27488;10;35;32;6;26;.813;2706000;0
996;4506;33;90;30;1;29;.967;3600000;0
996;25076;8;69;36;3;33;.917;3577000;0
996;34740;33;0;0;0;0;.00nan;0;0
996;34788;8;0;0;0;0;.00nan;0;0
997;335;18;77;33;3;30;.909;3600000;0
997;5001;18;0;0;0;0;.00nan;0;0
997;5385;17;66;33;4;29;.879;3572000;0
997;34006;17;0;0;0;0;.00nan;0;0
998;738;27;64;33;3;30;.909;3710000;0
998;22601;26;0;0;0;0;.00nan;0;0
998;26623;27;0;0;0;0;.00nan;0;0
998;32754;26;85;41;2;39;.951;3710000;0
999;717;0;37;12;3;9;.750;507000;0
999;4450;5;0;0;0;0;.00nan;0;0
999;19823;5;65;16;1;15;.938;3600000;0
999;31035;0;81;35;2;33;.943;3093000;0
1000;262;35;0;0;0;0;.00nan;0;0
1000;500;4182;70;19;1;18;.947;3600000;0
1000;1430;35;100;25;0;25;1.000;3600000;0
1000;25521;4182;0;0;0;0;.00nan;0;0
1001;823;23;0;0;0;0;.00nan;0;0
1001;1614;25;78;28;2;26;.929;3600000;0
1001;4716;25;0;0;0;0;.00nan;0;0
1001;10274;23;37;48;7;41;.854;3600000;0
1002;1913;30;88;36;3;33;.917;3600000;0
1002;4826;30;0;0;0;0;.00nan;0;0
1002;15464;32;66;25;2;23;.920;3600000;0
1002;16006;32;0;0;0;0;.00nan;0;0
1003;323;9;52;27;4;23;.852;3600000;0
1003;1251;14;0;0;0;0;.00nan;0;0
1003;20853;9;0;0;0;0;.00nan;0;0
1003;25584;14;83;26;1;25;.962;3600000;0
1004;51;21;75;29;2;27;.931;3900000;0
1004;18104;10;75;30;2;28;.933;3900000;0
1004;25843;21;0;0;0;0;.00nan;0;0
1004;27488;10;0;0;0;0;.00nan;0;0
1005;928;20;76;35;3;32;.914;3580000;0
1005;4450;5;64;22;2;20;.909;3600000;0
1005;18078;20;0;0;0;0;.00nan;0;0
1005;19823;5;0;0;0;0;.00nan;0;0
1006;2423;15;65;25;2;23;.920;3600000;0
1006;4106;15;0;0;0;0;.00nan;0;0
1006;13842;34;58;36;4;32;.889;3600000;0
1006;15502;34;0;0;0;0;.00nan;0;0
1007;1796;16;72;31;2;29;.935;3574000;0
1007;14321;16;0;0;0;0;.00nan;0;0
1007;27739;22;97;28;1;27;.964;3600000;0
1007;28026;22;0;0;0;0;.00nan;0;0
1008;7139;29;0;0;0;0;.00nan;0;0
1008;10103;24;0;0;0;0;.00nan;0;0
1008;13979;24;72;32;3;29;.906;3623000;0
1008;18351;29;63;18;2;16;.889;3623000;0
1009;376;12;0;0;0;0;.00nan;0;0
1009;445;12;77;26;1;25;.962;3600000;0
1009;823;23;92;40;2;38;.950;3592000;0
1009;10274;23;0;0;0;0;.00nan;0;0
1010;500;4182;0;0;0;0;.00nan;0;0
1010;4506;33;91;35;2;33;.943;3600000;0
1010;25521;4182;86;43;3;40;.930;3600000;0
1010;34740;33;0;0;0;0;.00nan;0;0
1011;544;19;0;0;0;0;.00nan;0;0
1011;738;27;75;30;2;28;.933;3557000;0
1011;26623;27;0;0;0;0;.00nan;0;0
1011;31124;19;100;35;0;35;1.000;3600000;0
1012;724;11;0;0;0;0;.00nan;0;0
1012;15464;32;0;0;0;0;.00nan;0;0
1012;16006;32;76;34;4;30;.882;3840000;0
1012;21522;11;66;27;3;24;.889;3840000;0
1013;2423;15;0;0;0;0;.00nan;0;0
1013;4106;15;72;28;2;26;.929;3600000;0
1013;5385;17;67;38;4;34;.895;3569000;0
1013;34006;17;0;0;0;0;.00nan;0;0
1014;51;21;0;0;0;0;.00nan;0;0
1014;1821;3;0;0;0;0;.00nan;0;0
1014;2054;3;76;32;3;29;.906;3600000;0
1014;25843;21;26;29;6;23;.793;3600000;0
1015;335;18;0;0;0;0;.00nan;0;0
1015;1614;25;48;22;4;18;.818;2359000;0
1015;4716;25;53;9;1;8;.889;1241000;0
1015;5001;18;94;35;2;33;.943;3600000;0
1016;1572;4838;72;34;3;31;.912;3600000;0
1016;2328;4838;0;0;0;0;.00nan;0;0
1016;22601;26;89;23;0;23;1.000;3600000;0
1016;32754;26;0;0;0;0;.00nan;0;0
1017;1913;30;92;44;2;42;.955;3553000;0
1017;4826;30;0;0;0;0;.00nan;0;0
1017;25076;8;0;0;0;0;.00nan;0;0
1017;34788;8;75;22;1;21;.955;3600000;0
1018;4450;5;0;0;0;0;.00nan;0;0
1018;7139;29;0;0;0;0;.00nan;0;0
1018;18351;29;52;32;5;27;.844;3545000;0
1018;19823;5;82;42;4;38;.905;3600000;0
1019;61;31;0;0;0;0;.00nan;0;0
1019;717;0;0;0;0;0;.00nan;0;0
1019;31035;0;64;43;5;38;.884;3600000;0
1019;34797;31;74;25;2;23;.920;3600000;0
1020;928;20;100;35;0;35;1.000;3600000;0
1020;2058;28;65;38;4;34;.895;3600000;0
1020;18078;20;0;0;0;0;.00nan;0;0
1020;26824;28;0;0;0;0;.00nan;0;0
1021;376;12;0;0;0;0;.00nan;0;0
1021;445;12;79;29;3;26;.897;3600000;0
1021;10103;24;0;0;0;0;.00nan;0;0
1021;13979;24;56;27;4;23;.852;3595000;0
1022;1251;14;0;0;0;0;.00nan;0;0
1022;1796;16;100;33;1;32;.970;3900000;0
1022;14321;16;0;0;0;0;.00nan;0;0
1022;25584;14;97;41;1;40;.976;3900000;0
1023;262;35;0;0;0;0;.00nan;0;0
1023;335;18;75;24;1;23;.958;3600000;0
1023;1430;35;71;33;4;29;.879;3600000;0
1023;5001;18;0;0;0;0;.00nan;0;0
1024;738;27;97;49;1;48;.980;3600000;0
1024;823;23;0;0;0;0;.00nan;0;0
1024;10274;23;68;30;3;27;.900;3562000;0
1024;26623;27;0;0;0;0;.00nan;0;0
1025;500;4182;71;21;1;20;.952;3600000;0
1025;15464;32;61;29;3;26;.897;3534000;0
1025;16006;32;0;0;0;0;.00nan;0;0
1025;25521;4182;0;0;0;0;.00nan;0;0
1026;724;11;0;0;0;0;.00nan;0;0
1026;21522;11;87;29;1;28;.966;3600000;0
1026;25076;8;0;0;0;0;.00nan;0;0
1026;34788;8;78;34;2;32;.941;3600000;0
1027;5385;17;58;35;4;31;.886;3574000;0
1027;27739;22;0;0;0;0;.00nan;0;0
1027;28026;22;71;31;3;28;.903;3600000;0
1027;34006;17;0;0;0;0;.00nan;0;0
1028;2423;15;0;0;0;0;.00nan;0;0
1028;4106;15;74;35;3;32;.914;3559000;0
1028;18104;10;87;30;2;28;.933;3600000;0
1028;27488;10;0;0;0;0;.00nan;0;0
1029;4506;33;55;21;2;19;.905;3627000;0
1029;13842;34;0;0;0;0;.00nan;0;0
1029;15502;34;72;30;3;27;.900;3627000;0
1029;34740;33;0;0;0;0;.00nan;0;0
1030;1251;14;83;31;2;29;.935;3600000;0
1030;1614;25;87;32;3;29;.906;3586000;0
1030;4716;25;0;0;0;0;.00nan;0;0
1030;25584;14;0;0;0;0;.00nan;0;0
1031;544;19;32;5;2;3;.600;352000;0
1031;22601;26;77;32;2;30;.938;3600000;0
1031;31124;19;52;40;6;34;.850;3248000;0
1031;32754;26;0;0;0;0;.00nan;0;0
1032;1572;4838;71;34;3;31;.912;3795000;0
1032;1913;30;61;31;4;27;.871;3795000;0
1032;2328;4838;0;0;0;0;.00nan;0;0
1032;4826;30;0;0;0;0;.00nan;0;0
1033;928;20;60;39;5;34;.872;3600000;0
1033;4450;5;0;0;0;0;.00nan;0;0
1033;18078;20;0;0;0;0;.00nan;0;0
1033;19823;5;74;24;2;22;.917;3600000;0
1034;717;0;99;33;1;32;.970;3600000;0
1034;1821;3;69;30;2;28;.933;3548000;0
1034;2054;3;0;0;0;0;.00nan;0;0
1034;31035;0;0;0;0;0;.00nan;0;0
1035;61;31;0;0;0;0;.00nan;0;0
1035;2058;28;44;25;4;21;.840;3600000;0
1035;26824;28;0;0;0;0;.00nan;0;0
1035;34797;31;98;33;1;32;.970;3600000;0
1036;323;9;69;24;1;23;.958;3600000;0
1036;7139;29;0;0;0;0;.00nan;0;0
1036;18351;29;63;40;5;35;.875;3600000;0
1036;20853;9;0;0;0;0;.00nan;0;0
1037;51;21;0;0;0;0;.00nan;0;0
1037;25843;21;64;30;3;27;.900;3556000;0
1037;27739;22;100;37;1;36;.973;3600000;0
1037;28026;22;0;0;0;0;.00nan;0;0
1038;1796;16;80;30;3;27;.900;3900000;0
1038;10103;24;84;39;3;36;.923;3900000;0
1038;13979;24;0;0;0;0;.00nan;0;0
1038;14321;16;0;0;0;0;.00nan;0;0
1039;335;18;0;0;0;0;.00nan;0;0
1039;376;12;0;0;0;0;.00nan;0;0
1039;445;12;82;40;3;37;.925;3565000;0
1039;5001;18;86;29;2;27;.931;3600000;0
1040;262;35;0;0;0;0;.00nan;0;0
1040;1430;35;80;13;0;13;1.000;3600000;0
1040;13842;34;85;43;3;40;.930;3600000;0
1040;15502;34;0;0;0;0;.00nan;0;0
1041;544;19;98;40;2;38;.950;3600000;0
1041;823;23;71;36;3;33;.917;3581000;0
1041;10274;23;0;0;0;0;.00nan;0;0
1041;31124;19;0;0;0;0;.00nan;0;0
1042;500;4182;72;30;3;27;.900;3600000;0
1042;15505;8;0;0;0;0;.00nan;0;0
1042;25076;8;70;40;5;35;.875;3595000;0
1042;25521;4182;0;0;0;0;.00nan;0;0
1043;724;11;50;1;0;1;1.000;359000;0
1043;1572;4838;84;30;2;28;.933;3600000;0
1043;2328;4838;0;0;0;0;.00nan;0;0
1043;21522;11;26;27;6;21;.778;3241000;0
1044;738;27;44;10;2;8;.800;1461000;0
1044;1913;30;0;0;0;0;.00nan;0;0
1044;4826;30;82;35;2;33;.943;3600000;0
1044;26623;27;32;29;6;23;.793;2139000;0
1045;61;31;69;46;5;41;.891;3600000;0
1045;1821;3;0;0;0;0;.00nan;0;0
1045;2054;3;96;50;3;47;.940;3600000;0
1045;34797;31;0;0;0;0;.00nan;0;0
1046;51;21;81;36;3;33;.917;3600000;0
1046;717;0;0;0;0;0;.00nan;0;0
1046;25843;21;0;0;0;0;.00nan;0;0
1046;31035;0;66;38;4;34;.895;3546000;0
1047;928;20;0;0;0;0;.00nan;0;0
1047;7139;29;0;0;0;0;.00nan;0;0
1047;18078;20;77;31;2;29;.935;3546000;0
1047;18351;29;78;12;0;12;1.000;3600000;0
1048;5385;17;84;41;3;38;.927;3600000;0
1048;18104;10;0;0;0;0;.00nan;0;0
1048;27488;10;82;29;2;27;.931;3600000;0
1048;34006;17;0;0;0;0;.00nan;0;0
1049;323;9;0;0;0;0;.00nan;0;0
1049;2423;15;58;26;3;23;.885;3709000;0
1049;4106;15;0;0;0;0;.00nan;0;0
1049;20853;9;86;39;2;37;.949;3709000;0
1050;1251;14;0;0;0;0;.00nan;0;0
1050;15464;32;61;38;4;34;.895;3564000;0
1050;16006;32;0;0;0;0;.00nan;0;0
1050;25584;14;75;33;3;30;.909;3600000;0
1051;262;35;0;0;0;0;.00nan;0;0
1051;1430;35;70;33;4;29;.879;3586000;0
1051;1614;25;0;0;0;0;.00nan;0;0
1051;4716;25;70;25;2;23;.920;3600000;0
1052;4506;33;68;33;3;30;.909;3600000;0
1052;22601;26;32;24;5;19;.792;2386000;0
1052;32754;26;55;10;1;9;.900;1214000;0
1052;34740;33;0;0;0;0;.00nan;0;0
1053;10103;24;0;0;0;0;.00nan;0;0
1053;13979;24;86;38;2;36;.947;3559000;0
1053;27739;22;0;0;0;0;.00nan;0;0
1053;28026;22;88;27;1;26;.963;3600000;0
1054;5385;17;0;0;0;0;.00nan;0;0
1054;15505;8;78;35;2;33;.943;3635000;0
1054;25076;8;0;0;0;0;.00nan;0;0
1054;34006;17;66;30;3;27;.900;3635000;0
1055;335;18;0;0;0;0;.00nan;0;0
1055;1796;16;71;26;2;24;.923;3600000;0
1055;5001;18;47;26;4;22;.846;3578000;0
1055;14321;16;0;0;0;0;.00nan;0;0
1056;823;23;0;0;0;0;.00nan;0;0
1056;10274;23;98;32;1;31;.969;3600000;0
1056;22601;26;0;0;0;0;.00nan;0;0
1056;32754;26;73;41;4;37;.902;3600000;0
1057;724;11;0;0;0;0;.00nan;0;0
1057;1572;4838;70;36;3;33;.917;3600000;0
1057;2328;4838;0;0;0;0;.00nan;0;0
1057;21522;11;100;22;0;22;1.000;3600000;0
1058;1821;3;95;35;2;33;.943;3600000;0
1058;2054;3;0;0;0;0;.00nan;0;0
1058;4450;5;0;0;0;0;.00nan;0;0
1058;19823;5;64;24;3;21;.875;3543000;0
1059;7139;29;0;0;0;0;.00nan;0;0
1059;10103;24;66;33;3;30;.909;3555000;0
1059;13979;24;0;0;0;0;.00nan;0;0
1059;18351;29;95;31;1;30;.968;3600000;0
1060;61;31;100;37;1;36;.973;3215000;0
1060;717;0;56;35;5;30;.857;3654000;0
1060;31035;0;0;0;0;0;.00nan;0;0
1060;34797;31;23;3;3;0;.000;439000;0
1061;2423;15;100;34;1;33;.971;3600000;0
1061;4106;15;0;0;0;0;.00nan;0;0
1061;18104;10;84;39;2;37;.949;3561000;0
1061;27488;10;0;0;0;0;.00nan;0;0
1062;928;20;0;0;0;0;.00nan;0;0
1062;13842;34;0;0;0;0;.00nan;0;0
1062;15502;34;61;30;4;26;.867;3549000;0
1062;18078;20;66;33;3;30;.909;3600000;0
1063;2058;28;81;43;4;39;.907;3536000;0
1063;15464;32;87;37;2;35;.946;3600000;0
1063;16006;32;0;0;0;0;.00nan;0;0
1063;26824;28;0;0;0;0;.00nan;0;0
1064;262;35;0;0;0;0;.00nan;0;0
1064;1251;14;0;0;0;0;.00nan;0;0
1064;1430;35;90;38;2;36;.947;3900000;0
1064;25584;14;82;35;2;33;.943;3900000;0
1065;544;19;99;44;1;43;.977;3900000;0
1065;1614;25;0;0;0;0;.00nan;0;0
1065;4716;25;95;30;1;29;.967;3900000;0
1065;31124;19;0;0;0;0;.00nan;0;0
1066;376;12;0;0;0;0;.00nan;0;0
1066;445;12;96;34;3;31;.912;3578000;0
1066;1913;30;90;39;2;37;.949;3600000;0
1066;4826;30;0;0;0;0;.00nan;0;0
1067;4506;33;100;26;0;26;1.000;3600000;0
1067;5385;17;76;36;3;33;.917;3600000;0
1067;34006;17;0;0;0;0;.00nan;0;0
1067;34740;33;0;0;0;0;.00nan;0;0
1068;323;9;76;37;3;34;.919;3558000;0
1068;18104;10;88;34;1;33;.971;3600000;0
1068;20853;9;0;0;0;0;.00nan;0;0
1068;27488;10;0;0;0;0;.00nan;0;0
1069;724;11;0;0;0;0;.00nan;0;0
1069;823;23;72;37;3;34;.919;3900000;0
1069;10274;23;0;0;0;0;.00nan;0;0
1069;21522;11;68;25;3;22;.880;3900000;0
1070;335;18;0;0;0;0;.00nan;0;0
1070;1796;16;77;32;2;30;.938;3600000;0
1070;5001;18;45;27;4;23;.852;3582000;0
1070;14321;16;0;0;0;0;.00nan;0;0
1071;738;27;79;24;1;23;.958;3600000;0
1071;22601;26;97;43;2;41;.953;3560000;0
1071;26623;27;0;0;0;0;.00nan;0;0
1071;32754;26;0;0;0;0;.00nan;0;0
1072;500;4182;72;19;1;18;.947;3900000;0
1072;1572;4838;100;44;1;43;.977;3900000;0
1072;2328;4838;0;0;0;0;.00nan;0;0
1072;25521;4182;0;0;0;0;.00nan;0;0
1073;51;21;0;0;0;0;.00nan;0;0
1073;4450;5;0;0;0;0;.00nan;0;0
1073;19823;5;62;41;4;37;.902;3900000;0
1073;25843;21;84;38;4;34;.895;3900000;0
1074;1821;3;0;0;0;0;.00nan;0;0
1074;2054;3;72;40;4;36;.900;3548000;0
1074;4506;33;58;21;3;18;.857;3600000;0
1074;34740;33;0;0;0;0;.00nan;0;0
1075;61;31;78;31;2;29;.935;3576000;0
1075;15505;8;77;28;1;27;.964;3600000;0
1075;25076;8;0;0;0;0;.00nan;0;0
1075;34797;31;0;0;0;0;.00nan;0;0
1076;928;20;85;35;2;33;.943;3600000;0
1076;13842;34;62;38;4;34;.895;3571000;0
1076;15502;34;0;0;0;0;.00nan;0;0
1076;18078;20;0;0;0;0;.00nan;0;0
1077;717;0;0;0;0;0;.00nan;0;0
1077;10103;24;0;0;0;0;.00nan;0;0
1077;13979;24;92;29;2;27;.931;3600000;0
1077;31035;0;58;34;4;30;.882;3535000;0
1078;262;35;100;29;0;29;1.000;3600000;0
1078;1430;35;0;0;0;0;.00nan;0;0
1078;2423;15;0;0;0;0;.00nan;0;0
1078;4106;15;72;29;2;27;.931;3588000;0
1079;738;27;0;0;0;0;.00nan;0;0
1079;1614;25;87;30;2;28;.933;3600000;0
1079;4716;25;0;0;0;0;.00nan;0;0
1079;26623;27;65;34;3;31;.912;3588000;0
1080;544;19;0;0;0;0;.00nan;0;0
1080;724;11;87;42;4;38;.905;3550000;0
1080;21522;11;0;0;0;0;.00nan;0;0
1080;31124;19;66;25;3;22;.880;3600000;0
1081;376;12;0;0;0;0;.00nan;0;0
1081;445;12;31;27;6;21;.778;3600000;0
1081;1913;30;73;38;3;35;.921;3600000;0
1081;4826;30;0;0;0;0;.00nan;0;0
1082;5385;17;39;37;6;31;.838;3320000;0
1082;15464;32;70;35;4;31;.886;3600000;0
1082;16006;32;0;0;0;0;.00nan;0;0
1082;34006;17;51;2;0;2;1.000;280000;0
1083;323;9;76;36;4;32;.889;3544000;0
1083;2058;28;78;32;3;29;.906;3600000;0
1083;20853;9;0;0;0;0;.00nan;0;0
1083;26824;28;0;0;0;0;.00nan;0;0
1084;7139;29;0;0;0;0;.00nan;0;0
1084;15505;8;64;51;5;46;.902;3600000;0
1084;18351;29;76;25;2;23;.920;3600000;0
1084;25076;8;0;0;0;0;.00nan;0;0
1085;928;20;0;0;0;0;.00nan;0;0
1085;18078;20;87;37;2;35;.946;3566000;0
1085;18104;10;100;37;0;37;1.000;3600000;0
1085;27488;10;0;0;0;0;.00nan;0;0
1086;823;23;99;41;2;39;.951;3600000;0
1086;1796;16;54;28;4;24;.857;2353000;0
1086;10274;23;0;0;0;0;.00nan;0;0
1086;14321;16;58;12;1;11;.917;1247000;0
1087;1913;30;0;0;0;0;.00nan;0;0
1087;4826;30;84;47;4;43;.915;3600000;0
1087;22601;26;74;21;1;20;.952;3600000;0
1087;32754;26;0;0;0;0;.00nan;0;0
1088;500;4182;85;15;0;15;1.000;3600000;0
1088;1572;4838;98;56;2;54;.964;3539000;0
1088;2328;4838;0;0;0;0;.00nan;0;0
1088;25521;4182;0;0;0;0;.00nan;0;0
1089;4450;5;0;0;0;0;.00nan;0;0
1089;13842;34;81;37;3;34;.919;3600000;0
1089;15502;34;0;0;0;0;.00nan;0;0
1089;19823;5;57;34;4;30;.882;3576000;0
1090;717;0;40;34;6;28;.824;3600000;0
1090;7139;29;40;17;3;14;.824;3600000;0
1090;18351;29;0;0;0;0;.00nan;0;0
1090;31035;0;0;0;0;0;.00nan;0;0
1091;51;21;0;0;0;0;.00nan;0;0
1091;61;31;0;0;0;0;.00nan;0;0
1091;25843;21;60;23;3;20;.870;3600000;0
1091;34797;31;53;33;4;29;.879;3553000;0
1092;1251;14;0;0;0;0;.00nan;0;0
1092;1821;3;0;0;0;0;.00nan;0;0
1092;2054;3;69;34;4;30;.882;3880000;0
1092;25584;14;71;39;4;35;.897;3900000;0
1093;262;35;85;39;3;36;.923;3600000;0
1093;1430;35;0;0;0;0;.00nan;0;0
1093;10103;24;0;0;0;0;.00nan;0;0
1093;13979;24;70;27;2;25;.926;3600000;0
1094;15464;32;0;0;0;0;.00nan;0;0
1094;16006;32;68;28;2;26;.929;3600000;0
1094;27739;22;0;0;0;0;.00nan;0;0
1094;28026;22;52;28;4;24;.857;3563000;0
1095;724;11;93;32;2;30;.938;3900000;0
1095;4506;33;76;19;2;17;.895;3900000;0
1095;21522;11;0;0;0;0;.00nan;0;0
1095;34740;33;0;0;0;0;.00nan;0;0
1096;1614;25;81;40;4;36;.900;3600000;0
1096;2423;15;54;4;0;4;1.000;675000;0
1096;4106;15;40;28;5;23;.821;2925000;0
1096;4716;25;0;0;0;0;.00nan;0;0
1097;544;19;86;48;3;45;.938;3600000;0
1097;1796;16;100;26;0;26;1.000;3600000;0
1097;14321;16;0;0;0;0;.00nan;0;0
1097;31124;19;0;0;0;0;.00nan;0;0
1098;376;12;67;9;0;9;1.000;1465000;0
1098;445;12;36;18;4;14;.778;2105000;0
1098;738;27;70;39;3;36;.923;3600000;0
1098;26623;27;0;0;0;0;.00nan;0;0
1099;61;31;56;28;4;24;.857;3600000;0
1099;5385;17;90;36;3;33;.917;3600000;0
1099;34006;17;0;0;0;0;.00nan;0;0
1099;34797;31;0;0;0;0;.00nan;0;0
1100;323;9;0;0;0;0;.00nan;0;0
1100;2058;28;0;0;0;0;.00nan;0;0
1100;20853;9;54;19;3;16;.842;3600000;0
1100;26824;28;64;43;5;38;.884;3586000;0
1101;51;21;70;31;3;28;.903;3600000;0
1101;928;20;53;32;4;28;.875;3570000;0
1101;18078;20;0;0;0;0;.00nan;0;0
1101;25843;21;0;0;0;0;.00nan;0;0
1102;1251;14;65;30;3;27;.900;3600000;0
1102;18104;10;61;17;2;15;.882;3600000;0
1102;25584;14;0;0;0;0;.00nan;0;0
1102;27488;10;0;0;0;0;.00nan;0;0
1103;262;35;0;0;0;0;.00nan;0;0
1103;1430;35;99;52;2;50;.962;3600000;0
1103;27739;22;67;26;3;23;.885;3587000;0
1103;28026;22;0;0;0;0;.00nan;0;0
1104;15505;8;0;0;0;0;.00nan;0;0
1104;22601;26;93;35;1;34;.971;3600000;0
1104;25076;8;61;29;3;26;.897;3530000;0
1104;32754;26;0;0;0;0;.00nan;0;0
1105;335;18;0;0;0;0;.00nan;0;0
1105;500;4182;82;34;2;32;.941;3577000;0
1105;5001;18;89;41;1;40;.976;3600000;0
1105;25521;4182;0;0;0;0;.00nan;0;0
1106;823;23;45;26;4;22;.846;3600000;0
1106;1913;30;57;38;5;33;.868;3553000;0
1106;4826;30;0;0;0;0;.00nan;0;0
1106;10274;23;0;0;0;0;.00nan;0;0
1107;376;12;71;25;2;23;.920;3600000;0
1107;445;12;0;0;0;0;.00nan;0;0
1107;1572;4838;0;0;0;0;.00nan;0;0
1107;2328;4838;76;44;4;40;.909;3532000;0
1108;1821;3;58;19;2;17;.895;2435000;0
1108;2054;3;57;11;1;10;.909;1116000;0
1108;7139;29;0;0;0;0;.00nan;0;0
1108;18351;29;78;29;2;27;.931;3600000;0
1109;4450;5;0;0;0;0;.00nan;0;0
1109;13842;34;0;0;0;0;.00nan;0;0
1109;15502;34;54;22;3;19;.864;3549000;0
1109;19823;5;93;33;2;31;.939;3600000;0
1110;1796;16;98;23;0;23;1.000;3600000;0
1110;14321;16;0;0;0;0;.00nan;0;0
1110;22601;26;0;0;0;0;.00nan;0;0
1110;32754;26;82;36;2;34;.944;3587000;0
1111;544;19;95;35;1;34;.971;3874000;0
1111;724;11;0;0;0;0;.00nan;0;0
1111;21522;11;92;40;2;38;.950;3874000;0
1111;31124;19;0;0;0;0;.00nan;0;0
1112;5385;17;65;45;5;40;.889;3600000;0
1112;10103;24;0;0;0;0;.00nan;0;0
1112;13979;24;85;31;2;29;.935;3600000;0
1112;34006;17;0;0;0;0;.00nan;0;0
1113;717;0;0;0;0;0;.00nan;0;0
1113;2058;28;54;32;4;28;.875;3565000;0
1113;26824;28;0;0;0;0;.00nan;0;0
1113;31035;0;74;36;3;33;.917;3600000;0
1114;323;9;57;27;5;22;.815;3600000;0
1114;4450;5;0;0;0;0;.00nan;0;0
1114;19823;5;100;42;1;41;.976;3600000;0
1114;20853;9;0;0;0;0;.00nan;0;0
1115;61;31;0;0;0;0;.00nan;0;0
1115;2054;3;62;23;2;21;.913;3577000;0
1115;26967;3;0;0;0;0;.00nan;0;0
1115;34797;31;100;35;0;35;1.000;3600000;0
1116;51;21;0;0;0;0;.00nan;0;0
1116;18104;10;93;27;1;26;.963;3600000;0
1116;25843;21;74;27;2;25;.926;3544000;0
1116;27488;10;0;0;0;0;.00nan;0;0
1117;1251;14;0;0;0;0;.00nan;0;0
1117;13842;34;50;31;4;27;.871;3579000;0
1117;15502;34;0;0;0;0;.00nan;0;0
1117;25584;14;56;26;3;23;.885;3600000;0
1118;1614;25;94;44;3;41;.932;3645000;0
1118;2423;15;80;34;2;32;.941;3645000;0
1118;4106;15;0;0;0;0;.00nan;0;0
1118;4716;25;0;0;0;0;.00nan;0;0
1119;262;35;54;4;0;4;1.000;345000;0
1119;1430;35;24;35;8;27;.771;3255000;0
1119;15464;32;34;18;5;13;.722;3600000;0
1119;16006;32;0;0;0;0;.00nan;0;0
1120;376;12;0;0;0;0;.00nan;0;0
1120;445;12;87;35;3;32;.914;3900000;0
1120;928;20;66;25;3;22;.880;3900000;0
1120;18078;20;0;0;0;0;.00nan;0;0
1121;738;27;58;24;3;21;.875;3600000;0
1121;823;23;62;35;5;30;.857;3532000;0
1121;10274;23;0;0;0;0;.00nan;0;0
1121;26623;27;0;0;0;0;.00nan;0;0
1122;7139;29;0;0;0;0;.00nan;0;0
1122;18351;29;94;28;1;27;.964;3600000;0
1122;27739;22;0;0;0;0;.00nan;0;0
1122;28026;22;55;31;4;27;.871;3600000;0
1123;1572;4838;0;0;0;0;.00nan;0;0
1123;1796;16;61;25;2;23;.920;3900000;0
1123;2328;4838;71;33;2;31;.939;3900000;0
1123;14321;16;0;0;0;0;.00nan;0;0
1124;323;9;0;0;0;0;.00nan;0;0
1124;4506;33;99;45;1;44;.978;3600000;0
1124;20853;9;84;34;2;32;.941;3567000;0
1124;34740;33;0;0;0;0;.00nan;0;0
1125;544;19;77;29;3;26;.897;3600000;0
1125;1913;30;46;46;7;39;.848;3600000;0
1125;4826;30;0;0;0;0;.00nan;0;0
1125;31124;19;0;0;0;0;.00nan;0;0
1126;335;18;0;0;0;0;.00nan;0;0
1126;500;4182;78;21;1;20;.952;3600000;0
1126;5001;18;98;38;2;36;.947;3600000;0
1126;25521;4182;0;0;0;0;.00nan;0;0
1127;51;21;0;0;0;0;.00nan;0;0
1127;2058;28;99;46;1;45;.978;3600000;0
1127;25843;21;63;35;4;31;.886;3600000;0
1127;26824;28;0;0;0;0;.00nan;0;0
1128;2423;15;0;0;0;0;.00nan;0;0
1128;4106;15;83;27;1;26;.963;3600000;0
1128;18104;10;84;42;4;38;.905;3600000;0
1128;27488;10;0;0;0;0;.00nan;0;0
1129;5385;17;25;30;6;24;.800;2888000;0
1129;10103;24;0;0;0;0;.00nan;0;0
1129;13979;24;100;43;0;43;1.000;3600000;0
1129;34006;17;52;4;0;4;1.000;712000;0
1130;1251;14;84;34;2;32;.941;3600000;0
1130;13842;34;0;0;0;0;.00nan;0;0
1130;15502;34;86;44;3;41;.932;3578000;0
1130;25584;14;0;0;0;0;.00nan;0;0
1131;1572;4838;82;27;1;26;.963;3600000;0
1131;2328;4838;0;0;0;0;.00nan;0;0
1131;15505;8;78;48;4;44;.917;3600000;0
1131;25076;8;0;0;0;0;.00nan;0;0
1132;376;12;0;0;0;0;.00nan;0;0
1132;445;12;100;37;1;36;.973;3600000;0
1132;2054;3;0;0;0;0;.00nan;0;0
1132;26967;3;67;32;3;29;.906;3537000;0
1133;335;18;0;0;0;0;.00nan;0;0
1133;5001;18;87;31;2;29;.935;3900000;0
1133;22601;26;88;34;2;32;.941;3900000;0
1133;32754;26;0;0;0;0;.00nan;0;0
1134;724;11;0;0;0;0;.00nan;0;0
1134;823;23;58;26;4;22;.846;3515000;0
1134;10274;23;0;0;0;0;.00nan;0;0
1134;21522;11;69;27;2;25;.926;3600000;0
1135;544;19;58;22;2;20;.909;3600000;0
1135;738;27;79;40;4;36;.900;3520000;0
1135;26623;27;0;0;0;0;.00nan;0;0
1135;31124;19;0;0;0;0;.00nan;0;0
1136;4450;5;0;0;0;0;.00nan;0;0
1136;7139;29;0;0;0;0;.00nan;0;0
1136;18351;29;68;31;3;28;.903;3600000;0
1136;19823;5;51;32;4;28;.875;3582000;0
1137;61;31;0;0;0;0;.00nan;0;0
1137;5385;17;0;0;0;0;.00nan;0;0
1137;34006;17;39;44;7;37;.841;3600000;0
1137;34797;31;100;23;0;23;1.000;3600000;0
1138;928;20;74;28;2;26;.929;3600000;0
1138;10103;24;0;0;0;0;.00nan;0;0
1138;13979;24;71;39;4;35;.897;3513000;0
1138;18078;20;0;0;0;0;.00nan;0;0
1139;262;35;0;0;0;0;.00nan;0;0
1139;1430;35;80;35;3;32;.914;3600000;0
1139;1796;16;100;26;0;26;1.000;3600000;0
1139;14321;16;0;0;0;0;.00nan;0;0
1140;1614;25;88;43;2;41;.953;3600000;0
1140;4506;33;66;30;3;27;.900;3574000;0
1140;4716;25;0;0;0;0;.00nan;0;0
1140;34740;33;0;0;0;0;.00nan;0;0
1141;717;0;0;0;0;0;.00nan;0;0
1141;2054;3;98;22;0;22;1.000;3600000;0
1141;26967;3;0;0;0;0;.00nan;0;0
1141;31035;0;75;33;3;30;.909;3600000;0
1142;323;9;0;0;0;0;.00nan;0;0
1142;13842;34;0;0;0;0;.00nan;0;0
1142;15502;34;61;27;3;24;.889;3600000;0
1142;20853;9;58;37;5;32;.865;3583000;0
1143;2058;28;49;40;6;34;.850;2960000;0
1143;18104;10;63;22;2;20;.909;3600000;0
1143;26824;28;31;14;4;10;.714;640000;0
1143;27488;10;0;0;0;0;.00nan;0;0
1144;1251;14;0;0;0;0;.00nan;0;0
1144;1913;30;74;38;3;35;.921;3600000;0
1144;4826;30;0;0;0;0;.00nan;0;0
1144;25584;14;80;26;1;25;.962;3600000;0
1145;2423;15;58;33;4;29;.879;3572000;0
1145;4106;15;0;0;0;0;.00nan;0;0
1145;27739;22;0;0;0;0;.00nan;0;0
1145;28026;22;92;44;3;41;.932;3600000;0
1146;928;20;0;0;0;0;.00nan;0;0
1146;1796;16;96;31;1;30;.968;3600000;0
1146;14321;16;0;0;0;0;.00nan;0;0
1146;18078;20;71;35;3;32;.914;3600000;0
1147;61;31;0;0;0;0;.00nan;0;0
1147;15464;32;84;30;2;28;.933;3600000;0
1147;16006;32;0;0;0;0;.00nan;0;0
1147;34797;31;46;25;4;21;.840;3516000;0
1148;51;21;0;0;0;0;.00nan;0;0
1148;376;12;65;30;4;26;.867;3559000;0
1148;445;12;0;0;0;0;.00nan;0;0
1148;25843;21;78;33;2;31;.939;3600000;0
1149;262;35;0;0;0;0;.00nan;0;0
1149;724;11;0;0;0;0;.00nan;0;0
1149;1430;35;86;25;1;24;.960;3900000;0
1149;21522;11;71;21;1;20;.952;3900000;0
1150;823;23;0;0;0;0;.00nan;0;0
1150;1614;25;97;41;3;38;.927;3600000;0
1150;4716;25;0;0;0;0;.00nan;0;0
1150;10274;23;88;55;4;51;.927;3543000;0
1151;335;18;0;0;0;0;.00nan;0;0
1151;738;27;99;45;2;43;.956;3794000;0
1151;5001;18;72;31;3;28;.903;3794000;0
1151;26623;27;0;0;0;0;.00nan;0;0
1152;500;4182;87;30;1;29;.967;3600000;0
1152;22601;26;79;28;2;26;.929;3570000;0
1152;25521;4182;0;0;0;0;.00nan;0;0
1152;32754;26;0;0;0;0;.00nan;0;0
1153;544;19;79;32;2;30;.938;3557000;0
1153;1572;4838;100;42;1;41;.976;3600000;0
1153;2328;4838;0;0;0;0;.00nan;0;0
1153;31124;19;0;0;0;0;.00nan;0;0
1154;2058;28;0;0;0;0;.00nan;0;0
1154;4506;33;80;25;2;23;.920;3600000;0
1154;26824;28;86;51;3;48;.941;3558000;0
1154;34740;33;0;0;0;0;.00nan;0;0
1155;5385;17;67;28;3;25;.893;3600000;0
1155;7139;29;0;0;0;0;.00nan;0;0
1155;18351;29;53;26;4;22;.846;3564000;0
1155;34006;17;0;0;0;0;.00nan;0;0
1156;2423;15;0;0;0;0;.00nan;0;0
1156;4106;15;77;41;3;38;.927;3671000;0
1156;15464;32;0;0;0;0;.00nan;0;0
1156;16006;32;73;30;2;28;.933;3671000;0
1157;4450;5;0;0;0;0;.00nan;0;0
1157;19823;5;77;23;1;22;.957;3600000;0
1157;27739;22;76;37;3;34;.919;3583000;0
1157;28026;22;0;0;0;0;.00nan;0;0
1158;1913;30;0;0;0;0;.00nan;0;0
1158;4826;30;96;33;1;32;.970;3600000;0
1158;10103;24;0;0;0;0;.00nan;0;0
1158;13979;24;65;20;2;18;.900;3581000;0
1159;376;12;0;0;0;0;.00nan;0;0
1159;445;12;64;21;2;19;.905;3545000;0
1159;15505;8;84;30;1;29;.967;3600000;0
1159;25076;8;0;0;0;0;.00nan;0;0
1160;500;4182;86;33;2;31;.939;3600000;0
1160;738;27;0;0;0;0;.00nan;0;0
1160;25521;4182;0;0;0;0;.00nan;0;0
1160;26623;27;58;42;5;37;.881;3600000;0
1161;717;0;0;0;0;0;.00nan;0;0
1161;4506;33;83;19;1;18;.947;3600000;0
1161;31035;0;70;28;2;26;.929;3600000;0
1161;34740;33;0;0;0;0;.00nan;0;0
1162;262;35;0;0;0;0;.00nan;0;0
1162;823;23;67;32;3;29;.906;3573000;0
1162;1430;35;72;30;2;28;.933;3600000;0
1162;10274;23;0;0;0;0;.00nan;0;0
1163;1796;16;87;50;4;46;.920;3900000;0
1163;4450;5;0;0;0;0;.00nan;0;0
1163;14321;16;0;0;0;0;.00nan;0;0
1163;19823;5;88;40;4;36;.900;3900000;0
1164;2054;3;55;29;4;25;.862;3726000;0
1164;5385;17;83;38;3;35;.921;3726000;0
1164;26967;3;0;0;0;0;.00nan;0;0
1164;34006;17;0;0;0;0;.00nan;0;0
1165;323;9;69;44;5;39;.886;3849000;0
1165;2058;28;0;0;0;0;.00nan;0;0
1165;20853;9;0;0;0;0;.00nan;0;0
1165;26824;28;49;39;6;33;.846;3870000;0
1166;61;31;0;0;0;0;.00nan;0;0
1166;1913;30;54;37;5;32;.865;3900000;0
1166;4826;30;0;0;0;0;.00nan;0;0
1166;34797;31;65;34;5;29;.853;3868000;0
1167;10103;24;0;0;0;0;.00nan;0;0
1167;13979;24;37;30;5;25;.833;3600000;0
1167;18104;10;81;36;2;34;.944;3600000;0
1167;27488;10;0;0;0;0;.00nan;0;0
1168;2423;15;100;32;0;32;1.000;3600000;0
1168;4106;15;0;0;0;0;.00nan;0;0
1168;13842;34;87;46;3;43;.935;3600000;0
1168;15502;34;0;0;0;0;.00nan;0;0
1169;1251;14;0;0;0;0;.00nan;0;0
1169;25584;14;64;43;5;38;.884;3600000;0
1169;27739;22;0;0;0;0;.00nan;0;0
1169;28026;22;90;24;1;23;.958;3600000;0
1170;738;27;81;24;2;22;.917;3600000;0
1170;15505;8;78;48;5;43;.896;3600000;0
1170;25076;8;0;0;0;0;.00nan;0;0
1170;26623;27;0;0;0;0;.00nan;0;0
1171;823;23;0;0;0;0;.00nan;0;0
1171;10274;23;89;29;1;28;.966;3600000;0
1171;15464;32;74;40;5;35;.875;3600000;0
1171;16006;32;0;0;0;0;.00nan;0;0
1172;376;12;60;28;4;24;.857;3600000;0
1172;445;12;0;0;0;0;.00nan;0;0
1172;7139;29;0;0;0;0;.00nan;0;0
1172;18351;29;92;28;1;27;.964;3600000;0
1173;544;19;72;18;1;17;.944;3600000;0
1173;1572;4838;75;35;3;32;.914;3558000;0
1173;2328;4838;0;0;0;0;.00nan;0;0
1173;31124;19;0;0;0;0;.00nan;0;0
1174;335;18;0;0;0;0;.00nan;0;0
1174;500;4182;38;31;6;25;.806;3600000;0
1174;5001;18;73;35;2;33;.943;3600000;0
1174;25521;4182;0;0;0;0;.00nan;0;0
1175;51;21;0;0;0;0;.00nan;0;0
1175;22601;26;78;30;2;28;.933;3600000;0
1175;25843;21;81;34;3;31;.912;3600000;0
1175;32754;26;0;0;0;0;.00nan;0;0
1176;1251;14;82;34;2;32;.941;3600000;0
1176;18104;10;54;37;6;31;.838;3600000;0
1176;25584;14;0;0;0;0;.00nan;0;0
1176;27488;10;0;0;0;0;.00nan;0;0
1177;717;0;0;0;0;0;.00nan;0;0
1177;13842;34;0;0;0;0;.00nan;0;0
1177;15502;34;70;33;3;30;.909;3699000;0
1177;31035;0;92;48;2;46;.958;3703000;0
1178;1572;4838;0;0;0;0;.00nan;0;0
1178;2328;4838;91;27;1;26;.963;3600000;0
1178;4506;33;64;20;2;18;.900;3552000;0
1178;34740;33;0;0;0;0;.00nan;0;0
1179;724;11;33;11;3;8;.727;665000;0
1179;1614;25;53;20;3;17;.850;3600000;0
1179;4716;25;0;0;0;0;.00nan;0;0
1179;21522;11;36;30;6;24;.800;2935000;0
1180;2058;28;84;43;4;39;.907;3600000;0
1180;4450;5;0;0;0;0;.00nan;0;0
1180;19823;5;85;25;2;23;.920;3600000;0
1180;26824;28;0;0;0;0;.00nan;0;0
1181;1796;16;55;11;1;10;.909;3600000;0
1181;5385;17;46;36;6;30;.833;3600000;0
1181;14321;16;0;0;0;0;.00nan;0;0
1181;34006;17;0;0;0;0;.00nan;0;0
1182;2054;3;0;0;0;0;.00nan;0;0
1182;26967;3;99;31;1;30;.968;3600000;0
1182;27739;22;0;0;0;0;.00nan;0;0
1182;28026;22;46;27;4;23;.852;3600000;0
1183;1913;30;97;50;2;48;.960;3900000;0
1183;4826;30;0;0;0;0;.00nan;0;0
1183;7139;29;0;0;0;0;.00nan;0;0
1183;18351;29;66;20;2;18;.900;3900000;0
1184;928;20;100;30;0;30;1.000;3600000;0
1184;2423;15;75;32;3;29;.906;3600000;0
1184;4106;15;0;0;0;0;.00nan;0;0
1184;18078;20;0;0;0;0;.00nan;0;0
1185;323;9;0;0;0;0;.00nan;0;0
1185;10103;24;0;0;0;0;.00nan;0;0
1185;13979;24;55;32;5;27;.844;3567000;0
1185;20853;9;76;33;3;30;.909;3600000;0
1186;724;11;79;32;2;30;.938;3900000;0
1186;15505;8;0;0;0;0;.00nan;0;0
1186;21522;11;0;0;0;0;.00nan;0;0
1186;25076;8;90;40;2;38;.950;3900000;0
1187;738;27;52;40;5;35;.875;3523000;0
1187;15464;32;80;35;3;32;.914;3600000;0
1187;16006;32;0;0;0;0;.00nan;0;0
1187;26623;27;0;0;0;0;.00nan;0;0
1188;262;35;0;0;0;0;.00nan;0;0
1188;376;12;0;0;0;0;.00nan;0;0
1188;445;12;58;27;4;23;.852;3568000;0
1188;1430;35;63;30;3;27;.900;3600000;0
1189;51;21;70;26;2;24;.923;2440000;0
1189;1614;25;61;26;3;23;.885;3600000;0
1189;4716;25;0;0;0;0;.00nan;0;0
1189;25843;21;28;13;4;9;.692;1160000;0
1190;500;4182;81;24;1;23;.958;3600000;0
1190;544;19;69;37;4;33;.892;3600000;0
1190;25521;4182;0;0;0;0;.00nan;0;0
1190;31124;19;0;0;0;0;.00nan;0;0
1191;335;18;0;0;0;0;.00nan;0;0
1191;5001;18;100;34;0;34;1.000;3600000;0
1191;22601;26;75;35;2;33;.943;3520000;0
1191;32754;26;0;0;0;0;.00nan;0;0
1192;717;0;0;0;0;0;.00nan;0;0
1192;928;20;91;32;1;31;.969;3600000;0
1192;18078;20;0;0;0;0;.00nan;0;0
1192;31035;0;85;44;3;41;.932;3600000;0
1193;61;31;0;0;0;0;.00nan;0;0
1193;4506;33;68;41;4;37;.902;3826000;0
1193;34740;33;0;0;0;0;.00nan;0;0
1193;34797;31;62;25;3;22;.880;3826000;0
1194;500;4182;46;23;3;20;.870;3526000;0
1194;823;23;100;44;1;43;.977;3600000;0
1194;10274;23;0;0;0;0;.00nan;0;0
1194;25521;4182;0;0;0;0;.00nan;0;0
1195;2423;15;89;36;2;34;.944;3600000;0
1195;4106;15;0;0;0;0;.00nan;0;0
1195;4450;5;0;0;0;0;.00nan;0;0
1195;19823;5;61;30;3;27;.900;3549000;0
1196;1251;14;0;0;0;0;.00nan;0;0
1196;5385;17;36;28;5;23;.821;3542000;0
1196;25584;14;85;39;3;36;.923;3600000;0
1196;34006;17;0;0;0;0;.00nan;0;0
1197;717;0;61;23;3;20;.870;3556000;0
1197;27739;22;0;0;0;0;.00nan;0;0
1197;28026;22;94;31;2;29;.935;3600000;0
1197;31035;0;0;0;0;0;.00nan;0;0
1198;2054;3;88;33;2;31;.939;3600000;0
1198;2058;28;0;0;0;0;.00nan;0;0
1198;26824;28;61;37;4;33;.892;3577000;0
1198;26967;3;0;0;0;0;.00nan;0;0
1199;4506;33;79;33;2;31;.939;3900000;0
1199;7139;29;0;0;0;0;.00nan;0;0
1199;18351;29;88;36;2;34;.944;3900000;0
1199;34740;33;0;0;0;0;.00nan;0;0
1200;323;9;0;0;0;0;.00nan;0;0
1200;18104;10;69;21;2;19;.905;3600000;0
1200;20853;9;65;36;3;33;.917;3600000;0
1200;27488;10;0;0;0;0;.00nan;0;0
1201;262;35;0;0;0;0;.00nan;0;0
1201;1430;35;42;35;6;29;.829;3600000;0
1201;1796;16;82;28;2;26;.929;3600000;0
1201;14321;16;0;0;0;0;.00nan;0;0
1202;15464;32;72;28;2;26;.929;3600000;0
1202;15505;8;20;22;6;16;.727;2231000;0
1202;16006;32;0;0;0;0;.00nan;0;0
1202;25076;8;52;11;2;9;.818;1369000;0
1203;376;12;46;13;3;10;.769;3609000;0
1203;445;12;0;0;0;0;.00nan;0;0
1203;738;27;82;32;2;30;.938;3609000;0
1203;26623;27;0;0;0;0;.00nan;0;0
1204;1614;25;61;27;3;24;.889;3598000;0
1204;4716;25;0;0;0;0;.00nan;0;0
1204;10103;24;0;0;0;0;.00nan;0;0
1204;13979;24;100;41;2;39;.951;3600000;0
1205;544;19;87;45;3;42;.933;3600000;0
1205;22601;26;54;29;4;25;.862;3599000;0
1205;31124;19;0;0;0;0;.00nan;0;0
1205;32754;26;0;0;0;0;.00nan;0;0
1206;335;18;0;0;0;0;.00nan;0;0
1206;823;23;0;0;0;0;.00nan;0;0
1206;5001;18;83;36;3;33;.917;3580000;0
1206;10274;23;69;27;2;25;.926;3600000;0
1207;724;11;0;0;0;0;.00nan;0;0
1207;13842;34;37;33;6;27;.818;3600000;0
1207;15502;34;0;0;0;0;.00nan;0;0
1207;21522;11;83;19;0;19;1.000;3600000;0
1208;51;21;0;0;0;0;.00nan;0;0
1208;1572;4838;100;46;2;44;.957;3900000;0
1208;2328;4838;0;0;0;0;.00nan;0;0
1208;25843;21;78;24;2;22;.917;3900000;0
1209;61;31;0;0;0;0;.00nan;0;0
1209;323;9;74;47;5;42;.894;3582000;0
1209;20853;9;0;0;0;0;.00nan;0;0
1209;34797;31;44;25;4;21;.840;3600000;0
1210;928;20;0;0;0;0;.00nan;0;0
1210;2054;3;0;0;0;0;.00nan;0;0
1210;18078;20;86;44;3;41;.932;3600000;0
1210;26967;3;41;22;4;18;.818;3591000;0
1211;1251;14;74;36;3;33;.917;3600000;0
1211;5385;17;0;0;0;0;.00nan;0;0
1211;25584;14;0;0;0;0;.00nan;0;0
1211;34006;17;84;33;2;31;.939;3600000;0
1212;1796;16;68;34;3;31;.912;3600000;0
1212;14321;16;0;0;0;0;.00nan;0;0
1212;15464;32;0;0;0;0;.00nan;0;0
1212;16006;32;57;23;4;19;.826;3600000;0
1213;262;35;0;0;0;0;.00nan;0;0
1213;738;27;0;0;0;0;.00nan;0;0
1213;1430;35;75;34;4;30;.882;3702000;0
1213;26623;27;69;43;5;38;.884;3702000;0
1214;1913;30;96;40;2;38;.950;3600000;0
1214;4826;30;0;0;0;0;.00nan;0;0
1214;13842;34;0;0;0;0;.00nan;0;0
1214;15502;34;52;28;4;24;.857;3550000;0
1215;1614;25;29;32;6;26;.813;2834000;0
1215;4716;25;50;6;1;5;.833;766000;0
1215;27739;22;48;8;2;6;.750;1781000;0
1215;28026;22;41;29;6;23;.793;1819000;0
1216;335;18;0;0;0;0;.00nan;0;0
1216;376;12;84;41;2;39;.951;3757000;0
1216;445;12;0;0;0;0;.00nan;0;0
1216;5001;18;67;28;3;25;.893;3757000;0
1217;10103;24;0;0;0;0;.00nan;0;0
1217;13979;24;77;22;1;21;.955;3600000;0
1217;22601;26;0;0;0;0;.00nan;0;0
1217;32754;26;74;30;2;28;.933;3593000;0
1218;51;21;50;3;0;3;1.000;375000;0
1218;500;4182;0;0;0;0;.00nan;0;0
1218;25521;4182;100;28;0;28;1.000;3600000;0
1218;25843;21;33;26;6;20;.769;3225000;0
1219;1251;14;0;0;0;0;.00nan;0;0
1219;2054;3;63;25;2;23;.920;3580000;0
1219;25584;14;91;34;1;33;.971;3600000;0
1219;26967;3;0;0;0;0;.00nan;0;0
1220;262;35;0;0;0;0;.00nan;0;0
1220;717;0;47;34;5;29;.853;3600000;0
1220;1430;35;30;37;8;29;.784;3600000;0
1220;31035;0;0;0;0;0;.00nan;0;0
1221;323;9;0;0;0;0;.00nan;0;0
1221;7139;29;0;0;0;0;.00nan;0;0
1221;18351;29;87;16;0;16;1.000;3600000;0
1221;20853;9;96;50;3;47;.940;3600000;0
1222;61;31;0;0;0;0;.00nan;0;0
1222;928;20;68;26;3;23;.885;3900000;0
1222;18078;20;0;0;0;0;.00nan;0;0
1222;34797;31;64;27;3;24;.889;3900000;0
1223;4506;33;79;24;1;23;.958;3600000;0
1223;18104;10;30;25;5;20;.800;3600000;0
1223;27488;10;0;0;0;0;.00nan;0;0
1223;34740;33;0;0;0;0;.00nan;0;0
1224;1796;16;75;28;2;26;.929;3600000;0
1224;4450;5;0;0;0;0;.00nan;0;0
1224;14321;16;0;0;0;0;.00nan;0;0
1224;19823;5;68;29;3;26;.897;3600000;0
1225;724;11;0;0;0;0;.00nan;0;0
1225;1913;30;89;47;4;43;.915;3600000;0
1225;4826;30;0;0;0;0;.00nan;0;0
1225;21522;11;74;23;1;22;.957;3600000;0
1226;738;27;32;27;6;21;.778;2550000;0
1226;13842;34;64;39;5;34;.872;3600000;0
1226;15502;34;0;0;0;0;.00nan;0;0
1226;26623;27;42;12;2;10;.833;1050000;0
1227;2058;28;100;39;2;37;.949;3600000;0
1227;5385;17;12;22;7;15;.682;2335000;0
1227;26824;28;0;0;0;0;.00nan;0;0
1227;34006;17;46;9;2;7;.778;1265000;0
1228;376;12;42;5;1;4;.800;1296000;0
1228;445;12;43;34;6;28;.824;2285000;0
1228;823;23;82;45;5;40;.889;3600000;0
1228;10274;23;0;0;0;0;.00nan;0;0
1229;15505;8;34;23;5;18;.783;2121000;0
1229;22601;26;100;47;2;45;.957;3600000;0
1229;25076;8;91;14;0;14;1.000;1479000;0
1229;32754;26;0;0;0;0;.00nan;0;0
1230;500;4182;0;0;0;0;.00nan;0;0
1230;25521;4182;49;35;5;30;.857;3600000;0
1230;27739;22;57;7;0;7;1.000;948000;0
1230;28026;22;50;39;6;33;.846;2630000;0
1231;1572;4838;76;32;3;29;.906;3564000;0
1231;1614;25;71;20;1;19;.950;3600000;0
1231;2328;4838;0;0;0;0;.00nan;0;0
1231;4716;25;0;0;0;0;.00nan;0;0
1232;717;0;0;0;0;0;.00nan;0;0
1232;1251;14;0;0;0;0;.00nan;0;0
1232;25584;14;52;21;4;17;.810;3863000;0
1232;31035;0;76;31;3;28;.903;3837000;0
1233;2054;3;56;29;4;25;.862;3575000;0
1233;7139;29;0;0;0;0;.00nan;0;0
1233;18351;29;72;32;3;29;.906;3600000;0
1233;26967;3;0;0;0;0;.00nan;0;0
1234;61;31;0;0;0;0;.00nan;0;0
1234;323;9;0;0;0;0;.00nan;0;0
1234;20853;9;65;38;4;34;.895;3600000;0
1234;34797;31;86;27;1;26;.963;3600000;0
1235;51;21;88;35;1;34;.971;3600000;0
1235;5385;17;66;26;3;23;.885;3539000;0
1235;25843;21;0;0;0;0;.00nan;0;0
1235;34006;17;0;0;0;0;.00nan;0;0
1236;928;20;100;43;2;41;.953;3600000;0
1236;18078;20;0;0;0;0;.00nan;0;0
1236;18104;10;45;27;4;23;.852;3517000;0
1236;27488;10;0;0;0;0;.00nan;0;0
1237;2423;15;72;32;3;29;.906;3600000;0
1237;4106;15;0;0;0;0;.00nan;0;0
1237;4450;5;0;0;0;0;.00nan;0;0
1237;19823;5;30;31;6;25;.806;3600000;0
1238;4506;33;100;41;2;39;.951;3600000;0
1238;10103;24;0;0;0;0;.00nan;0;0
1238;13979;24;59;34;4;30;.882;3571000;0
1238;34740;33;0;0;0;0;.00nan;0;0
1239;262;35;0;0;0;0;.00nan;0;0
1239;335;18;0;0;0;0;.00nan;0;0
1239;1430;35;53;39;5;34;.872;3600000;0
1239;5001;18;94;27;1;26;.963;3600000;0
1240;376;12;48;40;6;34;.850;3600000;0
1240;445;12;0;0;0;0;.00nan;0;0
1240;544;19;73;32;3;29;.906;3600000;0
1240;31124;19;0;0;0;0;.00nan;0;0
1241;724;11;82;39;3;36;.923;3780000;0
1241;15505;8;100;48;2;46;.958;3780000;0
1241;21522;11;0;0;0;0;.00nan;0;0
1241;25076;8;0;0;0;0;.00nan;0;0
1242;738;27;90;34;2;32;.941;3600000;0
1242;1796;16;45;37;6;31;.838;3600000;0
1242;14321;16;0;0;0;0;.00nan;0;0
1242;26623;27;0;0;0;0;.00nan;0;0
1243;2058;28;0;0;0;0;.00nan;0;0
1243;13842;34;0;0;0;0;.00nan;0;0
1243;15502;34;82;40;3;37;.925;3580000;0
1243;26824;28;99;43;2;41;.953;3600000;0
1244;262;35;16;28;7;21;.750;3688000;0
1244;1430;35;0;0;0;0;.00nan;0;0
1244;1572;4838;46;32;6;26;.813;3688000;0
1244;2328;4838;0;0;0;0;.00nan;0;0
1245;823;23;99;40;2;38;.950;3600000;0
1245;1614;25;72;35;3;32;.914;3600000;0
1245;4716;25;0;0;0;0;.00nan;0;0
1245;10274;23;0;0;0;0;.00nan;0;0
1246;22601;26;99;38;1;37;.974;3600000;0
1246;27739;22;0;0;0;0;.00nan;0;0
1246;28026;22;53;27;5;22;.815;3600000;0
1246;32754;26;0;0;0;0;.00nan;0;0
1247;4450;5;0;0;0;0;.00nan;0;0
1247;18104;10;98;64;3;61;.953;3545000;0
1247;19823;5;79;25;2;23;.920;3600000;0
1247;27488;10;0;0;0;0;.00nan;0;0
1248;928;20;74;18;1;17;.944;3600000;0
1248;5385;17;85;49;4;45;.918;3600000;0
1248;18078;20;0;0;0;0;.00nan;0;0
1248;34006;17;0;0;0;0;.00nan;0;0
1249;717;0;95;40;2;38;.950;3588000;0
1249;2058;28;84;30;1;29;.967;3600000;0
1249;26824;28;0;0;0;0;.00nan;0;0
1249;31035;0;0;0;0;0;.00nan;0;0
1250;323;9;0;0;0;0;.00nan;0;0
1250;2423;15;0;0;0;0;.00nan;0;0
1250;4106;15;65;27;2;25;.926;3588000;0
1250;20853;9;92;33;1;32;.970;3600000;0
1251;7139;29;0;0;0;0;.00nan;0;0
1251;15464;32;74;19;1;18;.947;3600000;0
1251;16006;32;0;0;0;0;.00nan;0;0
1251;18351;29;81;37;3;34;.919;3520000;0
1252;61;31;0;0;0;0;.00nan;0;0
1252;2054;3;0;0;0;0;.00nan;0;0
1252;26967;3;47;35;6;29;.829;3600000;0
1252;34797;31;91;38;2;36;.947;3600000;0
1253;51;21;0;0;0;0;.00nan;0;0
1253;10103;24;0;0;0;0;.00nan;0;0
1253;13979;24;56;22;3;19;.864;3572000;0
1253;25843;21;60;19;2;17;.895;3600000;0
1254;376;12;0;0;0;0;.00nan;0;0
1254;445;12;75;32;2;30;.938;3600000;0
1254;1572;4838;0;0;0;0;.00nan;0;0
1254;2328;4838;60;32;4;28;.875;3566000;0
1255;335;18;0;0;0;0;.00nan;0;0
1255;544;19;83;36;3;33;.917;3600000;0
1255;5001;18;87;38;2;36;.947;3600000;0
1255;31124;19;0;0;0;0;.00nan;0;0
1256;1796;16;74;24;2;22;.917;3900000;0
1256;14321;16;0;0;0;0;.00nan;0;0
1256;22601;26;0;0;0;0;.00nan;0;0
1256;32754;26;98;45;2;43;.956;3900000;0
1257;724;11;0;0;0;0;.00nan;0;0
1257;1913;30;63;38;4;34;.895;3600000;0
1257;4826;30;0;0;0;0;.00nan;0;0
1257;21522;11;77;24;1;23;.958;3600000;0
1258;738;27;78;39;3;36;.923;3588000;0
1258;15505;8;85;32;2;30;.938;3600000;0
1258;25076;8;0;0;0;0;.00nan;0;0
1258;26623;27;0;0;0;0;.00nan;0;0
1259;61;31;69;36;4;32;.889;3889000;0
1259;7139;29;0;0;0;0;.00nan;0;0
1259;18351;29;62;39;5;34;.872;3889000;0
1259;34797;31;0;0;0;0;.00nan;0;0
1260;51;21;28;17;4;13;.765;3579000;0
1260;323;9;90;48;3;45;.938;3600000;0
1260;20853;9;0;0;0;0;.00nan;0;0
1260;25843;21;0;0;0;0;.00nan;0;0
1261;928;20;0;0;0;0;.00nan;0;0
1261;10103;24;0;0;0;0;.00nan;0;0
1261;13979;24;100;33;1;32;.970;3600000;0
1261;18078;20;38;23;4;19;.826;3600000;0
1262;4450;5;0;0;0;0;.00nan;0;0
1262;18104;10;0;0;0;0;.00nan;0;0
1262;19823;5;85;26;1;25;.962;3600000;0
1262;27488;10;83;36;3;33;.917;3528000;0
1263;1251;14;0;0;0;0;.00nan;0;0
1263;2423;15;100;33;0;33;1.000;3600000;0
1263;4106;15;0;0;0;0;.00nan;0;0
1263;25584;14;82;32;2;30;.938;3534000;0
1264;2054;3;86;30;2;28;.933;3900000;0
1264;26967;3;0;0;0;0;.00nan;0;0
1264;27739;22;0;0;0;0;.00nan;0;0
1264;28026;22;92;39;2;37;.949;3900000;0
1265;823;23;93;39;2;37;.949;3529000;0
1265;10274;23;0;0;0;0;.00nan;0;0
1265;13842;34;0;0;0;0;.00nan;0;0
1265;15502;34;100;28;0;28;1.000;3600000;0
1266;262;35;0;0;0;0;.00nan;0;0
1266;1430;35;45;30;5;25;.833;3600000;0
1266;15464;32;0;0;0;0;.00nan;0;0
1266;16006;32;74;27;2;25;.926;3600000;0
1267;1614;25;26;26;6;20;.769;3199000;0
1267;4506;33;0;0;0;0;.00nan;0;0
1267;4716;25;49;7;1;6;.857;401000;0
1267;34740;33;68;35;4;31;.886;3600000;0
1268;500;4182;60;16;1;15;.938;3600000;0
1268;738;27;67;51;6;45;.882;3600000;0
1268;25521;4182;0;0;0;0;.00nan;0;0
1268;26623;27;0;0;0;0;.00nan;0;0
1269;1796;16;62;19;2;17;.895;3600000;0
1269;1913;30;0;0;0;0;.00nan;0;0
1269;4826;30;86;51;4;47;.922;3519000;0
1269;14321;16;0;0;0;0;.00nan;0;0
1270;1251;14;63;30;3;27;.900;3530000;0
1270;15505;8;74;25;1;24;.960;3600000;0
1270;25076;8;0;0;0;0;.00nan;0;0
1270;25584;14;0;0;0;0;.00nan;0;0
1271;61;31;57;17;1;16;.941;1241000;0
1271;4450;5;0;0;0;0;.00nan;0;0
1271;19823;5;62;31;4;27;.871;3600000;0
1271;34797;31;56;29;4;25;.862;2322000;0
1272;717;0;60;24;3;21;.875;3600000;0
1272;5385;17;47;26;4;22;.846;3584000;0
1272;31035;0;0;0;0;0;.00nan;0;0
1272;34006;17;0;0;0;0;.00nan;0;0
1273;51;21;0;0;0;0;.00nan;0;0
1273;2058;28;73;32;3;29;.906;3550000;0
1273;25843;21;85;22;1;21;.955;3600000;0
1273;26824;28;0;0;0;0;.00nan;0;0
1274;323;9;80;31;2;29;.935;2409000;0
1274;2054;3;0;0;0;0;.00nan;0;0
1274;20853;9;12;14;5;9;.643;1191000;0
1274;26967;3;74;26;1;25;.962;3600000;0
1275;7139;29;0;0;0;0;.00nan;0;0
1275;13842;34;0;0;0;0;.00nan;0;0
1275;15502;34;96;31;1;30;.968;3600000;0
1275;18351;29;43;21;4;17;.810;3600000;0
1276;10103;24;0;0;0;0;.00nan;0;0
1276;13979;24;76;29;2;27;.931;3575000;0
1276;18104;10;91;35;1;34;.971;3600000;0
1276;27488;10;0;0;0;0;.00nan;0;0
1277;823;23;92;35;2;33;.943;3600000;0
1277;2423;15;67;31;3;28;.903;3566000;0
1277;4106;15;0;0;0;0;.00nan;0;0
1277;10274;23;0;0;0;0;.00nan;0;0
1278;928;20;67;30;3;27;.900;3600000;0
1278;18078;20;0;0;0;0;.00nan;0;0
1278;27739;22;0;0;0;0;.00nan;0;0
1278;28026;22;64;39;4;35;.897;3550000;0
1279;544;19;92;38;2;36;.947;3600000;0
1279;15464;32;53;35;4;31;.886;3514000;0
1279;16006;32;0;0;0;0;.00nan;0;0
1279;31124;19;0;0;0;0;.00nan;0;0
1280;376;12;73;36;3;33;.917;3600000;0
1280;445;12;0;0;0;0;.00nan;0;0
1280;500;4182;28;25;6;19;.760;3600000;0
1280;25521;4182;0;0;0;0;.00nan;0;0
1281;262;35;0;0;0;0;.00nan;0;0
1281;1430;35;77;33;3;30;.909;3600000;0
1281;22601;26;19;22;6;16;.727;2594000;0
1281;32754;26;25;11;4;7;.636;1006000;0
1282;1614;25;0;0;0;0;.00nan;0;0
1282;1796;16;77;41;4;37;.902;3600000;0
1282;4716;25;75;26;1;25;.962;3600000;0
1282;14321;16;0;0;0;0;.00nan;0;0
1283;335;18;48;0;0;0;.00nan;334000;0
1283;1572;4838;0;0;0;0;.00nan;0;0
1283;2328;4838;66;33;3;30;.909;3600000;0
1283;5001;18;36;30;6;24;.800;3266000;0
1284;738;27;47;26;5;21;.808;2982000;0
1284;1913;30;89;34;2;32;.941;3600000;0
1284;4826;30;0;0;0;0;.00nan;0;0
1284;26623;27;42;5;1;4;.800;618000;0
1285;500;4182;0;0;0;0;.00nan;0;0
1285;15505;8;0;0;0;0;.00nan;0;0
1285;25076;8;58;41;5;36;.878;3600000;0
1285;25521;4182;71;23;2;21;.913;3600000;0
1286;376;12;0;0;0;0;.00nan;0;0
1286;445;12;77;27;1;26;.963;3600000;0
1286;22601;26;71;23;2;21;.913;3567000;0
1286;32754;26;0;0;0;0;.00nan;0;0
1287;1251;14;39;36;6;30;.833;3600000;0
1287;4506;33;82;34;3;31;.912;3600000;0
1287;25584;14;0;0;0;0;.00nan;0;0
1287;34740;33;0;0;0;0;.00nan;0;0
1288;724;11;49;27;4;23;.852;3900000;0
1288;1572;4838;82;38;4;34;.895;3900000;0
1288;2328;4838;0;0;0;0;.00nan;0;0
1288;21522;11;0;0;0;0;.00nan;0;0
1289;4450;5;0;0;0;0;.00nan;0;0
1289;5385;17;42;37;6;31;.838;2872000;0
1289;19823;5;66;22;3;19;.864;3600000;0
1289;34006;17;45;6;1;5;.833;728000;0
1290;61;31;0;0;0;0;.00nan;0;0
1290;2058;28;0;0;0;0;.00nan;0;0
1290;26824;28;83;34;2;32;.941;3600000;0
1290;34797;31;72;30;3;27;.900;3571000;0
1291;928;20;28;26;6;20;.769;3600000;0
1291;7139;29;0;0;0;0;.00nan;0;0
1291;18078;20;0;0;0;0;.00nan;0;0
1291;18351;29;97;42;2;40;.952;3600000;0
1292;13842;34;100;31;0;31;1.000;3600000;0
1292;15502;34;0;0;0;0;.00nan;0;0
1292;27739;22;0;0;0;0;.00nan;0;0
1292;28026;22;65;21;2;19;.905;3536000;0
1293;51;21;0;0;0;0;.00nan;0;0
1293;10103;24;0;0;0;0;.00nan;0;0
1293;13979;24;63;27;3;24;.889;3600000;0
1293;25843;21;100;28;0;28;1.000;3600000;0
1294;262;35;0;0;0;0;.00nan;0;0
1294;544;19;56;37;5;32;.865;3600000;0
1294;1430;35;41;40;6;34;.850;3600000;0
1294;31124;19;0;0;0;0;.00nan;0;0
1295;1614;25;98;36;2;34;.944;3778000;0
1295;4716;25;0;0;0;0;.00nan;0;0
1295;15464;32;85;45;3;42;.933;3778000;0
1295;16006;32;0;0;0;0;.00nan;0;0
1296;738;27;65;30;3;27;.900;3608000;0
1296;823;23;86;36;2;34;.944;3608000;0
1296;10274;23;0;0;0;0;.00nan;0;0
1296;26623;27;0;0;0;0;.00nan;0;0
1297;5385;17;74;14;0;14;1.000;1419000;0
1297;15505;8;60;32;4;28;.875;3600000;0
1297;25076;8;0;0;0;0;.00nan;0;0
1297;34006;17;51;36;6;30;.833;2181000;0
1298;2054;3;65;29;3;26;.897;3600000;0
1298;4450;5;0;0;0;0;.00nan;0;0
1298;19823;5;69;36;4;32;.889;3600000;0
1298;26967;3;0;0;0;0;.00nan;0;0
1299;61;31;92;23;0;23;1.000;3600000;0
1299;717;0;66;29;3;26;.897;3600000;0
1299;31035;0;0;0;0;0;.00nan;0;0
1299;34797;31;0;0;0;0;.00nan;0;0
1300;51;21;0;0;0;0;.00nan;0;0
1300;323;9;0;0;0;0;.00nan;0;0
1300;20853;9;75;27;2;25;.926;3600000;0
1300;25843;21;77;38;3;35;.921;3559000;0
1301;18104;10;97;49;3;46;.939;3539000;0
1301;27488;10;0;0;0;0;.00nan;0;0
1301;27739;22;59;13;1;12;.923;3600000;0
1301;28026;22;0;0;0;0;.00nan;0;0
1302;1251;14;0;0;0;0;.00nan;0;0
1302;2058;28;84;39;3;36;.923;3600000;0
1302;25584;14;71;34;4;30;.882;3561000;0
1302;26824;28;0;0;0;0;.00nan;0;0
1303;2423;15;74;28;2;26;.929;3600000;0
1303;4106;15;0;0;0;0;.00nan;0;0
1303;10103;24;0;0;0;0;.00nan;0;0
1303;13979;24;79;35;3;32;.914;3600000;0
1304;7139;29;69;28;2;26;.929;3600000;0
1304;13842;34;38;21;4;17;.810;2020000;0
1304;15502;34;61;12;1;11;.917;1580000;0
1304;18351;29;0;0;0;0;.00nan;0;0
1305;500;4182;81;25;1;24;.960;3600000;0
1305;1796;16;0;0;0;0;.00nan;0;0
1305;14321;16;50;23;3;20;.870;3555000;0
1305;25521;4182;0;0;0;0;.00nan;0;0
1306;376;12;0;0;0;0;.00nan;0;0
1306;445;12;63;20;2;18;.900;3600000;0
1306;1913;30;61;43;5;38;.884;3600000;0
1306;4826;30;0;0;0;0;.00nan;0;0
1307;262;35;0;0;0;0;.00nan;0;0
1307;1430;35;64;40;5;35;.875;3600000;0
1307;1614;25;0;0;0;0;.00nan;0;0
1307;4716;25;63;23;2;21;.913;3600000;0
1308;544;19;99;39;2;37;.949;3600000;0
1308;4506;33;98;45;3;42;.933;3600000;0
1308;31124;19;0;0;0;0;.00nan;0;0
1308;34740;33;0;0;0;0;.00nan;0;0
1309;335;18;0;0;0;0;.00nan;0;0
1309;724;11;88;41;2;39;.951;3600000;0
1309;5001;18;100;23;0;23;1.000;3600000;0
1309;21522;11;0;0;0;0;.00nan;0;0
1310;15464;32;63;31;3;28;.903;3045000;0
1310;16006;32;31;11;3;8;.727;525000;0
1310;22601;26;44;29;5;24;.828;3600000;0
1310;32754;26;0;0;0;0;.00nan;0;0
1311;738;27;0;0;0;0;.00nan;0;0
1311;1572;4838;81;35;3;32;.914;3600000;0
1311;2328;4838;0;0;0;0;.00nan;0;0
1311;26623;27;76;30;2;28;.933;3600000;0
2701;323;9;61;30;3;27;.900;3600000;0
2701;1913;30;88;20;0;20;1.000;3600000;0
2701;4826;30;0;0;0;0;.00nan;0;0
2701;20853;9;0;0;0;0;.00nan;0;0
2703;1614;25;75;32;2;30;.938;3600000;0
2703;5182;25;0;0;0;0;.00nan;0;0
2703;27739;22;61;33;4;29;.879;3546000;0
2703;28026;22;0;0;0;0;.00nan;0;0
2705;823;23;0;0;0;0;.00nan;0;0
2705;2058;28;95;49;3;46;.939;3900000;0
2705;10274;23;78;38;3;35;.921;3900000;0
2705;14061;28;0;0;0;0;.00nan;0;0
2707;1796;16;78;36;3;33;.917;3789000;0
2707;10103;24;0;0;0;0;.00nan;0;0
2707;13979;24;72;39;4;35;.897;3789000;0
2707;15437;16;0;0;0;0;.00nan;0;0
2709;1821;3;81;34;2;32;.941;3900000;0
2709;2054;3;0;0;0;0;.00nan;0;0
2709;13842;34;76;30;2;28;.933;3900000;0
2709;15502;34;0;0;0;0;.00nan;0;0
2711;335;18;0;0;0;0;.00nan;0;0
2711;5001;18;98;36;1;35;.972;3600000;0
2711;5385;17;38;28;5;23;.821;3182000;0
2711;34006;17;53;3;0;3;1.000;418000;0
2713;738;27;69;30;3;27;.900;3556000;0
2713;18078;20;77;28;2;26;.929;3600000;0
2713;26623;27;0;0;0;0;.00nan;0;0
2713;32146;20;0;0;0;0;.00nan;0;0
2715;233;29;0;0;0;0;.00nan;0;0
2715;1251;14;0;0;0;0;.00nan;0;0
2715;18351;29;65;17;1;16;.941;3600000;0
2715;25584;14;77;34;3;31;.912;3596000;0
2717;445;12;50;32;5;27;.844;3600000;0
2717;544;19;0;0;0;0;.00nan;0;0
2717;31124;19;79;23;1;22;.957;3600000;0
2717;34786;12;0;0;0;0;.00nan;0;0
2719;724;11;0;0;0;0;.00nan;0;0
2719;18104;10;60;33;4;29;.879;3851000;0
2719;21522;11;63;34;4;30;.882;3900000;0
2719;27488;10;0;0;0;0;.00nan;0;0
2721;262;35;88;28;1;27;.964;3600000;0
2721;1430;35;0;0;0;0;.00nan;0;0
2721;4506;33;58;20;3;17;.850;3543000;0
2721;34740;33;0;0;0;0;.00nan;0;0
2723;61;31;0;0;0;0;.00nan;0;0
2723;4450;5;50;26;4;22;.846;3600000;0
2723;19823;5;0;0;0;0;.00nan;0;0
2723;34797;31;75;23;2;21;.913;3600000;0
2725;1074;0;34;18;4;14;.778;995000;0
2725;22601;26;100;44;1;43;.977;3600000;0
2725;31035;0;64;21;1;20;.952;2605000;0
2725;32754;26;0;0;0;0;.00nan;0;0
2727;500;4182;0;0;0;0;.00nan;0;0
2727;15464;32;0;0;0;0;.00nan;0;0
2727;16006;32;78;46;4;42;.913;3580000;0
2727;25521;4182;78;34;2;32;.941;3600000;0
2729;51;21;68;27;3;24;.889;3600000;0
2729;1572;4838;100;26;0;26;1.000;3600000;0
2729;2328;4838;0;0;0;0;.00nan;0;0
2729;25843;21;0;0;0;0;.00nan;0;0
2731;2423;15;0;0;0;0;.00nan;0;0
2731;4106;15;74;32;3;29;.906;3900000;0
2731;15505;8;62;34;3;31;.912;3900000;0
2731;25076;8;0;0;0;0;.00nan;0;0
2733;323;9;76;39;3;36;.923;3762000;0
2733;445;12;0;0;0;0;.00nan;0;0
2733;20853;9;0;0;0;0;.00nan;0;0
2733;34786;12;59;20;2;18;.900;3762000;0
2735;51;21;0;0;0;0;.00nan;0;0
2735;1913;30;68;45;5;40;.889;3600000;0
2735;4826;30;0;0;0;0;.00nan;0;0
2735;25843;21;100;26;0;26;1.000;3600000;0
2737;1074;0;94;54;3;51;.944;3831000;0
2737;22601;26;0;0;0;0;.00nan;0;0
2737;31035;0;0;0;0;0;.00nan;0;0
2737;32754;26;92;32;2;30;.938;3831000;0
2739;724;11;73;43;4;39;.907;3600000;0
2739;1821;3;84;29;1;28;.966;3600000;0
2739;2054;3;0;0;0;0;.00nan;0;0
2739;21522;11;0;0;0;0;.00nan;0;0
2741;1572;4838;73;23;2;21;.913;3900000;0
2741;2328;4838;0;0;0;0;.00nan;0;0
2741;5385;17;0;0;0;0;.00nan;0;0
2741;34006;17;83;34;2;32;.941;3900000;0
2743;335;18;0;0;0;0;.00nan;0;0
2743;823;23;0;0;0;0;.00nan;0;0
2743;5001;18;72;37;4;33;.892;3535000;0
2743;10274;23;61;21;2;19;.905;3600000;0
2745;4506;33;34;35;7;28;.800;3600000;0
2745;18104;10;0;0;0;0;.00nan;0;0
2745;27488;10;100;45;2;43;.956;3600000;0
2745;34740;33;0;0;0;0;.00nan;0;0
2747;262;35;0;0;0;0;.00nan;0;0
2747;1430;35;89;32;2;30;.938;3600000;0
2747;2423;15;37;30;6;24;.800;1597000;0
2747;4106;15;52;19;2;17;.895;2003000;0
2749;738;27;0;0;0;0;.00nan;0;0
2749;2058;28;73;34;3;31;.912;3900000;0
2749;14061;28;0;0;0;0;.00nan;0;0
2749;26623;27;73;34;3;31;.912;3900000;0
2751;233;29;0;0;0;0;.00nan;0;0
2751;18078;20;90;18;0;18;1.000;3600000;0
2751;18351;29;86;37;2;35;.946;3551000;0
2751;32146;20;0;0;0;0;.00nan;0;0
2753;15505;8;0;0;0;0;.00nan;0;0
2753;25076;8;75;25;1;24;.960;3600000;0
2753;27739;22;70;30;2;28;.933;3546000;0
2753;28026;22;0;0;0;0;.00nan;0;0
2755;544;19;48;36;5;31;.861;3600000;0
2755;1251;14;88;35;2;33;.943;3600000;0
2755;25584;14;0;0;0;0;.00nan;0;0
2755;31124;19;0;0;0;0;.00nan;0;0
2757;10103;24;85;31;1;30;.968;2440000;0
2757;13979;24;37;14;4;10;.714;1160000;0
2757;15464;32;0;0;0;0;.00nan;0;0
2757;16006;32;66;22;2;20;.909;3600000;0
2759;4450;5;0;0;0;0;.00nan;0;0
2759;13842;34;0;0;0;0;.00nan;0;0
2759;15502;34;70;45;4;41;.911;3584000;0
2759;19823;5;59;19;2;17;.895;3600000;0
2761;500;4182;40;35;6;29;.829;3600000;0
2761;1796;16;0;0;0;0;.00nan;0;0
2761;15437;16;39;23;4;19;.826;3600000;0
2761;25521;4182;0;0;0;0;.00nan;0;0
2763;61;31;99;36;1;35;.972;3600000;0
2763;1614;25;0;0;0;0;.00nan;0;0
2763;5182;25;53;24;4;20;.833;3600000;0
2763;34797;31;0;0;0;0;.00nan;0;0
2765;1074;0;0;0;0;0;.00nan;0;0
2765;13842;34;62;24;2;22;.917;3900000;0
2765;15502;34;0;0;0;0;.00nan;0;0
2765;31035;0;100;46;2;44;.957;3900000;0
2767;262;35;65;39;5;34;.872;3565000;0
2767;323;9;0;0;0;0;.00nan;0;0
2767;1430;35;0;0;0;0;.00nan;0;0
2767;20853;9;65;34;4;30;.882;3600000;0
2769;5385;17;72;33;2;31;.939;3900000;0
2769;27739;22;0;0;0;0;.00nan;0;0
2769;28026;22;65;20;2;18;.900;3900000;0
2769;34006;17;0;0;0;0;.00nan;0;0
2771;544;19;0;0;0;0;.00nan;0;0
2771;1913;30;0;0;0;0;.00nan;0;0
2771;4826;30;99;34;1;33;.971;3600000;0
2771;31124;19;76;28;2;26;.929;3550000;0
2773;10103;24;0;0;0;0;.00nan;0;0
2773;13979;24;56;35;4;31;.886;3600000;0
2773;18078;20;71;21;1;20;.952;3600000;0
2773;32146;20;0;0;0;0;.00nan;0;0
2775;51;21;0;0;0;0;.00nan;0;0
2775;500;4182;0;0;0;0;.00nan;0;0
2775;25521;4182;71;31;2;29;.935;3542000;0
2775;25843;21;100;38;0;38;1.000;3600000;0
2777;724;11;0;0;0;0;.00nan;0;0
2777;21522;11;66;30;3;27;.900;3600000;0
2777;22601;26;53;27;5;22;.815;3575000;0
2777;32754;26;0;0;0;0;.00nan;0;0
2779;1572;4838;33;4;2;2;.500;516000;0
2779;1796;16;41;16;3;13;.813;3600000;0
2779;2328;4838;29;30;6;24;.800;3084000;0
2779;15437;16;0;0;0;0;.00nan;0;0
2781;823;23;79;19;1;18;.947;3600000;0
2781;10274;23;0;0;0;0;.00nan;0;0
2781;18104;10;34;38;7;31;.816;3600000;0
2781;27488;10;0;0;0;0;.00nan;0;0
2783;445;12;96;38;2;36;.947;3600000;0
2783;2423;15;49;17;3;14;.824;3549000;0
2783;4106;15;0;0;0;0;.00nan;0;0
2783;34786;12;0;0;0;0;.00nan;0;0
2785;1251;14;0;0;0;0;.00nan;0;0
2785;4506;33;39;8;2;6;.750;1483000;0
2785;25584;14;62;29;4;25;.862;3600000;0
2785;34740;33;30;23;5;18;.783;2117000;0
2787;1614;25;81;31;2;29;.935;3600000;0
2787;5182;25;0;0;0;0;.00nan;0;0
2787;15505;8;18;23;6;17;.739;2208000;0
2787;25076;8;73;17;0;17;1.000;1392000;0
2789;335;18;98;46;2;44;.957;3600000;0
2789;738;27;36;23;4;19;.826;3539000;0
2789;5001;18;0;0;0;0;.00nan;0;0
2789;26623;27;0;0;0;0;.00nan;0;0
2791;61;31;51;7;1;6;.857;1028000;0
2791;15464;32;77;36;3;33;.917;3600000;0
2791;16006;32;0;0;0;0;.00nan;0;0
2791;34797;31;20;23;6;17;.739;2572000;0
2793;233;29;70;16;1;15;.938;3600000;0
2793;2058;28;0;0;0;0;.00nan;0;0
2793;14061;28;98;56;3;53;.946;3600000;0
2793;18351;29;0;0;0;0;.00nan;0;0
2795;1821;3;0;0;0;0;.00nan;0;0
2795;2054;3;73;35;3;32;.914;3600000;0
2795;4450;5;45;24;5;19;.792;3516000;0
2795;19823;5;0;0;0;0;.00nan;0;0
2797;51;21;0;0;0;0;.00nan;0;0
2797;1251;14;79;29;3;26;.897;3900000;0
2797;25584;14;0;0;0;0;.00nan;0;0
2797;25843;21;66;35;3;32;.914;3900000;0
2799;323;9;0;0;0;0;.00nan;0;0
2799;724;11;65;15;1;14;.933;3600000;0
2799;20853;9;74;40;4;36;.900;3600000;0
2799;21522;11;0;0;0;0;.00nan;0;0
2801;1074;0;91;41;1;40;.976;3600000;0
2801;1821;3;67;25;2;23;.920;3591000;0
2801;2054;3;0;0;0;0;.00nan;0;0
2801;31035;0;0;0;0;0;.00nan;0;0
2803;15505;8;0;0;0;0;.00nan;0;0
2803;22601;26;45;31;5;26;.839;3600000;0
2803;25076;8;89;27;1;26;.963;3600000;0
2803;32754;26;0;0;0;0;.00nan;0;0
2805;2058;28;87;32;2;30;.938;3544000;0
2805;14061;28;0;0;0;0;.00nan;0;0
2805;27739;22;100;35;1;34;.971;3600000;0
2805;28026;22;0;0;0;0;.00nan;0;0
2807;233;29;0;0;0;0;.00nan;0;0
2807;1614;25;46;22;4;18;.818;3559000;0
2807;5182;25;0;0;0;0;.00nan;0;0
2807;18351;29;68;29;3;26;.897;3600000;0
2809;4450;5;0;0;0;0;.00nan;0;0
2809;18104;10;0;0;0;0;.00nan;0;0
2809;19823;5;99;44;2;42;.955;3900000;0
2809;27488;10;64;22;2;20;.909;3900000;0
2811;1796;16;93;19;0;19;1.000;3600000;0
2811;13842;34;0;0;0;0;.00nan;0;0
2811;15437;16;0;0;0;0;.00nan;0;0
2811;15502;34;83;34;2;32;.941;3577000;0
2813;4506;33;74;35;3;32;.914;3556000;0
2813;18078;20;73;26;2;24;.923;3600000;0
2813;32146;20;0;0;0;0;.00nan;0;0
2813;34740;33;0;0;0;0;.00nan;0;0
2815;738;27;88;33;1;32;.970;2999000;0
2815;15464;32;85;32;3;29;.906;3600000;0
2815;16006;32;0;0;0;0;.00nan;0;0
2815;26623;27;25;6;3;3;.500;574000;0
2817;262;35;0;0;0;0;.00nan;0;0
2817;1430;35;95;46;3;43;.935;3900000;0
2817;2423;15;0;0;0;0;.00nan;0;0
2817;4106;15;51;25;4;21;.840;3900000;0
2819;1572;4838;0;0;0;0;.00nan;0;0
2819;2328;4838;100;37;1;36;.973;3600000;0
2819;10103;24;42;30;4;26;.867;3600000;0
2819;13979;24;0;0;0;0;.00nan;0;0
2821;823;23;0;0;0;0;.00nan;0;0
2821;1913;30;87;27;1;26;.963;3600000;0
2821;4826;30;0;0;0;0;.00nan;0;0
2821;10274;23;81;44;3;41;.932;3561000;0
2823;61;31;92;38;2;36;.947;3565000;0
2823;445;12;0;0;0;0;.00nan;0;0
2823;34786;12;92;32;1;31;.969;3600000;0
2823;34797;31;0;0;0;0;.00nan;0;0
2825;500;4182;53;30;4;26;.867;3558000;0
2825;5385;17;0;0;0;0;.00nan;0;0
2825;25521;4182;0;0;0;0;.00nan;0;0
2825;34006;17;73;30;2;28;.933;3600000;0
2827;335;18;63;51;6;45;.882;3290000;0
2827;544;19;70;20;1;19;.950;3600000;0
2827;5001;18;42;3;1;2;.667;310000;0
2827;31124;19;0;0;0;0;.00nan;0;0
2829;335;18;46;10;2;8;.800;1448000;0
2829;2423;15;88;33;2;31;.939;3600000;0
2829;4106;15;0;0;0;0;.00nan;0;0
2829;5001;18;39;20;4;16;.800;2152000;0
2831;1251;14;0;0;0;0;.00nan;0;0
2831;1796;16;56;33;4;29;.879;3537000;0
2831;15437;16;0;0;0;0;.00nan;0;0
2831;25584;14;80;34;2;32;.941;3600000;0
2833;18078;20;0;0;0;0;.00nan;0;0
2833;27739;22;0;0;0;0;.00nan;0;0
2833;28026;22;89;21;0;21;1.000;3600000;0
2833;32146;20;64;35;4;31;.886;3600000;0
2835;1614;25;0;0;0;0;.00nan;0;0
2835;5182;25;72;24;2;22;.917;3600000;0
2835;22601;26;0;0;0;0;.00nan;0;0
2835;32754;26;78;38;3;35;.921;3600000;0
2837;10103;24;0;0;0;0;.00nan;0;0
2837;13842;34;85;41;3;38;.927;3549000;0
2837;13979;24;60;19;2;17;.895;3600000;0
2837;15502;34;0;0;0;0;.00nan;0;0
2839;262;35;51;31;5;26;.839;3524000;0
2839;1430;35;0;0;0;0;.00nan;0;0
2839;1821;3;0;0;0;0;.00nan;0;0
2839;2054;3;81;41;3;38;.927;3600000;0
2841;544;19;0;0;0;0;.00nan;0;0
2841;4450;5;27;24;5;19;.792;3600000;0
2841;19823;5;0;0;0;0;.00nan;0;0
2841;31124;19;93;52;2;50;.962;3600000;0
2843;1074;0;0;0;0;0;.00nan;0;0
2843;5385;17;74;32;3;29;.906;3600000;0
2843;31035;0;53;34;5;29;.853;3514000;0
2843;34006;17;0;0;0;0;.00nan;0;0
2845;233;29;68;27;2;25;.926;3600000;0
2845;15464;32;0;0;0;0;.00nan;0;0
2845;16006;32;61;28;3;25;.893;3600000;0
2845;18351;29;0;0;0;0;.00nan;0;0
2847;445;12;100;24;0;24;1.000;3600000;0
2847;724;11;58;28;3;25;.893;3163000;0
2847;21522;11;33;11;3;8;.727;437000;0
2847;34786;12;0;0;0;0;.00nan;0;0
2849;51;21;58;31;4;27;.871;3577000;0
2849;823;23;85;30;2;28;.933;3600000;0
2849;10274;23;0;0;0;0;.00nan;0;0
2849;25843;21;0;0;0;0;.00nan;0;0
2851;738;27;0;0;0;0;.00nan;0;0
2851;1572;4838;81;27;2;25;.926;3723000;0
2851;2328;4838;0;0;0;0;.00nan;0;0
2851;26623;27;66;20;1;19;.950;3723000;0
2853;61;31;0;0;0;0;.00nan;0;0
2853;323;9;78;45;5;40;.889;3579000;0
2853;20853;9;0;0;0;0;.00nan;0;0
2853;34797;31;38;16;3;13;.813;3600000;0
2855;500;4182;0;0;0;0;.00nan;0;0
2855;4506;33;0;0;0;0;.00nan;0;0
2855;25521;4182;79;21;1;20;.952;3900000;0
2855;34740;33;95;44;1;43;.977;3900000;0
2857;15505;8;22;15;5;10;.667;893000;0
2857;18104;10;91;37;2;35;.946;3600000;0
2857;25076;8;71;20;1;19;.950;2707000;0
2857;27488;10;0;0;0;0;.00nan;0;0
2859;1913;30;0;0;0;0;.00nan;0;0
2859;2058;28;0;0;0;0;.00nan;0;0
2859;4826;30;45;27;4;23;.852;3592000;0
2859;14061;28;68;33;3;30;.909;3600000;0
2861;1251;14;67;36;4;32;.889;3600000;0
2861;1614;25;100;35;0;35;1.000;3600000;0
2861;5182;25;0;0;0;0;.00nan;0;0
2861;25584;14;0;0;0;0;.00nan;0;0
2863;323;9;51;13;2;11;.846;1927000;0
2863;4450;5;0;0;0;0;.00nan;0;0
2863;19823;5;51;30;5;25;.833;3600000;0
2863;20853;9;36;24;5;19;.792;1632000;0
2865;10103;24;0;0;0;0;.00nan;0;0
2865;13979;24;68;35;4;31;.886;3515000;0
2865;18078;20;82;33;2;31;.939;3600000;0
2865;32146;20;0;0;0;0;.00nan;0;0
2867;1821;3;0;0;0;0;.00nan;0;0
2867;2054;3;85;44;4;40;.909;3593000;0
2867;15464;32;84;32;2;30;.938;3600000;0
2867;16006;32;0;0;0;0;.00nan;0;0
2869;233;29;0;0;0;0;.00nan;0;0
2869;500;4182;80;23;1;22;.957;3600000;0
2869;18351;29;93;50;3;47;.940;3600000;0
2869;25521;4182;0;0;0;0;.00nan;0;0
2871;823;23;0;0;0;0;.00nan;0;0
2871;1572;4838;0;0;0;0;.00nan;0;0
2871;2328;4838;52;35;4;31;.886;3600000;0
2871;10274;23;34;24;5;19;.792;3525000;0
2873;1074;0;100;34;0;34;1.000;3600000;0
2873;2058;28;36;25;4;21;.840;3600000;0
2873;14061;28;0;0;0;0;.00nan;0;0
2873;31035;0;0;0;0;0;.00nan;0;0
2875;445;12;70;30;2;28;.933;3600000;0
2875;18104;10;0;0;0;0;.00nan;0;0
2875;27488;10;57;32;4;28;.875;3517000;0
2875;34786;12;0;0;0;0;.00nan;0;0
2877;738;27;0;0;0;0;.00nan;0;0
2877;15505;8;49;28;4;24;.857;3579000;0
2877;25076;8;0;0;0;0;.00nan;0;0
2877;26623;27;99;46;2;44;.957;3600000;0
2879;61;31;0;0;0;0;.00nan;0;0
2879;544;19;0;0;0;0;.00nan;0;0
2879;31124;19;89;39;2;37;.949;3900000;0
2879;34797;31;76;32;2;30;.938;3900000;0
2881;13842;34;0;0;0;0;.00nan;0;0
2881;15502;34;82;35;2;33;.943;3874000;0
2881;27739;22;0;0;0;0;.00nan;0;0
2881;28026;22;58;30;3;27;.900;3874000;0
2883;1796;16;63;19;1;18;.947;3600000;0
2883;1913;30;98;47;2;45;.957;3600000;0
2883;4826;30;0;0;0;0;.00nan;0;0
2883;15437;16;0;0;0;0;.00nan;0;0
2885;51;21;0;0;0;0;.00nan;0;0
2885;724;11;48;23;4;19;.826;3559000;0
2885;21522;11;0;0;0;0;.00nan;0;0
2885;25843;21;73;27;2;25;.926;3600000;0
2887;4506;33;60;17;1;16;.941;3600000;0
2887;5385;17;0;0;0;0;.00nan;0;0
2887;34006;17;81;35;2;33;.943;3576000;0
2887;34740;33;0;0;0;0;.00nan;0;0
2889;335;18;70;27;2;25;.926;3871000;0
2889;5001;18;0;0;0;0;.00nan;0;0
2889;22601;26;72;32;3;29;.906;3871000;0
2889;32754;26;0;0;0;0;.00nan;0;0
2891;262;35;0;0;0;0;.00nan;0;0
2891;1430;35;80;23;1;22;.957;3600000;0
2891;2423;15;0;0;0;0;.00nan;0;0
2891;4106;15;80;33;2;31;.939;3600000;0
2893;4506;33;0;0;0;0;.00nan;0;0
2893;18078;20;0;0;0;0;.00nan;0;0
2893;32146;20;87;29;1;28;.966;3600000;0
2893;34740;33;54;31;4;27;.871;3600000;0
2895;1251;14;0;0;0;0;.00nan;0;0
2895;10103;24;54;21;3;18;.857;3600000;0
2895;13979;24;0;0;0;0;.00nan;0;0
2895;25584;14;57;30;4;26;.867;3585000;0
2897;1821;3;89;42;3;39;.929;3600000;0
2897;2054;3;0;0;0;0;.00nan;0;0
2897;15464;32;0;0;0;0;.00nan;0;0
2897;16006;32;73;22;1;21;.955;3600000;0
2899;233;29;98;37;1;36;.973;3591000;0
2899;1614;25;100;35;0;35;1.000;3600000;0
2899;5182;25;0;0;0;0;.00nan;0;0
2899;18351;29;0;0;0;0;.00nan;0;0
2901;1572;4838;76;30;2;28;.933;3600000;0
2901;2328;4838;0;0;0;0;.00nan;0;0
2901;27739;22;63;29;3;26;.897;3571000;0
2901;28026;22;0;0;0;0;.00nan;0;0
2903;323;9;0;0;0;0;.00nan;0;0
2903;2058;28;0;0;0;0;.00nan;0;0
2903;14061;28;56;25;3;22;.880;3600000;0
2903;20853;9;76;26;1;25;.962;3600000;0
2905;500;4182;0;0;0;0;.00nan;0;0
2905;1074;0;34;19;4;15;.789;900000;0
2905;25521;4182;49;20;3;17;.850;3600000;0
2905;31035;0;86;43;3;40;.930;2700000;0
2907;544;19;83;48;4;44;.917;3600000;0
2907;724;11;0;0;0;0;.00nan;0;0
2907;21522;11;97;36;1;35;.972;3600000;0
2907;31124;19;0;0;0;0;.00nan;0;0
2909;1796;16;0;0;0;0;.00nan;0;0
2909;15437;16;35;27;5;22;.815;3600000;0
2909;22601;26;0;0;0;0;.00nan;0;0
2909;32754;26;95;45;2;43;.956;3600000;0
2911;51;21;67;30;3;27;.900;3600000;0
2911;13842;34;49;27;4;23;.852;3576000;0
2911;15502;34;0;0;0;0;.00nan;0;0
2911;25843;21;0;0;0;0;.00nan;0;0
2913;1913;30;0;0;0;0;.00nan;0;0
2913;4826;30;63;33;3;30;.909;3567000;0
2913;18104;10;80;24;1;23;.958;3600000;0
2913;27488;10;0;0;0;0;.00nan;0;0
2915;738;27;59;35;4;31;.886;2385000;0
2915;2423;15;67;27;3;24;.889;3600000;0
2915;4106;15;0;0;0;0;.00nan;0;0
2915;26623;27;68;16;1;15;.938;1137000;0
2917;335;18;0;0;0;0;.00nan;0;0
2917;5001;18;64;18;2;16;.889;3593000;0
2917;5385;17;87;26;1;25;.962;3600000;0
2917;34006;17;0;0;0;0;.00nan;0;0
2919;61;31;62;32;4;28;.875;3546000;0
2919;445;12;0;0;0;0;.00nan;0;0
2919;34786;12;78;39;3;36;.923;3600000;0
2919;34797;31;0;0;0;0;.00nan;0;0
2921;262;35;93;29;1;28;.966;3600000;0
2921;1430;35;0;0;0;0;.00nan;0;0
2921;15505;8;0;0;0;0;.00nan;0;0
2921;25076;8;89;47;3;44;.936;3554000;0
2923;823;23;87;59;2;57;.966;3600000;0
2923;4450;5;52;22;3;19;.864;3586000;0
2923;10274;23;0;0;0;0;.00nan;0;0
2923;19823;5;0;0;0;0;.00nan;0;0
1312;780;52;0;0;0;0;.00nan;0;0
1312;23255;52;100;26;0;26;1.000;3600000;0
1312;28772;53;0;0;0;0;.00nan;0;0
1312;31156;53;78;46;4;42;.913;3600000;0
1313;1486;43;74;44;4;40;.909;3533000;0
1313;2900;36;0;0;0;0;.00nan;0;0
1313;3625;43;0;0;0;0;.00nan;0;0
1313;14874;36;58;25;3;22;.880;3600000;0
1314;6081;56;89;42;3;39;.929;3235000;0
1314;23493;51;67;27;2;25;.926;3600000;0
1314;26824;56;53;3;0;3;1.000;311000;0
1314;31822;51;0;0;0;0;.00nan;0;0
1315;37;46;0;0;0;0;.00nan;0;0
1315;2553;46;75;33;2;31;.939;3600000;0
1315;34788;42;73;35;3;32;.914;3598000;0
1315;37416;42;0;0;0;0;.00nan;0;0
1316;1051;44;0;0;0;0;.00nan;0;0
1316;3281;44;59;38;5;33;.868;3600000;0
1316;14351;40;67;22;2;20;.909;3600000;0
1316;26840;40;0;0;0;0;.00nan;0;0
1317;3626;48;0;0;0;0;.00nan;0;0
1317;4716;4619;86;25;1;24;.960;3600000;0
1317;35210;4619;0;0;0;0;.00nan;0;0
1317;38547;48;77;29;2;27;.931;3582000;0
1318;1592;63;86;43;4;39;.907;3820000;0
1318;2296;37;60;29;3;26;.897;3797000;0
1318;5883;37;0;0;0;0;.00nan;0;0
1318;26967;63;0;0;0;0;.00nan;0;0
1319;2796;59;0;0;0;0;.00nan;0;0
1319;8046;57;0;0;0;0;.00nan;0;0
1319;26865;57;54;31;4;27;.871;3589000;0
1319;31858;59;76;24;2;22;.917;3600000;0
1320;4338;65;0;0;0;0;.00nan;0;0
1320;4987;65;66;16;1;15;.938;3600000;0
1320;19640;41;72;39;4;35;.897;3600000;0
1320;23075;41;0;0;0;0;.00nan;0;0
1321;1486;43;0;0;0;0;.00nan;0;0
1321;2900;36;74;27;1;26;.963;3600000;0
1321;3625;43;63;23;2;21;.913;3597000;0
1321;14874;36;0;0;0;0;.00nan;0;0
1322;6081;56;76;33;4;29;.879;3900000;0
1322;23493;51;0;0;0;0;.00nan;0;0
1322;31822;51;47;30;4;26;.867;3900000;0
1322;33640;56;0;0;0;0;.00nan;0;0
1323;37;46;78;33;2;31;.939;3600000;0
1323;2553;46;0;0;0;0;.00nan;0;0
1323;4447;54;69;29;3;26;.897;3564000;0
1323;31643;54;0;0;0;0;.00nan;0;0
1324;780;52;0;0;0;0;.00nan;0;0
1324;3847;38;0;0;0;0;.00nan;0;0
1324;23255;52;85;44;3;41;.932;3900000;0
1324;31021;38;81;37;3;34;.919;3900000;0
1325;5137;58;0;0;0;0;.00nan;0;0
1325;14321;58;50;22;3;19;.864;3600000;0
1325;28772;53;63;46;6;40;.870;3600000;0
1325;31156;53;0;0;0;0;.00nan;0;0
1326;5146;64;46;24;4;20;.833;3580000;0
1326;28845;64;0;0;0;0;.00nan;0;0
1326;34788;42;92;42;3;39;.929;3600000;0
1326;37416;42;0;0;0;0;.00nan;0;0
1327;3;50;70;35;3;32;.914;3600000;0
1327;376;45;0;0;0;0;.00nan;0;0
1327;2198;45;45;25;4;21;.840;3600000;0
1327;5048;50;0;0;0;0;.00nan;0;0
1328;2152;49;0;0;0;0;.00nan;0;0
1328;4435;49;55;24;3;21;.875;3900000;0
1328;6572;62;0;0;0;0;.00nan;0;0
1328;26919;62;81;26;3;23;.885;3900000;0
1329;1051;44;69;33;3;30;.909;3600000;0
1329;3281;44;0;0;0;0;.00nan;0;0
1329;14351;40;0;0;0;0;.00nan;0;0
1329;26840;40;98;31;1;30;.968;3600000;0
1330;2016;61;0;0;0;0;.00nan;0;0
1330;7049;47;0;0;0;0;.00nan;0;0
1330;30971;61;72;22;1;21;.955;3546000;0
1330;33654;47;100;28;0;28;1.000;3600000;0
1331;3847;38;64;26;3;23;.885;3600000;0
1331;28772;53;44;17;3;14;.824;1390000;0
1331;31021;38;0;0;0;0;.00nan;0;0
1331;31156;53;30;31;6;25;.806;2210000;0
1332;4338;65;56;25;3;22;.880;3649000;0
1332;4987;65;0;0;0;0;.00nan;0;0
1332;8046;57;90;42;2;40;.952;3649000;0
1332;26865;57;0;0;0;0;.00nan;0;0
1333;2163;39;92;36;1;35;.972;3600000;0
1333;5298;55;84;40;3;37;.925;3517000;0
1333;9238;39;0;0;0;0;.00nan;0;0
1333;34770;55;0;0;0;0;.00nan;0;0
1334;2796;59;90;27;1;26;.963;3600000;0
1334;19640;41;0;0;0;0;.00nan;0;0
1334;23075;41;75;39;3;36;.923;3577000;0
1334;31858;59;0;0;0;0;.00nan;0;0
1335;780;52;75;22;1;21;.955;3600000;0
1335;5137;58;60;32;3;29;.906;3600000;0
1335;14321;58;0;0;0;0;.00nan;0;0
1335;23255;52;0;0;0;0;.00nan;0;0
1336;1592;63;0;0;0;0;.00nan;0;0
1336;2296;37;0;0;0;0;.00nan;0;0
1336;5883;37;72;29;3;26;.897;3600000;0
1336;26967;63;43;24;4;20;.833;3588000;0
1337;3;50;0;0;0;0;.00nan;0;0
1337;376;45;76;27;2;25;.926;3600000;0
1337;2198;45;0;0;0;0;.00nan;0;0
1337;5048;50;47;26;4;22;.846;3556000;0
1338;7049;47;0;0;0;0;.00nan;0;0
1338;20717;60;66;11;0;11;1.000;635000;0
1338;33654;47;76;29;2;27;.931;3600000;0
1338;35536;60;33;28;6;22;.786;2965000;0
1339;2016;61;34;24;5;19;.792;2388000;0
1339;2152;49;100;25;0;25;1.000;3600000;0
1339;4435;49;0;0;0;0;.00nan;0;0
1339;30971;61;42;16;3;13;.813;1212000;0
1340;3626;48;43;26;4;22;.846;3600000;0
1340;4716;4619;40;31;5;26;.839;3578000;0
1340;35210;4619;0;0;0;0;.00nan;0;0
1340;38547;48;0;0;0;0;.00nan;0;0
1341;2016;61;61;7;0;7;1.000;556000;0
1341;2152;49;78;23;1;22;.957;3600000;0
1341;4435;49;0;0;0;0;.00nan;0;0
1341;30971;61;36;35;6;29;.829;3044000;0
1342;2296;37;0;0;0;0;.00nan;0;0
1342;5883;37;87;19;0;19;1.000;3600000;0
1342;23493;51;0;0;0;0;.00nan;0;0
1342;31822;51;80;38;3;35;.921;3600000;0
1343;4338;65;0;0;0;0;.00nan;0;0
1343;4987;65;83;30;2;28;.933;3600000;0
1343;19640;41;0;0;0;0;.00nan;0;0
1343;23075;41;40;26;4;22;.846;3583000;0
1344;3847;38;0;0;0;0;.00nan;0;0
1344;5298;55;0;0;0;0;.00nan;0;0
1344;31021;38;84;26;2;24;.923;3900000;0
1344;34770;55;97;41;2;39;.951;3900000;0
1345;1486;43;80;30;2;28;.933;3600000;0
1345;3625;43;0;0;0;0;.00nan;0;0
1345;6081;56;52;36;5;31;.861;3600000;0
1345;33640;56;0;0;0;0;.00nan;0;0
1346;2796;59;0;0;0;0;.00nan;0;0
1346;28772;53;46;33;6;27;.818;2620000;0
1346;31156;53;64;10;0;10;1.000;980000;0
1346;31858;59;80;31;2;29;.935;3600000;0
1347;780;52;0;0;0;0;.00nan;0;0
1347;5137;58;0;0;0;0;.00nan;0;0
1347;23255;52;86;32;2;30;.938;3600000;0
1347;26622;58;46;35;5;30;.857;3600000;0
1348;2163;39;0;0;0;0;.00nan;0;0
1348;2900;36;0;0;0;0;.00nan;0;0
1348;9238;39;68;33;3;30;.909;3600000;0
1348;14874;36;100;28;0;28;1.000;3600000;0
1349;37;46;0;0;0;0;.00nan;0;0
1349;2296;37;0;0;0;0;.00nan;0;0
1349;2553;46;93;44;3;41;.932;3558000;0
1349;5883;37;86;37;2;35;.946;3600000;0
1350;4447;54;0;0;0;0;.00nan;0;0
1350;5146;64;0;0;0;0;.00nan;0;0
1350;28845;64;46;29;4;25;.862;3577000;0
1350;31643;54;72;32;3;29;.906;3600000;0
1351;3;50;75;35;4;31;.886;3600000;0
1351;5048;50;0;0;0;0;.00nan;0;0
1351;34788;42;71;32;3;29;.906;3600000;0
1351;37416;42;0;0;0;0;.00nan;0;0
1352;4716;4619;0;0;0;0;.00nan;0;0
1352;20717;60;0;0;0;0;.00nan;0;0
1352;35210;4619;75;30;2;28;.933;3900000;0
1352;35536;60;95;42;2;40;.952;3900000;0
1353;2152;49;26;21;5;16;.762;3600000;0
1353;4435;49;0;0;0;0;.00nan;0;0
1353;7049;47;49;43;6;37;.860;3600000;0
1353;33654;47;0;0;0;0;.00nan;0;0
1354;6572;62;94;44;3;41;.932;3600000;0
1354;14351;40;0;0;0;0;.00nan;0;0
1354;26840;40;51;25;4;21;.840;3577000;0
1354;26919;62;0;0;0;0;.00nan;0;0
1355;2016;61;0;0;0;0;.00nan;0;0
1355;3626;48;0;0;0;0;.00nan;0;0
1355;30971;61;82;40;3;37;.925;3600000;0
1355;38547;48;50;28;4;24;.857;3550000;0
1356;1592;63;59;12;1;11;.917;1061000;0
1356;2163;39;82;31;2;29;.935;3600000;0
1356;9238;39;0;0;0;0;.00nan;0;0
1356;26967;63;43;35;6;29;.829;2539000;0
1357;4338;65;100;25;0;25;1.000;3600000;0
1357;4987;65;0;0;0;0;.00nan;0;0
1357;19640;41;50;27;4;23;.852;3600000;0
1357;23075;41;0;0;0;0;.00nan;0;0
1358;780;52;40;18;4;14;.778;1710000;0
1358;5137;58;79;33;1;32;.970;3600000;0
1358;23255;52;10;15;6;9;.600;1890000;0
1358;26622;58;0;0;0;0;.00nan;0;0
1359;2900;36;0;0;0;0;.00nan;0;0
1359;5298;55;32;18;4;14;.778;2353000;0
1359;14874;36;98;33;2;31;.939;3600000;0
1359;34770;55;17;16;5;11;.688;1247000;0
1360;1486;43;0;0;0;0;.00nan;0;0
1360;3625;43;62;26;3;23;.885;3559000;0
1360;6081;56;0;0;0;0;.00nan;0;0
1360;33640;56;91;38;2;36;.947;3600000;0
1361;3;50;0;0;0;0;.00nan;0;0
1361;5048;50;85;29;1;28;.966;3600000;0
1361;34788;42;51;37;6;31;.838;3600000;0
1361;37416;42;0;0;0;0;.00nan;0;0
1362;3847;38;58;22;2;20;.909;3600000;0
1362;23493;51;32;9;3;6;.667;306000;0
1362;31021;38;0;0;0;0;.00nan;0;0
1362;31822;51;69;35;3;32;.914;3294000;0
1363;8046;57;100;31;0;31;1.000;3600000;0
1363;26865;57;0;0;0;0;.00nan;0;0
1363;28772;53;0;0;0;0;.00nan;0;0
1363;31156;53;88;39;2;37;.949;3559000;0
1364;4447;54;76;19;1;18;.947;3600000;0
1364;5146;64;88;36;2;34;.944;3548000;0
1364;28845;64;0;0;0;0;.00nan;0;0
1364;31643;54;0;0;0;0;.00nan;0;0
1365;2152;49;0;0;0;0;.00nan;0;0
1365;4435;49;79;14;0;14;1.000;3600000;0
1365;6572;62;0;0;0;0;.00nan;0;0
1365;26919;62;35;36;7;29;.806;3600000;0
1366;4716;4619;56;27;3;24;.889;3547000;0
1366;20717;60;81;28;1;27;.964;3600000;0
1366;35210;4619;0;0;0;0;.00nan;0;0
1366;35536;60;0;0;0;0;.00nan;0;0
1367;7049;47;0;0;0;0;.00nan;0;0
1367;14351;40;92;34;2;32;.941;3600000;0
1367;26840;40;0;0;0;0;.00nan;0;0
1367;33654;47;86;29;1;28;.966;3600000;0
1368;376;45;0;0;0;0;.00nan;0;0
1368;1051;44;59;27;3;24;.889;3600000;0
1368;2198;45;52;39;6;33;.846;3600000;0
1368;3281;44;0;0;0;0;.00nan;0;0
1369;780;52;0;0;0;0;.00nan;0;0
1369;23255;52;56;34;4;30;.882;3696000;0
1369;23493;51;65;27;3;24;.889;3721000;0
1369;31822;51;0;0;0;0;.00nan;0;0
1370;37;46;0;0;0;0;.00nan;0;0
1370;2296;37;90;29;2;27;.931;3900000;0
1370;2553;46;73;18;2;16;.889;3900000;0
1370;5883;37;0;0;0;0;.00nan;0;0
1371;3847;38;0;0;0;0;.00nan;0;0
1371;5137;58;0;0;0;0;.00nan;0;0
1371;26622;58;57;29;4;25;.862;3868000;0
1371;31021;38;49;23;3;20;.870;3899000;0
1372;2796;59;0;0;0;0;.00nan;0;0
1372;8046;57;33;32;6;26;.813;2961000;0
1372;26865;57;45;9;2;7;.778;639000;0
1372;31858;59;50;17;2;15;.882;3600000;0
1373;1486;43;29;17;4;13;.765;3575000;0
1373;1592;63;81;39;3;36;.923;3600000;0
1373;3625;43;0;0;0;0;.00nan;0;0
1373;26967;63;0;0;0;0;.00nan;0;0
1374;376;45;86;26;1;25;.962;3600000;0
1374;1051;44;44;9;2;7;.778;1247000;0
1374;2198;45;0;0;0;0;.00nan;0;0
1374;3281;44;63;36;4;32;.889;2353000;0
1375;2016;61;0;0;0;0;.00nan;0;0
1375;3626;48;0;0;0;0;.00nan;0;0
1375;30971;61;96;24;0;24;1.000;3600000;0
1375;38547;48;67;41;4;37;.902;3600000;0
1376;2900;36;0;0;0;0;.00nan;0;0
1376;4338;65;60;22;2;20;.909;3600000;0
1376;4987;65;0;0;0;0;.00nan;0;0
1376;14874;36;64;31;4;27;.871;3586000;0
1377;2163;39;58;24;3;21;.875;3600000;0
1377;6081;56;89;32;2;30;.938;3600000;0
1377;9238;39;0;0;0;0;.00nan;0;0
1377;33640;56;0;0;0;0;.00nan;0;0
1378;37;46;0;0;0;0;.00nan;0;0
1378;2553;46;58;37;4;33;.892;3600000;0
1378;5146;64;48;19;3;16;.842;3600000;0
1378;28845;64;0;0;0;0;.00nan;0;0
1379;2796;59;0;0;0;0;.00nan;0;0
1379;8046;57;0;0;0;0;.00nan;0;0
1379;26865;57;84;27;2;25;.926;3600000;0
1379;31858;59;76;37;4;33;.892;3532000;0
1380;1592;63;89;39;2;37;.949;3600000;0
1380;23493;51;0;0;0;0;.00nan;0;0
1380;26967;63;0;0;0;0;.00nan;0;0
1380;31822;51;57;29;4;25;.862;3521000;0
1381;4716;4619;0;0;0;0;.00nan;0;0
1381;7049;47;0;0;0;0;.00nan;0;0
1381;33654;47;34;28;5;23;.821;3600000;0
1381;35210;4619;99;35;1;34;.971;3600000;0
1382;376;45;0;0;0;0;.00nan;0;0
1382;2198;45;74;29;2;27;.931;3600000;0
1382;34788;42;66;28;3;25;.893;3545000;0
1382;37416;42;0;0;0;0;.00nan;0;0
1383;3626;48;55;28;3;25;.893;3600000;0
1383;7049;47;65;32;4;28;.875;3544000;0
1383;33654;47;0;0;0;0;.00nan;0;0
1383;38547;48;0;0;0;0;.00nan;0;0
1384;2796;59;0;0;0;0;.00nan;0;0
1384;28772;53;99;47;1;46;.979;3600000;0
1384;31156;53;0;0;0;0;.00nan;0;0
1384;31858;59;78;30;2;28;.933;3600000;0
1385;1486;43;65;35;4;31;.886;3519000;0
1385;2900;36;0;0;0;0;.00nan;0;0
1385;3625;43;0;0;0;0;.00nan;0;0
1385;14874;36;59;20;2;18;.900;3600000;0
1386;3533;57;0;0;0;0;.00nan;0;0
1386;5298;55;0;0;0;0;.00nan;0;0
1386;26865;57;66;30;3;27;.900;3600000;0
1386;34770;55;84;33;2;31;.939;3600000;0
1387;1592;63;87;25;1;24;.960;3563000;0
1387;6081;56;94;16;0;16;1.000;3600000;0
1387;26824;56;0;0;0;0;.00nan;0;0
1387;26967;63;0;0;0;0;.00nan;0;0
1388;2163;39;84;33;2;31;.939;3600000;0
1388;9238;39;0;0;0;0;.00nan;0;0
1388;23493;51;39;1;1;0;.000;380000;0
1388;31822;51;32;27;6;21;.778;3220000;0
1389;3847;38;0;0;0;0;.00nan;0;0
1389;19640;41;0;0;0;0;.00nan;0;0
1389;23075;41;61;33;4;29;.879;3573000;0
1389;31021;38;72;33;2;31;.939;3600000;0
1390;4447;54;56;37;4;33;.892;3900000;0
1390;5146;64;72;42;4;38;.905;3900000;0
1390;28845;64;0;0;0;0;.00nan;0;0
1390;31643;54;0;0;0;0;.00nan;0;0
1391;4716;4619;45;16;3;13;.813;3600000;0
1391;20717;60;48;39;5;34;.872;3587000;0
1391;35210;4619;0;0;0;0;.00nan;0;0
1391;35536;60;0;0;0;0;.00nan;0;0
1392;1051;44;59;32;3;29;.906;3592000;0
1392;3281;44;0;0;0;0;.00nan;0;0
1392;6572;62;0;0;0;0;.00nan;0;0
1392;26919;62;72;30;2;28;.933;3600000;0
1393;2016;61;0;0;0;0;.00nan;0;0
1393;2152;49;0;0;0;0;.00nan;0;0
1393;4435;49;63;27;3;24;.889;3600000;0
1393;30971;61;33;33;6;27;.818;3600000;0
1394;2163;39;0;0;0;0;.00nan;0;0
1394;9238;39;49;23;3;20;.870;3600000;0
1394;23493;51;75;35;2;33;.943;3600000;0
1394;31822;51;0;0;0;0;.00nan;0;0
1395;3;50;62;20;2;18;.900;3600000;0
1395;2296;37;54;4;0;4;1.000;1498000;0
1395;5048;50;0;0;0;0;.00nan;0;0
1395;5883;37;36;22;5;17;.773;2102000;0
1396;1592;63;0;0;0;0;.00nan;0;0
1396;6081;56;52;24;3;21;.875;3574000;0
1396;26824;56;0;0;0;0;.00nan;0;0
1396;26967;63;76;23;1;22;.957;3600000;0
1397;19640;41;39;45;7;38;.844;3600000;0
1397;23075;41;0;0;0;0;.00nan;0;0
1397;28772;53;38;11;3;8;.727;625000;0
1397;31156;53;48;41;6;35;.854;2945000;0
1398;780;52;0;0;0;0;.00nan;0;0
1398;3847;38;51;29;4;25;.862;3600000;0
1398;23255;52;90;30;1;29;.967;3600000;0
1398;31021;38;0;0;0;0;.00nan;0;0
1399;1486;43;0;0;0;0;.00nan;0;0
1399;3625;43;58;33;4;29;.879;3553000;0
1399;4338;65;76;35;3;32;.914;3600000;0
1399;4987;65;0;0;0;0;.00nan;0;0
1400;37;46;0;0;0;0;.00nan;0;0
1400;2553;46;78;25;2;23;.920;3671000;0
1400;4447;54;0;0;0;0;.00nan;0;0
1400;31643;54;86;28;1;27;.964;3671000;0
1401;2900;36;34;34;6;28;.824;3900000;0
1401;3533;57;53;44;6;38;.864;3900000;0
1401;14874;36;0;0;0;0;.00nan;0;0
1401;26865;57;0;0;0;0;.00nan;0;0
1402;2796;59;89;19;0;19;1.000;3600000;0
1402;5137;58;0;0;0;0;.00nan;0;0
1402;26622;58;57;35;5;30;.857;3600000;0
1402;31858;59;0;0;0;0;.00nan;0;0
1403;376;45;0;0;0;0;.00nan;0;0
1403;2198;45;73;23;1;22;.957;3600000;0
1403;34788;42;72;36;4;32;.889;3600000;0
1403;37416;42;0;0;0;0;.00nan;0;0
1404;351;4619;0;0;0;0;.00nan;0;0
1404;14351;40;0;0;0;0;.00nan;0;0
1404;26840;40;79;40;3;37;.925;3600000;0
1404;35210;4619;96;32;1;31;.969;3600000;0
1405;1051;44;0;0;0;0;.00nan;0;0
1405;3281;44;94;44;3;41;.932;3559000;0
1405;6572;62;74;24;2;22;.917;3600000;0
1405;26919;62;0;0;0;0;.00nan;0;0
1406;3626;48;0;0;0;0;.00nan;0;0
1406;7049;47;0;0;0;0;.00nan;0;0
1406;33654;47;65;22;2;20;.909;3600000;0
1406;38547;48;46;32;5;27;.844;3600000;0
1407;2016;61;19;24;6;18;.750;2066000;0
1407;2152;49;97;27;0;27;1.000;3600000;0
1407;4435;49;0;0;0;0;.00nan;0;0
1407;30971;61;63;14;1;13;.929;1534000;0
1408;5137;58;70;21;1;20;.952;3600000;0
1408;19640;41;0;0;0;0;.00nan;0;0
1408;23075;41;36;26;5;21;.808;3600000;0
1408;26622;58;0;0;0;0;.00nan;0;0
1409;780;52;0;0;0;0;.00nan;0;0
1409;23255;52;40;25;4;21;.840;3600000;0
1409;28772;53;28;9;3;6;.667;524000;0
1409;31156;53;98;45;3;42;.933;3076000;0
1410;3;50;0;0;0;0;.00nan;0;0
1410;2296;37;0;0;0;0;.00nan;0;0
1410;5048;50;89;45;3;42;.933;3577000;0
1410;5883;37;64;24;2;22;.917;3600000;0
1411;37;46;41;14;4;10;.714;771000;0
1411;2553;46;77;16;0;16;1.000;2829000;0
1411;5146;64;32;18;4;14;.778;1179000;0
1411;28845;64;46;12;2;10;.833;2370000;0
1412;1486;43;80;25;1;24;.960;3900000;0
1412;3625;43;0;0;0;0;.00nan;0;0
1412;4338;65;0;0;0;0;.00nan;0;0
1412;4987;65;74;22;1;21;.955;3900000;0
1413;14351;40;78;19;1;18;.947;3900000;0
1413;21324;60;0;0;0;0;.00nan;0;0
1413;26840;40;0;0;0;0;.00nan;0;0
1413;35536;60;71;20;1;19;.950;3900000;0
1414;351;4619;51;30;4;26;.867;3900000;0
1414;376;45;0;0;0;0;.00nan;0;0
1414;2198;45;52;31;4;27;.871;3900000;0
1414;35210;4619;0;0;0;0;.00nan;0;0
1415;2796;59;100;35;1;34;.971;3600000;0
1415;3533;57;0;0;0;0;.00nan;0;0
1415;26865;57;74;30;2;28;.933;3600000;0
1415;31858;59;0;0;0;0;.00nan;0;0
1416;2163;39;0;0;0;0;.00nan;0;0
1416;6081;56;82;38;4;34;.895;3564000;0
1416;9238;39;71;29;2;27;.931;3600000;0
1416;26824;56;0;0;0;0;.00nan;0;0
1417;351;4619;0;0;0;0;.00nan;0;0
1417;376;45;86;26;1;25;.962;3900000;0
1417;2198;45;0;0;0;0;.00nan;0;0
1417;35210;4619;75;29;1;28;.966;3900000;0
1418;14351;40;0;0;0;0;.00nan;0;0
1418;21324;60;0;0;0;0;.00nan;0;0
1418;26840;40;57;28;3;25;.893;3600000;0
1418;35536;60;43;27;5;22;.815;3561000;0
1419;2152;49;61;27;3;24;.889;3600000;0
1419;3626;48;0;0;0;0;.00nan;0;0
1419;4435;49;0;0;0;0;.00nan;0;0
1419;38547;48;63;37;5;32;.865;3559000;0
1420;780;52;55;12;1;11;.917;1358000;0
1420;28772;53;81;41;4;37;.902;3600000;0
1420;31156;53;0;0;0;0;.00nan;0;0
1420;32146;52;35;21;5;16;.762;2156000;0
1421;2900;36;0;0;0;0;.00nan;0;0
1421;5298;55;84;12;0;12;1.000;3600000;0
1421;14874;36;61;32;3;29;.906;3600000;0
1421;34770;55;0;0;0;0;.00nan;0;0
1422;1486;43;66;16;1;15;.938;2571000;0
1422;3625;43;37;18;4;14;.778;1029000;0
1422;6081;56;60;44;6;38;.864;3570000;0
1422;26824;56;0;0;0;0;.00nan;0;0
1423;3;50;55;28;4;24;.857;3600000;0
1423;37;46;100;27;0;27;1.000;3600000;0
1423;2553;46;0;0;0;0;.00nan;0;0
1423;5048;50;0;0;0;0;.00nan;0;0
1424;2796;59;0;0;0;0;.00nan;0;0
1424;3847;38;0;0;0;0;.00nan;0;0
1424;31021;38;52;34;5;29;.853;3550000;0
1424;31858;59;61;27;3;24;.889;3600000;0
1425;4338;65;82;26;1;25;.962;3600000;0
1425;4987;65;0;0;0;0;.00nan;0;0
1425;5137;58;0;0;0;0;.00nan;0;0
1425;26622;58;60;32;4;28;.875;3600000;0
1426;1592;63;87;40;2;38;.950;3600000;0
1426;2163;39;34;27;6;21;.778;2776000;0
1426;9238;39;57;5;0;5;1.000;824000;0
1426;26967;63;0;0;0;0;.00nan;0;0
1427;2296;37;0;0;0;0;.00nan;0;0
1427;4447;54;0;0;0;0;.00nan;0;0
1427;5883;37;76;24;1;23;.958;3600000;0
1427;31643;54;72;35;4;31;.886;3600000;0
1428;6572;62;0;0;0;0;.00nan;0;0
1428;7049;47;0;0;0;0;.00nan;0;0
1428;26919;62;78;28;2;26;.929;3600000;0
1428;33654;47;69;32;3;29;.906;3577000;0
1429;2016;61;0;0;0;0;.00nan;0;0
1429;14351;40;71;32;3;29;.906;3600000;0
1429;26840;40;0;0;0;0;.00nan;0;0
1429;30971;61;54;32;4;28;.875;3560000;0
1430;1051;44;0;0;0;0;.00nan;0;0
1430;3281;44;69;24;2;22;.917;3600000;0
1430;3626;48;33;27;6;21;.778;3263000;0
1430;38547;48;48;0;0;0;.00nan;337000;0
1431;376;45;0;0;0;0;.00nan;0;0
1431;2198;45;62;22;2;20;.909;3600000;0
1431;20717;60;0;0;0;0;.00nan;0;0
1431;35536;60;72;34;3;31;.912;3562000;0
1432;3533;57;0;0;0;0;.00nan;0;0
1432;19640;41;93;37;1;36;.973;3600000;0
1432;23075;41;0;0;0;0;.00nan;0;0
1432;26865;57;70;30;2;28;.933;3552000;0
1433;2796;59;68;25;2;23;.920;3600000;0
1433;28772;53;0;0;0;0;.00nan;0;0
1433;31156;53;16;37;8;29;.784;3600000;0
1433;31858;59;0;0;0;0;.00nan;0;0
1434;780;52;0;0;0;0;.00nan;0;0
1434;5137;58;68;27;2;25;.926;3600000;0
1434;26622;58;0;0;0;0;.00nan;0;0
1434;32146;52;52;29;4;25;.862;3548000;0
1435;3847;38;84;30;1;29;.967;3900000;0
1435;4338;65;0;0;0;0;.00nan;0;0
1435;4987;65;100;34;1;33;.971;3900000;0
1435;31021;38;0;0;0;0;.00nan;0;0
1436;2900;36;79;22;1;21;.955;3900000;0
1436;14874;36;0;0;0;0;.00nan;0;0
1436;23493;51;97;32;1;31;.969;3900000;0
1436;31822;51;0;0;0;0;.00nan;0;0
1437;1486;43;0;0;0;0;.00nan;0;0
1437;3625;43;54;20;3;17;.850;3600000;0
1437;6081;56;0;0;0;0;.00nan;0;0
1437;26824;56;64;42;5;37;.881;3529000;0
1438;1592;63;0;0;0;0;.00nan;0;0
1438;5298;55;68;28;3;25;.893;3600000;0
1438;26967;63;70;40;4;36;.900;3551000;0
1438;34770;55;0;0;0;0;.00nan;0;0
1439;3;50;0;0;0;0;.00nan;0;0
1439;4447;54;74;37;3;34;.919;3900000;0
1439;5048;50;70;30;3;27;.900;3900000;0
1439;31643;54;0;0;0;0;.00nan;0;0
1440;37;46;62;24;2;22;.917;3600000;0
1440;2553;46;0;0;0;0;.00nan;0;0
1440;34788;42;0;0;0;0;.00nan;0;0
1440;37416;42;65;30;3;27;.900;3568000;0
1441;751;64;0;0;0;0;.00nan;0;0
1441;2296;37;0;0;0;0;.00nan;0;0
1441;5146;64;88;22;1;21;.955;3600000;0
1441;5883;37;77;40;3;37;.925;3600000;0
1442;2016;61;34;19;4;15;.789;3563000;0
1442;14351;40;0;0;0;0;.00nan;0;0
1442;26840;40;95;47;2;45;.957;3600000;0
1442;30971;61;0;0;0;0;.00nan;0;0
1443;2152;49;0;0;0;0;.00nan;0;0
1443;4435;49;59;33;4;29;.879;3600000;0
1443;7049;47;56;35;5;30;.857;3586000;0
1443;33654;47;0;0;0;0;.00nan;0;0
1444;351;4619;0;0;0;0;.00nan;0;0
1444;6572;62;84;27;1;26;.963;3600000;0
1444;26919;62;0;0;0;0;.00nan;0;0
1444;35210;4619;78;29;2;27;.931;3554000;0
1445;1051;44;53;29;4;25;.862;3900000;0
1445;3281;44;0;0;0;0;.00nan;0;0
1445;3626;48;0;0;0;0;.00nan;0;0
1445;38547;48;47;25;4;21;.840;3854000;0
1446;3533;57;51;27;4;23;.852;3585000;0
1446;19640;41;0;0;0;0;.00nan;0;0
1446;23075;41;77;25;2;23;.920;3600000;0
1446;26865;57;0;0;0;0;.00nan;0;0
1447;780;52;67;32;3;29;.906;3900000;0
1447;28772;53;88;38;3;35;.921;3900000;0
1447;31156;53;0;0;0;0;.00nan;0;0
1447;32146;52;0;0;0;0;.00nan;0;0
1448;4338;65;34;31;6;25;.806;2253000;0
1448;4987;65;74;13;0;13;1.000;1347000;0
1448;5137;58;0;0;0;0;.00nan;0;0
1448;26622;58;56;28;3;25;.893;3600000;0
1449;751;64;63;20;2;18;.900;3516000;0
1449;4447;54;0;0;0;0;.00nan;0;0
1449;5146;64;0;0;0;0;.00nan;0;0
1449;31643;54;100;41;0;41;1.000;3600000;0
1450;5298;55;0;0;0;0;.00nan;0;0
1450;23493;51;0;0;0;0;.00nan;0;0
1450;31822;51;49;38;6;32;.842;3600000;0
1450;34770;55;81;26;1;25;.962;3600000;0
1451;2296;37;0;0;0;0;.00nan;0;0
1451;5883;37;82;25;1;24;.960;3600000;0
1451;34788;42;74;32;3;29;.906;3548000;0
1451;37416;42;0;0;0;0;.00nan;0;0
1452;351;4619;83;33;2;31;.939;3600000;0
1452;2152;49;49;22;3;19;.864;3574000;0
1452;4435;49;0;0;0;0;.00nan;0;0
1452;35210;4619;0;0;0;0;.00nan;0;0
1453;376;45;76;30;2;28;.933;3600000;0
1453;2198;45;0;0;0;0;.00nan;0;0
1453;20717;60;67;32;3;29;.906;3600000;0
1453;35536;60;0;0;0;0;.00nan;0;0
1454;3533;57;0;0;0;0;.00nan;0;0
1454;4338;65;68;29;3;26;.897;3600000;0
1454;4987;65;0;0;0;0;.00nan;0;0
1454;26865;57;79;43;4;39;.907;3544000;0
1455;780;52;0;0;0;0;.00nan;0;0
1455;2900;36;51;25;4;21;.840;3600000;0
1455;14874;36;0;0;0;0;.00nan;0;0
1455;32146;52;81;16;0;16;1.000;3600000;0
1456;3847;38;0;0;0;0;.00nan;0;0
1456;5137;58;0;0;0;0;.00nan;0;0
1456;14321;58;69;24;2;22;.917;3600000;0
1456;31021;38;76;40;4;36;.900;3574000;0
1457;2163;39;78;31;2;29;.935;3600000;0
1457;2796;59;0;0;0;0;.00nan;0;0
1457;9238;39;0;0;0;0;.00nan;0;0
1457;31858;59;65;34;4;30;.882;3551000;0
1458;6081;56;73;25;2;23;.920;3600000;0
1458;23493;51;37;24;5;19;.792;3600000;0
1458;26824;56;0;0;0;0;.00nan;0;0
1458;31822;51;0;0;0;0;.00nan;0;0
1459;2296;37;59;7;0;7;1.000;810000;0
1459;4447;54;0;0;0;0;.00nan;0;0
1459;5883;37;35;31;6;25;.806;2790000;0
1459;31643;54;100;35;0;35;1.000;3600000;0
1460;3;50;0;0;0;0;.00nan;0;0
1460;5048;50;41;24;4;20;.833;3847000;0
1460;34788;42;59;36;5;31;.861;3847000;0
1460;37416;42;0;0;0;0;.00nan;0;0
1461;7049;47;0;0;0;0;.00nan;0;0
1461;14351;40;0;0;0;0;.00nan;0;0
1461;26840;40;47;20;3;17;.850;3600000;0
1461;33654;47;100;34;0;34;1.000;3600000;0
1462;3626;48;72;32;2;30;.938;3600000;0
1462;6572;62;0;0;0;0;.00nan;0;0
1462;26919;62;73;36;3;33;.917;3600000;0
1462;38547;48;0;0;0;0;.00nan;0;0
1463;2900;36;0;0;0;0;.00nan;0;0
1463;5298;55;0;0;0;0;.00nan;0;0
1463;14874;36;59;23;3;20;.870;3600000;0
1463;34770;55;100;48;2;46;.958;3600000;0
1464;780;52;0;0;0;0;.00nan;0;0
1464;23493;51;0;0;0;0;.00nan;0;0
1464;31822;51;49;28;4;24;.857;3600000;0
1464;32146;52;71;21;1;20;.952;3600000;0
1465;37;46;70;28;2;26;.929;3600000;0
1465;2296;37;0;0;0;0;.00nan;0;0
1465;2553;46;0;0;0;0;.00nan;0;0
1465;5883;37;69;33;3;30;.909;3600000;0
1466;3533;57;0;0;0;0;.00nan;0;0
1466;3847;38;0;0;0;0;.00nan;0;0
1466;26865;57;53;42;6;36;.857;3600000;0
1466;31021;38;72;28;2;26;.929;3600000;0
1467;2796;59;0;0;0;0;.00nan;0;0
1467;19640;41;0;0;0;0;.00nan;0;0
1467;23075;41;90;29;1;28;.966;3600000;0
1467;31858;59;57;27;3;24;.889;3563000;0
1468;5137;58;0;0;0;0;.00nan;0;0
1468;14321;58;49;31;5;26;.839;3556000;0
1468;28772;53;63;34;4;30;.882;3600000;0
1468;31156;53;0;0;0;0;.00nan;0;0
1469;1486;43;83;31;2;29;.935;3600000;0
1469;2163;39;0;0;0;0;.00nan;0;0
1469;3625;43;0;0;0;0;.00nan;0;0
1469;9238;39;63;34;3;31;.912;3584000;0
1470;751;64;0;0;0;0;.00nan;0;0
1470;5146;64;68;28;3;25;.893;3600000;0
1470;34788;42;52;35;4;31;.886;3550000;0
1470;37416;42;0;0;0;0;.00nan;0;0
1471;376;45;0;0;0;0;.00nan;0;0
1471;2198;45;100;26;0;26;1.000;3600000;0
1471;4716;4619;61;26;3;23;.885;3600000;0
1471;10698;4619;0;0;0;0;.00nan;0;0
1472;1051;44;39;38;7;31;.816;3600000;0
1472;2152;49;0;0;0;0;.00nan;0;0
1472;3281;44;0;0;0;0;.00nan;0;0
1472;4435;49;68;25;2;23;.920;3600000;0
1473;6572;62;76;28;3;25;.893;3900000;0
1473;7049;47;0;0;0;0;.00nan;0;0
1473;26919;62;0;0;0;0;.00nan;0;0
1473;33654;47;74;35;3;32;.914;3900000;0
1474;3626;48;0;0;0;0;.00nan;0;0
1474;14351;40;88;31;1;30;.968;3568000;0
1474;26840;40;0;0;0;0;.00nan;0;0
1474;38547;48;100;29;0;29;1.000;3600000;0
1475;2016;61;0;0;0;0;.00nan;0;0
1475;20717;60;43;28;4;24;.857;3600000;0
1475;30971;61;100;28;0;28;1.000;3600000;0
1475;35536;60;0;0;0;0;.00nan;0;0
1476;5298;55;0;0;0;0;.00nan;0;0
1476;23493;51;30;27;6;21;.778;2908000;0
1476;31822;51;48;8;1;7;.875;692000;0
1476;34770;55;59;33;4;29;.879;3600000;0
1477;2796;59;30;18;4;14;.778;3559000;0
1477;19640;41;75;27;2;25;.926;3600000;0
1477;23075;41;0;0;0;0;.00nan;0;0
1477;31858;59;0;0;0;0;.00nan;0;0
1478;1486;43;0;0;0;0;.00nan;0;0
1478;2163;39;98;40;2;38;.950;3867000;0
1478;3625;43;53;22;3;19;.864;3867000;0
1478;9238;39;0;0;0;0;.00nan;0;0
1479;2900;36;54;29;4;25;.862;3884000;0
1479;4338;65;54;22;3;19;.864;3884000;0
1479;4987;65;0;0;0;0;.00nan;0;0
1479;14874;36;0;0;0;0;.00nan;0;0
1480;780;52;100;32;0;32;1.000;3600000;0
1480;6081;56;38;30;5;25;.833;3600000;0
1480;26824;56;0;0;0;0;.00nan;0;0
1480;32146;52;0;0;0;0;.00nan;0;0
1481;37;46;0;0;0;0;.00nan;0;0
1481;2296;37;0;0;0;0;.00nan;0;0
1481;2553;46;58;32;4;28;.875;3600000;0
1481;5883;37;99;23;0;23;1.000;3600000;0
1482;3;50;80;27;2;25;.926;3600000;0
1482;4447;54;0;0;0;0;.00nan;0;0
1482;5048;50;0;0;0;0;.00nan;0;0
1482;31643;54;29;32;6;26;.813;3600000;0
1483;3847;38;73;23;2;21;.913;3600000;0
1483;28772;53;0;0;0;0;.00nan;0;0
1483;31021;38;0;0;0;0;.00nan;0;0
1483;31156;53;48;18;3;15;.833;3570000;0
1484;3533;57;82;40;2;38;.950;3600000;0
1484;5137;58;100;38;1;37;.974;3600000;0
1484;14321;58;0;0;0;0;.00nan;0;0
1484;26865;57;0;0;0;0;.00nan;0;0
1485;751;64;17;24;6;18;.750;2236000;0
1485;1592;63;100;35;1;34;.971;3600000;0
1485;5146;64;67;11;0;11;1.000;1364000;0
1485;34814;63;0;0;0;0;.00nan;0;0
1486;376;45;0;0;0;0;.00nan;0;0
1486;2198;45;68;38;4;34;.895;3600000;0
1486;4716;4619;0;0;0;0;.00nan;0;0
1486;10698;4619;100;22;0;22;1.000;3600000;0
1487;3626;48;61;18;2;16;.889;3600000;0
1487;14351;40;0;0;0;0;.00nan;0;0
1487;26840;40;65;47;5;42;.894;3600000;0
1487;38547;48;0;0;0;0;.00nan;0;0
1488;1051;44;0;0;0;0;.00nan;0;0
1488;2152;49;52;29;4;25;.862;3550000;0
1488;3281;44;88;32;2;30;.938;3600000;0
1488;4435;49;0;0;0;0;.00nan;0;0
1489;6572;62;0;0;0;0;.00nan;0;0
1489;7049;47;59;32;3;29;.906;3600000;0
1489;26919;62;77;26;2;24;.923;3600000;0
1489;33654;47;0;0;0;0;.00nan;0;0
1490;5298;55;100;15;0;15;1.000;3600000;0
1490;6081;56;0;0;0;0;.00nan;0;0
1490;26824;56;66;34;3;31;.912;3600000;0
1490;34770;55;0;0;0;0;.00nan;0;0
1491;751;64;82;35;2;33;.943;3680000;0
1491;1592;63;0;0;0;0;.00nan;0;0
1491;5146;64;0;0;0;0;.00nan;0;0
1491;34814;63;63;30;3;27;.900;3680000;0
1492;3;50;0;0;0;0;.00nan;0;0
1492;4447;54;14;21;6;15;.714;2574000;0
1492;5048;50;100;30;0;30;1.000;3600000;0
1492;31643;54;59;7;0;7;1.000;1026000;0
1493;4338;65;0;0;0;0;.00nan;0;0
1493;4987;65;83;29;1;28;.966;3600000;0
1493;19640;41;0;0;0;0;.00nan;0;0
1493;23075;41;52;33;4;29;.879;3600000;0
1494;2016;61;0;0;0;0;.00nan;0;0
1494;20717;60;60;28;4;24;.857;3900000;0
1494;30971;61;70;37;4;33;.892;3900000;0
1494;35536;60;0;0;0;0;.00nan;0;0
1495;37;46;80;38;2;36;.947;3900000;0
1495;751;64;71;20;2;18;.900;3900000;0
1495;2553;46;0;0;0;0;.00nan;0;0
1495;5146;64;0;0;0;0;.00nan;0;0
1496;780;52;50;15;2;13;.867;3600000;0
1496;28772;53;63;33;3;30;.909;3600000;0
1496;31156;53;0;0;0;0;.00nan;0;0
1496;32146;52;0;0;0;0;.00nan;0;0
1497;1592;63;34;20;4;16;.800;656000;0
1497;23493;51;59;21;2;19;.905;3600000;0
1497;31822;51;0;0;0;0;.00nan;0;0
1497;34814;63;78;23;1;22;.957;2944000;0
1498;1486;43;0;0;0;0;.00nan;0;0
1498;2900;36;0;0;0;0;.00nan;0;0
1498;3625;43;86;28;1;27;.964;3600000;0
1498;14874;36;81;37;2;35;.946;3564000;0
1499;3533;57;0;0;0;0;.00nan;0;0
1499;19640;41;68;32;3;29;.906;3574000;0
1499;23075;41;0;0;0;0;.00nan;0;0
1499;26865;57;84;32;1;31;.969;3600000;0
1500;2163;39;0;0;0;0;.00nan;0;0
1500;5298;55;63;27;3;24;.889;3600000;0
1500;9238;39;31;21;5;16;.762;3573000;0
1500;34770;55;0;0;0;0;.00nan;0;0
1501;7049;47;0;0;0;0;.00nan;0;0
1501;20717;60;0;0;0;0;.00nan;0;0
1501;33654;47;45;32;5;27;.844;3600000;0
1501;35536;60;87;32;2;30;.938;3600000;0
1502;2296;37;0;0;0;0;.00nan;0;0
1502;4447;54;0;0;0;0;.00nan;0;0
1502;5883;37;58;36;4;32;.889;3564000;0
1502;31643;54;69;27;2;25;.926;3600000;0
1503;1486;43;60;24;4;20;.833;3534000;0
1503;2900;36;0;0;0;0;.00nan;0;0
1503;3625;43;0;0;0;0;.00nan;0;0
1503;14874;36;83;35;2;33;.943;3600000;0
1504;5298;55;65;39;4;35;.897;3528000;0
1504;19640;41;0;0;0;0;.00nan;0;0
1504;23075;41;60;23;2;21;.913;3600000;0
1504;34770;55;0;0;0;0;.00nan;0;0
1505;3847;38;0;0;0;0;.00nan;0;0
1505;28772;53;95;48;2;46;.958;3600000;0
1505;31021;38;42;19;3;16;.842;3600000;0
1505;31156;53;0;0;0;0;.00nan;0;0
1506;2796;59;100;30;0;30;1.000;3600000;0
1506;5137;58;60;7;0;7;1.000;887000;0
1506;14321;58;30;27;6;21;.778;2713000;0
1506;31858;59;0;0;0;0;.00nan;0;0
1507;2163;39;0;0;0;0;.00nan;0;0
1507;3533;57;0;0;0;0;.00nan;0;0
1507;9238;39;73;27;2;25;.926;3600000;0
1507;26865;57;59;40;5;35;.875;3600000;0
1508;2296;37;92;35;1;34;.971;3600000;0
1508;4447;54;56;22;2;20;.909;3556000;0
1508;5883;37;0;0;0;0;.00nan;0;0
1508;31643;54;0;0;0;0;.00nan;0;0
1509;751;64;0;0;0;0;.00nan;0;0
1509;5146;64;100;30;0;30;1.000;3600000;0
1509;34788;42;0;0;0;0;.00nan;0;0
1509;37416;42;57;31;4;27;.871;3600000;0
1510;37;46;39;27;5;22;.815;3600000;0
1510;2198;45;75;35;3;32;.914;3600000;0
1510;2553;46;0;0;0;0;.00nan;0;0
1510;34815;45;0;0;0;0;.00nan;0;0
1511;3;50;0;0;0;0;.00nan;0;0
1511;1051;44;57;23;3;20;.870;3612000;0
1511;3281;44;0;0;0;0;.00nan;0;0
1511;5048;50;65;22;2;20;.909;3612000;0
1512;3626;48;87;34;1;33;.971;2856000;0
1512;4716;4619;0;0;0;0;.00nan;0;0
1512;10698;4619;49;29;4;25;.862;3600000;0
1512;38547;48;13;5;4;1;.200;722000;0
1513;6572;62;0;0;0;0;.00nan;0;0
1513;20717;60;81;30;2;28;.933;3857000;0
1513;26919;62;86;33;3;30;.909;3857000;0
1513;35536;60;0;0;0;0;.00nan;0;0
1514;2016;61;0;0;0;0;.00nan;0;0
1514;7049;47;0;0;0;0;.00nan;0;0
1514;30971;61;58;35;5;30;.857;3600000;0
1514;33654;47;88;37;2;35;.946;3600000;0
1515;1592;63;82;30;2;28;.933;3600000;0
1515;3533;57;49;24;4;20;.833;3581000;0
1515;26865;57;0;0;0;0;.00nan;0;0
1515;34814;63;0;0;0;0;.00nan;0;0
1516;6572;62;80;34;2;32;.941;3600000;0
1516;20717;60;35;12;3;9;.750;1568000;0
1516;26919;62;0;0;0;0;.00nan;0;0
1516;35536;60;21;11;4;7;.636;2032000;0
1517;4338;65;90;31;1;30;.968;3600000;0
1517;4987;65;0;0;0;0;.00nan;0;0
1517;28772;53;56;13;2;11;.846;1201000;0
1517;31156;53;45;36;6;30;.833;2399000;0
1518;2163;39;79;29;1;28;.966;3600000;0
1518;5298;55;0;0;0;0;.00nan;0;0
1518;9238;39;0;0;0;0;.00nan;0;0
1518;34770;55;35;29;5;24;.828;3600000;0
1519;6081;56;70;34;4;30;.882;3697000;0
1519;23493;51;61;39;5;34;.872;3697000;0
1519;26824;56;0;0;0;0;.00nan;0;0
1519;31822;51;0;0;0;0;.00nan;0;0
1520;2796;59;54;28;4;24;.857;2836000;0
1520;3847;38;65;29;3;26;.897;3600000;0
1520;31021;38;0;0;0;0;.00nan;0;0
1520;31858;59;34;7;2;5;.714;764000;0
1521;780;52;0;0;0;0;.00nan;0;0
1521;5137;58;77;30;3;27;.900;3815000;0
1521;14321;58;0;0;0;0;.00nan;0;0
1521;32146;52;74;28;2;26;.929;3815000;0
1522;751;64;0;0;0;0;.00nan;0;0
1522;5146;64;82;37;3;34;.919;3600000;0
1522;34788;42;82;33;2;31;.939;3600000;0
1522;37416;42;0;0;0;0;.00nan;0;0
1523;37;46;0;0;0;0;.00nan;0;0
1523;2198;45;0;0;0;0;.00nan;0;0
1523;2553;46;72;31;2;29;.935;3900000;0
1523;34815;45;94;37;2;35;.946;3900000;0
1524;3626;48;54;10;1;9;.900;1816000;0
1524;4716;4619;65;30;3;27;.900;3600000;0
1524;10698;4619;0;0;0;0;.00nan;0;0
1524;38547;48;6;12;6;6;.500;1784000;0
1525;3;50;84;21;1;20;.952;3600000;0
1525;1051;44;78;48;4;44;.917;3600000;0
1525;3281;44;0;0;0;0;.00nan;0;0
1525;5048;50;0;0;0;0;.00nan;0;0
1526;780;52;96;29;1;28;.966;3600000;0
1526;5137;58;0;0;0;0;.00nan;0;0
1526;14321;58;40;27;6;21;.778;3600000;0
1526;32146;52;0;0;0;0;.00nan;0;0
1527;2296;37;48;0;0;0;.00nan;260000;0
1527;4447;54;0;0;0;0;.00nan;0;0
1527;5883;37;25;32;7;25;.781;3340000;0
1527;31643;54;62;23;3;20;.870;3600000;0
1528;1486;43;0;0;0;0;.00nan;0;0
1528;1592;63;0;0;0;0;.00nan;0;0
1528;3625;43;45;27;4;23;.852;3600000;0
1528;26967;63;97;30;1;29;.967;3600000;0
1529;4338;65;0;0;0;0;.00nan;0;0
1529;4987;65;60;30;4;26;.867;3599000;0
1529;19640;41;0;0;0;0;.00nan;0;0
1529;23075;41;89;35;3;32;.914;3600000;0
1530;2152;49;86;25;1;24;.960;3900000;0
1530;4435;49;0;0;0;0;.00nan;0;0
1530;14351;40;96;45;1;44;.978;3900000;0
1530;26840;40;0;0;0;0;.00nan;0;0
1531;2016;61;44;33;5;28;.848;3600000;0
1531;7049;47;0;0;0;0;.00nan;0;0
1531;30971;61;0;0;0;0;.00nan;0;0
1531;33654;47;80;28;2;26;.929;3600000;0
1532;2152;49;0;0;0;0;.00nan;0;0
1532;4435;49;79;29;2;27;.931;3600000;0
1532;14351;40;0;0;0;0;.00nan;0;0
1532;26840;40;38;31;5;26;.839;3600000;0
1533;2796;59;61;17;2;15;.882;3577000;0
1533;19640;41;100;28;0;28;1.000;3600000;0
1533;23075;41;0;0;0;0;.00nan;0;0
1533;31858;59;0;0;0;0;.00nan;0;0
1534;780;52;0;0;0;0;.00nan;0;0
1534;5137;58;0;0;0;0;.00nan;0;0
1534;14321;58;45;28;4;24;.857;3518000;0
1534;32146;52;86;33;2;31;.939;3600000;0
1535;3847;38;0;0;0;0;.00nan;0;0
1535;4338;65;81;30;2;28;.933;3547000;0
1535;4987;65;0;0;0;0;.00nan;0;0
1535;31021;38;97;32;1;31;.969;3600000;0
1536;2796;59;0;0;0;0;.00nan;0;0
1536;19640;41;0;0;0;0;.00nan;0;0
1536;23075;41;55;34;5;29;.853;3600000;0
1536;31858;59;82;27;1;26;.963;3600000;0
1537;2900;36;0;0;0;0;.00nan;0;0
1537;6081;56;0;0;0;0;.00nan;0;0
1537;14874;36;73;27;2;25;.926;3600000;0
1537;26824;56;55;33;5;28;.848;3600000;0
1538;2163;39;0;0;0;0;.00nan;0;0
1538;5298;55;44;23;4;19;.826;3600000;0
1538;9238;39;45;34;5;29;.853;3596000;0
1538;34770;55;0;0;0;0;.00nan;0;0
1539;37;46;68;34;3;31;.912;3550000;0
1539;2553;46;0;0;0;0;.00nan;0;0
1539;4447;54;93;34;2;32;.941;3600000;0
1539;31643;54;0;0;0;0;.00nan;0;0
1540;6572;62;0;0;0;0;.00nan;0;0
1540;20717;60;58;29;4;25;.862;3543000;0
1540;26919;62;72;31;3;28;.903;3600000;0
1540;35536;60;0;0;0;0;.00nan;0;0
1541;5137;58;0;0;0;0;.00nan;0;0
1541;14321;58;70;21;1;20;.952;3600000;0
1541;28772;53;71;28;3;25;.893;3517000;0
1541;31156;53;0;0;0;0;.00nan;0;0
1542;780;52;0;0;0;0;.00nan;0;0
1542;3847;38;0;0;0;0;.00nan;0;0
1542;31021;38;82;44;3;41;.932;3599000;0
1542;32146;52;81;28;2;26;.929;3600000;0
1543;2900;36;0;0;0;0;.00nan;0;0
1543;3533;57;0;0;0;0;.00nan;0;0
1543;14874;36;99;38;1;37;.974;3600000;0
1543;26865;57;46;18;3;15;.833;3522000;0
1544;1486;43;23;4;3;1;.250;138000;0
1544;1592;63;0;0;0;0;.00nan;0;0
1544;3625;43;70;26;2;24;.923;3375000;0
1544;34814;63;87;43;3;40;.930;3600000;0
1545;6081;56;65;21;2;19;.905;3600000;0
1545;23493;51;0;0;0;0;.00nan;0;0
1545;26824;56;0;0;0;0;.00nan;0;0
1545;31822;51;78;39;3;36;.923;3574000;0
1546;37;46;0;0;0;0;.00nan;0;0
1546;751;64;0;0;0;0;.00nan;0;0
1546;2553;46;69;36;4;32;.889;3548000;0
1546;5146;64;66;19;2;17;.895;3600000;0
1547;2163;39;0;0;0;0;.00nan;0;0
1547;4338;65;79;23;1;22;.957;3600000;0
1547;4987;65;0;0;0;0;.00nan;0;0
1547;9238;39;50;32;5;27;.844;3600000;0
1548;4447;54;0;0;0;0;.00nan;0;0
1548;31643;54;81;16;0;16;1.000;3600000;0
1548;34788;42;53;36;5;31;.861;3600000;0
1548;37416;42;0;0;0;0;.00nan;0;0
1549;6572;62;67;35;4;31;.886;3600000;0
1549;20717;60;100;28;0;28;1.000;3600000;0
1549;26919;62;0;0;0;0;.00nan;0;0
1549;35536;60;0;0;0;0;.00nan;0;0
1550;1051;44;76;23;2;21;.913;3600000;0
1550;2016;61;83;35;2;33;.943;3096000;0
1550;3281;44;0;0;0;0;.00nan;0;0
1550;30971;61;37;11;3;8;.727;504000;0
1551;4716;4619;100;29;0;29;1.000;3600000;0
1551;10698;4619;0;0;0;0;.00nan;0;0
1551;14351;40;56;25;3;22;.880;3600000;0
1551;26840;40;0;0;0;0;.00nan;0;0
1552;2152;49;74;23;1;22;.957;3600000;0
1552;4435;49;0;0;0;0;.00nan;0;0
1552;7049;47;0;0;0;0;.00nan;0;0
1552;33654;47;70;40;5;35;.875;3600000;0
1553;5137;58;96;31;1;30;.968;3600000;0
1553;14321;58;0;0;0;0;.00nan;0;0
1553;28772;53;0;0;0;0;.00nan;0;0
1553;31156;53;77;32;2;30;.938;3600000;0
1554;2198;45;92;30;1;29;.967;3900000;0
1554;2296;37;0;0;0;0;.00nan;0;0
1554;5883;37;88;31;1;30;.968;3900000;0
1554;34786;45;0;0;0;0;.00nan;0;0
1555;1486;43;36;32;6;26;.813;3590000;0
1555;1592;63;75;36;4;32;.889;3600000;0
1555;3625;43;0;0;0;0;.00nan;0;0
1555;34814;63;0;0;0;0;.00nan;0;0
1556;3;50;0;0;0;0;.00nan;0;0
1556;3626;48;72;23;1;22;.957;3600000;0
1556;5048;50;67;37;3;34;.919;3522000;0
1556;38547;48;0;0;0;0;.00nan;0;0
1557;4716;4619;72;30;2;28;.933;3553000;0
1557;10698;4619;0;0;0;0;.00nan;0;0
1557;14351;40;0;0;0;0;.00nan;0;0
1557;26840;40;85;26;1;25;.962;3600000;0
1558;5298;55;0;0;0;0;.00nan;0;0
1558;19640;41;75;31;2;29;.935;3600000;0
1558;23075;41;0;0;0;0;.00nan;0;0
1558;34770;55;89;53;4;49;.925;3549000;0
1559;2796;59;0;0;0;0;.00nan;0;0
1559;3847;38;100;47;2;45;.957;3900000;0
1559;31021;38;0;0;0;0;.00nan;0;0
1559;31858;59;68;27;2;25;.926;3900000;0
1560;2163;39;57;23;3;20;.870;3600000;0
1560;2900;36;60;30;4;26;.867;3546000;0
1560;9238;39;0;0;0;0;.00nan;0;0
1560;14874;36;0;0;0;0;.00nan;0;0
1561;6081;56;0;0;0;0;.00nan;0;0
1561;23493;51;52;40;6;34;.850;3051000;0
1561;26824;56;86;36;3;33;.917;3600000;0
1561;31822;51;49;2;0;2;1.000;549000;0
1562;780;52;59;42;5;37;.881;3587000;0
1562;3533;57;40;21;4;17;.810;3600000;0
1562;26865;57;0;0;0;0;.00nan;0;0
1562;32146;52;0;0;0;0;.00nan;0;0
1563;751;64;69;32;3;29;.906;3600000;0
1563;5146;64;0;0;0;0;.00nan;0;0
1563;34788;42;76;40;4;36;.900;2880000;0
1563;37416;42;31;14;4;10;.714;720000;0
1564;2152;49;0;0;0;0;.00nan;0;0
1564;4435;49;63;25;2;23;.920;3884000;0
1564;20717;60;92;46;3;43;.935;3884000;0
1564;35536;60;0;0;0;0;.00nan;0;0
1565;1051;44;0;0;0;0;.00nan;0;0
1565;2016;61;0;0;0;0;.00nan;0;0
1565;3281;44;100;29;0;29;1.000;3600000;0
1565;30971;61;66;33;3;30;.909;3600000;0
1566;6572;62;0;0;0;0;.00nan;0;0
1566;7049;47;69;28;3;25;.893;3597000;0
1566;26919;62;96;38;2;36;.947;3600000;0
1566;33654;47;0;0;0;0;.00nan;0;0
1567;5298;55;79;31;2;29;.935;3558000;0
1567;19640;41;0;0;0;0;.00nan;0;0
1567;23075;41;100;22;0;22;1.000;3600000;0
1567;34770;55;0;0;0;0;.00nan;0;0
1568;2198;45;0;0;0;0;.00nan;0;0
1568;2296;37;72;33;3;30;.909;3600000;0
1568;5883;37;0;0;0;0;.00nan;0;0
1568;34786;45;60;38;5;33;.868;3569000;0
1569;37;46;0;0;0;0;.00nan;0;0
1569;751;64;0;0;0;0;.00nan;0;0
1569;2553;46;59;27;3;24;.889;3568000;0
1569;5146;64;93;30;2;28;.933;3600000;0
1570;3;50;0;0;0;0;.00nan;0;0
1570;3626;48;56;16;2;14;.875;2106000;0
1570;5048;50;31;22;5;17;.773;3600000;0
1570;38547;48;17;28;7;21;.750;1494000;0
1571;3533;57;68;26;3;23;.885;2570000;0
1571;4338;65;88;17;0;17;1.000;3600000;0
1571;4987;65;0;0;0;0;.00nan;0;0
1571;26865;57;25;12;4;8;.667;1030000;0
1572;4447;54;0;0;0;0;.00nan;0;0
1572;31643;54;66;32;3;29;.906;3600000;0
1572;34788;42;0;0;0;0;.00nan;0;0
1572;37416;42;49;36;5;31;.861;3523000;0
1573;2016;61;70;27;2;25;.926;3600000;0
1573;2152;49;0;0;0;0;.00nan;0;0
1573;4435;49;53;26;4;22;.846;3562000;0
1573;30971;61;0;0;0;0;.00nan;0;0
1574;5137;58;0;0;0;0;.00nan;0;0
1574;14321;58;57;31;3;28;.903;3600000;0
1574;28772;53;100;27;0;27;1.000;3600000;0
1574;31156;53;0;0;0;0;.00nan;0;0
1575;5298;55;45;27;4;23;.852;3600000;0
1575;6081;56;0;0;0;0;.00nan;0;0
1575;26824;56;83;32;1;31;.969;3600000;0
1575;34770;55;0;0;0;0;.00nan;0;0
1576;3533;57;0;0;0;0;.00nan;0;0
1576;4338;65;42;32;5;27;.844;3583000;0
1576;4987;65;0;0;0;0;.00nan;0;0
1576;26865;57;68;38;4;34;.895;3600000;0
1577;2163;39;0;0;0;0;.00nan;0;0
1577;2900;36;55;18;2;16;.889;3600000;0
1577;9238;39;79;40;3;37;.925;3587000;0
1577;14874;36;0;0;0;0;.00nan;0;0
1578;2198;45;91;33;2;31;.939;3600000;0
1578;23493;51;52;25;3;22;.880;3554000;0
1578;31822;51;0;0;0;0;.00nan;0;0
1578;34786;45;0;0;0;0;.00nan;0;0
1579;4447;54;0;0;0;0;.00nan;0;0
1579;31643;54;100;24;0;24;1.000;3600000;0
1579;34788;42;0;0;0;0;.00nan;0;0
1579;37416;42;96;31;1;30;.968;3552000;0
1580;7049;47;69;29;2;27;.931;2904000;0
1580;14351;40;75;23;2;21;.913;3600000;0
1580;26840;40;0;0;0;0;.00nan;0;0
1580;33654;47;18;8;4;4;.500;696000;0
1581;2016;61;0;0;0;0;.00nan;0;0
1581;2152;49;59;20;2;18;.900;3600000;0
1581;4435;49;0;0;0;0;.00nan;0;0
1581;30971;61;65;44;5;39;.886;3600000;0
1582;3;50;0;0;0;0;.00nan;0;0
1582;751;64;95;33;1;32;.970;3600000;0
1582;5048;50;49;19;3;16;.842;3534000;0
1582;5146;64;0;0;0;0;.00nan;0;0
1583;2796;59;0;0;0;0;.00nan;0;0
1583;2900;36;0;0;0;0;.00nan;0;0
1583;14874;36;82;39;3;36;.923;3600000;0
1583;31858;59;56;27;4;23;.852;3577000;0
1584;1486;43;66;30;3;27;.900;3572000;0
1584;3625;43;0;0;0;0;.00nan;0;0
1584;4447;54;0;0;0;0;.00nan;0;0
1584;31643;54;69;21;1;20;.952;3600000;0
1585;2198;45;34;34;6;28;.824;2939000;0
1585;23493;51;80;28;2;26;.929;3600000;0
1585;31822;51;0;0;0;0;.00nan;0;0
1585;34786;45;57;5;0;5;1.000;661000;0
1586;37;46;0;0;0;0;.00nan;0;0
1586;2553;46;33;29;6;23;.793;3535000;0
1586;34788;42;0;0;0;0;.00nan;0;0
1586;37416;42;57;36;4;32;.889;3600000;0
1587;3847;38;0;0;0;0;.00nan;0;0
1587;28772;53;62;28;3;25;.893;3600000;0
1587;31021;38;100;29;0;29;1.000;3600000;0
1587;31156;53;0;0;0;0;.00nan;0;0
1588;3533;57;0;0;0;0;.00nan;0;0
1588;19640;41;0;0;0;0;.00nan;0;0
1588;23075;41;27;29;6;23;.793;3600000;0
1588;26865;57;77;27;2;25;.926;3600000;0
1589;2163;39;0;0;0;0;.00nan;0;0
1589;5137;58;0;0;0;0;.00nan;0;0
1589;9238;39;87;38;2;36;.947;3600000;0
1589;14321;58;46;21;3;18;.857;3600000;0
1590;1051;44;0;0;0;0;.00nan;0;0
1590;3281;44;47;29;5;24;.828;3739000;0
1590;4716;4619;40;23;4;19;.826;3701000;0
1590;10698;4619;0;0;0;0;.00nan;0;0
1591;3626;48;64;25;2;23;.920;3548000;0
1591;7049;47;0;0;0;0;.00nan;0;0
1591;33654;47;100;35;1;34;.971;3600000;0
1591;38547;48;0;0;0;0;.00nan;0;0
1592;6572;62;79;53;4;49;.925;3600000;0
1592;14351;40;73;20;1;19;.950;3600000;0
1592;26840;40;0;0;0;0;.00nan;0;0
1592;26919;62;0;0;0;0;.00nan;0;0
1593;1592;63;0;0;0;0;.00nan;0;0
1593;5137;58;99;44;2;42;.955;3900000;0
1593;14321;58;0;0;0;0;.00nan;0;0
1593;34814;63;97;43;2;41;.953;3900000;0
1594;2796;59;47;23;4;19;.826;3686000;0
1594;19640;41;92;39;3;36;.923;3686000;0
1594;23075;41;0;0;0;0;.00nan;0;0
1594;31858;59;0;0;0;0;.00nan;0;0
1595;780;52;0;0;0;0;.00nan;0;0
1595;3847;38;0;0;0;0;.00nan;0;0
1595;31021;38;64;28;3;25;.893;3660000;0
1595;32146;52;54;28;4;24;.857;3660000;0
1596;2163;39;51;33;5;28;.848;3600000;0
1596;2900;36;86;24;1;23;.958;3600000;0
1596;9238;39;0;0;0;0;.00nan;0;0
1596;14874;36;0;0;0;0;.00nan;0;0
1597;1486;43;0;0;0;0;.00nan;0;0
1597;3625;43;70;18;1;17;.944;3600000;0
1597;4447;54;75;41;4;37;.902;3600000;0
1597;31643;54;0;0;0;0;.00nan;0;0
1598;2296;37;0;0;0;0;.00nan;0;0
1598;5883;37;65;30;3;27;.900;3576000;0
1598;6081;56;99;39;2;37;.949;3600000;0
1598;26824;56;0;0;0;0;.00nan;0;0
1599;37;46;49;29;4;25;.862;3598000;0
1599;2553;46;0;0;0;0;.00nan;0;0
1599;34788;42;72;29;3;26;.897;3600000;0
1599;37416;42;0;0;0;0;.00nan;0;0
1600;3;50;74;21;1;20;.952;3900000;0
1600;751;64;75;27;1;26;.963;3900000;0
1600;5048;50;0;0;0;0;.00nan;0;0
1600;5146;64;0;0;0;0;.00nan;0;0
1601;3533;57;0;0;0;0;.00nan;0;0
1601;4338;65;63;30;3;27;.900;3387000;0
1601;4987;65;25;6;3;3;.500;159000;0
1601;26865;57;54;33;4;29;.879;3600000;0
1602;5298;55;0;0;0;0;.00nan;0;0
1602;28772;53;0;0;0;0;.00nan;0;0
1602;31156;53;72;18;1;17;.944;3600000;0
1602;34770;55;78;35;2;33;.943;3547000;0
1603;6572;62;0;0;0;0;.00nan;0;0
1603;14351;40;0;0;0;0;.00nan;0;0
1603;26840;40;77;26;1;25;.962;3600000;0
1603;26919;62;89;43;2;41;.953;3543000;0
1604;1051;44;95;35;2;33;.943;3600000;0
1604;3281;44;0;0;0;0;.00nan;0;0
1604;4716;4619;0;0;0;0;.00nan;0;0
1604;10698;4619;60;37;4;33;.892;3594000;0
1605;2152;49;0;0;0;0;.00nan;0;0
1605;4435;49;69;26;3;23;.885;3600000;0
1605;7049;47;75;30;2;28;.933;3600000;0
1605;33654;47;0;0;0;0;.00nan;0;0
1606;2016;61;0;0;0;0;.00nan;0;0
1606;20717;60;0;0;0;0;.00nan;0;0
1606;30971;61;91;53;3;50;.943;3900000;0
1606;35536;60;60;26;3;23;.885;3900000;0
1607;780;52;100;23;0;23;1.000;3600000;0
1607;19640;41;0;0;0;0;.00nan;0;0
1607;23075;41;72;35;3;32;.914;3600000;0
1607;32146;52;0;0;0;0;.00nan;0;0
1608;2796;59;0;0;0;0;.00nan;0;0
1608;4338;65;0;0;0;0;.00nan;0;0
1608;4987;65;50;29;5;24;.828;3900000;0
1608;31858;59;49;30;5;25;.833;3900000;0
1609;2296;37;26;13;4;9;.692;937000;0
1609;5883;37;86;30;2;28;.933;2663000;0
1609;6081;56;0;0;0;0;.00nan;0;0
1609;26824;56;55;26;3;23;.885;3600000;0
1610;3847;38;88;28;1;27;.964;3900000;0
1610;5298;55;100;37;1;36;.973;3900000;0
1610;31021;38;0;0;0;0;.00nan;0;0
1610;34770;55;0;0;0;0;.00nan;0;0
1611;1592;63;55;39;5;34;.872;3600000;0
1611;23493;51;46;12;2;10;.833;3600000;0
1611;31822;51;0;0;0;0;.00nan;0;0
1611;34814;63;0;0;0;0;.00nan;0;0
1612;3;50;0;0;0;0;.00nan;0;0
1612;751;64;0;0;0;0;.00nan;0;0
1612;5048;50;71;27;1;26;.963;3600000;0
1612;5146;64;63;37;5;32;.865;3600000;0
1613;2016;61;74;35;3;32;.914;3541000;0
1613;20717;60;70;22;1;21;.955;3600000;0
1613;30971;61;0;0;0;0;.00nan;0;0
1613;35536;60;0;0;0;0;.00nan;0;0
1614;37;46;82;40;3;37;.925;3551000;0
1614;1486;43;67;22;2;20;.909;3600000;0
1614;2553;46;0;0;0;0;.00nan;0;0
1614;3625;43;0;0;0;0;.00nan;0;0
1615;2152;49;0;0;0;0;.00nan;0;0
1615;4435;49;100;30;0;30;1.000;3600000;0
1615;7049;47;0;0;0;0;.00nan;0;0
1615;33654;47;89;30;1;29;.967;3557000;0
1616;6081;56;0;0;0;0;.00nan;0;0
1616;26824;56;77;28;2;26;.929;3600000;0
1616;28772;53;11;19;6;13;.684;3067000;0
1616;31156;53;55;7;0;7;1.000;533000;0
1617;1486;43;0;0;0;0;.00nan;0;0
1617;2900;36;0;0;0;0;.00nan;0;0
1617;3625;43;32;32;6;26;.813;3600000;0
1617;14874;36;34;20;4;16;.800;3600000;0
1618;2796;59;0;0;0;0;.00nan;0;0
1618;4338;65;99;36;2;34;.944;3600000;0
1618;4987;65;0;0;0;0;.00nan;0;0
1618;31858;59;48;19;3;16;.842;3600000;0
1619;2163;39;0;0;0;0;.00nan;0;0
1619;5298;55;66;26;2;24;.923;3557000;0
1619;9238;39;90;24;1;23;.958;3600000;0
1619;34770;55;0;0;0;0;.00nan;0;0
1620;2296;37;0;0;0;0;.00nan;0;0
1620;5883;37;78;29;3;26;.897;3600000;0
1620;23493;51;0;0;0;0;.00nan;0;0
1620;31822;51;75;30;2;28;.933;3600000;0
1621;3;50;0;0;0;0;.00nan;0;0
1621;5048;50;80;39;3;36;.923;3754000;0
1621;34788;42;0;0;0;0;.00nan;0;0
1621;37416;42;60;25;2;23;.920;3754000;0
1622;751;64;94;34;2;32;.941;3600000;0
1622;2198;45;41;31;5;26;.839;3600000;0
1622;5146;64;0;0;0;0;.00nan;0;0
1622;34786;45;0;0;0;0;.00nan;0;0
1623;8046;57;0;0;0;0;.00nan;0;0
1623;26865;57;64;27;3;24;.889;3542000;0
1623;28772;53;0;0;0;0;.00nan;0;0
1623;31156;53;99;43;1;42;.977;3600000;0
1624;2900;36;0;0;0;0;.00nan;0;0
1624;14874;36;80;29;2;27;.931;3588000;0
1624;19640;41;0;0;0;0;.00nan;0;0
1624;23075;41;75;22;1;21;.955;3600000;0
1625;1486;43;82;45;4;41;.911;3592000;0
1625;3625;43;0;0;0;0;.00nan;0;0
1625;5298;55;0;0;0;0;.00nan;0;0
1625;34770;55;58;30;3;27;.900;3600000;0
1626;3847;38;0;0;0;0;.00nan;0;0
1626;6081;56;0;0;0;0;.00nan;0;0
1626;26824;56;84;27;1;26;.963;3600000;0
1626;31021;38;47;35;5;30;.857;3600000;0
1627;1592;63;0;0;0;0;.00nan;0;0
1627;5137;58;0;0;0;0;.00nan;0;0
1627;14321;58;88;21;1;20;.952;3600000;0
1627;34814;63;68;33;3;30;.909;3543000;0
1628;2163;39;0;0;0;0;.00nan;0;0
1628;9238;39;57;28;4;24;.857;3600000;0
1628;23493;51;58;36;5;31;.861;3583000;0
1628;31822;51;0;0;0;0;.00nan;0;0
1629;37;46;0;0;0;0;.00nan;0;0
1629;2296;37;0;0;0;0;.00nan;0;0
1629;2553;46;61;21;2;19;.905;3600000;0
1629;5883;37;83;33;1;32;.970;3600000;0
1630;3;50;41;2;1;1;.500;373000;0
1630;4447;54;52;37;5;32;.865;3600000;0
1630;5048;50;39;35;6;29;.829;3194000;0
1630;31643;54;0;0;0;0;.00nan;0;0
1631;3626;48;79;37;3;34;.919;3600000;0
1631;34788;42;49;38;5;33;.868;3566000;0
1631;37416;42;0;0;0;0;.00nan;0;0
1631;38547;48;0;0;0;0;.00nan;0;0
1632;1051;44;76;30;2;28;.933;3600000;0
1632;3281;44;0;0;0;0;.00nan;0;0
1632;14351;40;0;0;0;0;.00nan;0;0
1632;26840;40;50;31;4;27;.871;3546000;0
1633;4716;4619;63;25;2;23;.920;3600000;0
1633;7049;47;0;0;0;0;.00nan;0;0
1633;10698;4619;0;0;0;0;.00nan;0;0
1633;33654;47;79;42;5;37;.881;3600000;0
1634;2152;49;0;0;0;0;.00nan;0;0
1634;4435;49;61;24;3;21;.875;3900000;0
1634;6572;62;0;0;0;0;.00nan;0;0
1634;26919;62;90;54;3;51;.944;3900000;0
1635;2016;61;0;0;0;0;.00nan;0;0
1635;20717;60;75;39;3;36;.923;3900000;0
1635;30971;61;82;33;3;30;.909;3900000;0
1635;35536;60;0;0;0;0;.00nan;0;0
1636;2900;36;67;27;3;24;.889;3565000;0
1636;14874;36;0;0;0;0;.00nan;0;0
1636;19640;41;86;34;2;32;.941;3600000;0
1636;23075;41;0;0;0;0;.00nan;0;0
1637;2796;59;0;0;0;0;.00nan;0;0
1637;4338;65;0;0;0;0;.00nan;0;0
1637;4987;65;84;33;1;32;.970;3600000;0
1637;31858;59;72;31;2;29;.935;3549000;0
1638;780;52;100;44;1;43;.977;3600000;0
1638;1592;63;77;33;2;31;.939;3582000;0
1638;32146;52;0;0;0;0;.00nan;0;0
1638;34814;63;0;0;0;0;.00nan;0;0
1639;37;46;91;32;1;31;.969;3600000;0
1639;2296;37;49;34;5;29;.853;3600000;0
1639;2553;46;0;0;0;0;.00nan;0;0
1639;5883;37;0;0;0;0;.00nan;0;0
1640;3;50;58;26;3;23;.885;3600000;0
1640;4447;54;0;0;0;0;.00nan;0;0
1640;5048;50;0;0;0;0;.00nan;0;0
1640;31643;54;39;28;5;23;.821;3600000;0
1641;3626;48;0;0;0;0;.00nan;0;0
1641;34788;42;0;0;0;0;.00nan;0;0
1641;37416;42;80;39;3;36;.923;3600000;0
1641;38547;48;42;25;4;21;.840;3600000;0
1642;1486;43;0;0;0;0;.00nan;0;0
1642;3625;43;57;32;4;28;.875;3553000;0
1642;8046;57;0;0;0;0;.00nan;0;0
1642;26865;57;74;35;3;32;.914;3600000;0
1643;3847;38;90;37;2;35;.946;3600000;0
1643;5137;58;34;29;6;23;.793;3600000;0
1643;14321;58;0;0;0;0;.00nan;0;0
1643;31021;38;0;0;0;0;.00nan;0;0
1644;751;64;31;31;6;25;.806;2645000;0
1644;2198;45;0;0;0;0;.00nan;0;0
1644;5146;64;57;12;1;11;.917;955000;0
1644;34786;45;46;30;5;25;.833;3600000;0
1645;1051;44;0;0;0;0;.00nan;0;0
1645;3281;44;71;32;4;28;.875;3900000;0
1645;14351;40;83;48;4;44;.917;3900000;0
1645;26840;40;0;0;0;0;.00nan;0;0
1646;4716;4619;0;0;0;0;.00nan;0;0
1646;7049;47;44;36;6;30;.833;3000000;0
1646;10698;4619;82;31;2;29;.935;3600000;0
1646;33654;47;55;9;1;8;.889;600000;0
1647;2152;49;58;16;1;15;.938;3600000;0
1647;4435;49;0;0;0;0;.00nan;0;0
1647;6572;62;51;28;4;24;.857;3600000;0
1647;26919;62;0;0;0;0;.00nan;0;0
1648;780;52;0;0;0;0;.00nan;0;0
1648;6081;56;0;0;0;0;.00nan;0;0
1648;26824;56;71;36;3;33;.917;3552000;0
1648;32146;52;90;38;2;36;.947;3600000;0
1649;1592;63;0;0;0;0;.00nan;0;0
1649;3847;38;0;0;0;0;.00nan;0;0
1649;31021;38;67;20;2;18;.900;3600000;0
1649;34814;63;46;32;5;27;.844;3600000;0
1650;8046;57;64;29;3;26;.897;3558000;0
1650;26865;57;0;0;0;0;.00nan;0;0
1650;28772;53;75;27;2;25;.926;3600000;0
1650;31156;53;0;0;0;0;.00nan;0;0
1651;2796;59;65;17;1;16;.941;3600000;0
1651;5137;58;0;0;0;0;.00nan;0;0
1651;14321;58;83;37;2;35;.946;3583000;0
1651;31858;59;0;0;0;0;.00nan;0;0
1652;4338;65;88;40;2;38;.950;3600000;0
1652;4987;65;0;0;0;0;.00nan;0;0
1652;23493;51;100;38;1;37;.974;3600000;0
1652;31822;51;0;0;0;0;.00nan;0;0
1653;751;64;0;0;0;0;.00nan;0;0
1653;2198;45;64;18;1;17;.944;3600000;0
1653;5146;64;57;34;4;30;.882;3600000;0
1653;34786;45;0;0;0;0;.00nan;0;0
1654;2016;61;44;34;5;29;.853;3516000;0
1654;20717;60;0;0;0;0;.00nan;0;0
1654;30971;61;0;0;0;0;.00nan;0;0
1654;35536;60;78;41;3;38;.927;3600000;0
1655;2163;39;0;0;0;0;.00nan;0;0
1655;9238;39;71;47;5;42;.894;3600000;0
1655;19640;41;0;0;0;0;.00nan;0;0
1655;23075;41;64;14;1;13;.929;3600000;0
1656;3;50;0;0;0;0;.00nan;0;0
1656;4447;54;0;0;0;0;.00nan;0;0
1656;5048;50;69;29;3;26;.897;3550000;0
1656;31643;54;85;26;1;25;.962;3600000;0
1657;1051;44;67;36;4;32;.889;3600000;0
1657;3281;44;0;0;0;0;.00nan;0;0
1657;3626;48;47;29;5;24;.828;3543000;0
1657;38547;48;0;0;0;0;.00nan;0;0
1658;2163;39;29;39;7;32;.821;3306000;0
1658;9238;39;49;1;0;1;1.000;294000;0
1658;19640;41;76;24;1;23;.958;3600000;0
1658;23075;41;0;0;0;0;.00nan;0;0
1659;1592;63;0;0;0;0;.00nan;0;0
1659;14874;36;73;25;1;24;.960;3600000;0
1659;34814;63;57;31;4;27;.871;3600000;0
1659;42825;36;0;0;0;0;.00nan;0;0
1660;6081;56;0;0;0;0;.00nan;0;0
1660;8046;57;0;0;0;0;.00nan;0;0
1660;26824;56;43;24;4;20;.833;3600000;0
1660;26865;57;48;37;6;31;.838;3600000;0
1661;1051;44;0;0;0;0;.00nan;0;0
1661;3281;44;42;31;5;26;.839;3600000;0
1661;3626;48;0;0;0;0;.00nan;0;0
1661;38547;48;80;33;2;31;.939;3600000;0
1662;7049;47;0;0;0;0;.00nan;0;0
1662;14351;40;0;0;0;0;.00nan;0;0
1662;26840;40;100;21;0;21;1.000;3600000;0
1662;33654;47;63;31;3;28;.903;3600000;0
1663;2016;61;0;0;0;0;.00nan;0;0
1663;6572;62;65;33;3;30;.909;3600000;0
1663;26919;62;0;0;0;0;.00nan;0;0
1663;30971;61;59;30;4;26;.867;3585000;0
1664;4716;4619;71;27;3;24;.889;3719000;0
1664;10698;4619;0;0;0;0;.00nan;0;0
1664;20717;60;0;0;0;0;.00nan;0;0
1664;35536;60;97;45;2;43;.956;3719000;0
1665;751;64;0;0;0;0;.00nan;0;0
1665;2296;37;0;0;0;0;.00nan;0;0
1665;5146;64;79;21;1;20;.952;3600000;0
1665;5883;37;85;32;2;30;.938;3543000;0
1666;1486;43;84;27;1;26;.963;3840000;0
1666;3625;43;0;0;0;0;.00nan;0;0
1666;5298;55;0;0;0;0;.00nan;0;0
1666;34770;55;87;32;2;30;.938;3840000;0
1667;8046;57;0;0;0;0;.00nan;0;0
1667;26865;57;77;28;2;26;.929;3600000;0
1667;28772;53;75;53;6;47;.887;3600000;0
1667;31156;53;0;0;0;0;.00nan;0;0
1668;6081;56;0;0;0;0;.00nan;0;0
1668;14874;36;87;24;1;23;.958;3600000;0
1668;26824;56;21;35;8;27;.771;3600000;0
1668;42825;36;0;0;0;0;.00nan;0;0
1669;1486;43;0;0;0;0;.00nan;0;0
1669;3625;43;48;30;5;25;.833;3582000;0
1669;5298;55;56;27;4;23;.852;3600000;0
1669;34770;55;0;0;0;0;.00nan;0;0
1670;3847;38;0;0;0;0;.00nan;0;0
1670;23493;51;82;31;3;28;.903;3900000;0
1670;31021;38;80;36;3;33;.917;3900000;0
1670;31822;51;0;0;0;0;.00nan;0;0
1671;4338;65;51;29;4;25;.862;3537000;0
1671;4987;65;0;0;0;0;.00nan;0;0
1671;5137;58;0;0;0;0;.00nan;0;0
1671;14321;58;73;25;2;23;.920;3600000;0
1672;751;64;66;33;3;30;.909;3900000;0
1672;4447;54;60;27;3;24;.889;3900000;0
1672;5146;64;0;0;0;0;.00nan;0;0
1672;31643;54;0;0;0;0;.00nan;0;0
1673;2198;45;43;25;5;20;.800;3900000;0
1673;34786;45;0;0;0;0;.00nan;0;0
1673;34788;42;70;45;5;40;.889;3900000;0
1673;37416;42;0;0;0;0;.00nan;0;0
1674;3;50;100;27;0;27;1.000;3600000;0
1674;2296;37;82;46;5;41;.891;3600000;0
1674;5048;50;0;0;0;0;.00nan;0;0
1674;5883;37;0;0;0;0;.00nan;0;0
1675;2152;49;0;0;0;0;.00nan;0;0
1675;4435;49;54;25;3;22;.880;3556000;0
1675;20717;60;0;0;0;0;.00nan;0;0
1675;35536;60;90;41;2;39;.951;3600000;0
1676;6572;62;0;0;0;0;.00nan;0;0
1676;7049;47;0;0;0;0;.00nan;0;0
1676;26919;62;96;40;2;38;.950;3900000;0
1676;33654;47;73;24;2;22;.917;3900000;0
1677;4716;4619;53;27;4;23;.852;3600000;0
1677;10698;4619;0;0;0;0;.00nan;0;0
1677;14351;40;0;0;0;0;.00nan;0;0
1677;26840;40;89;30;1;29;.967;3600000;0
1678;780;52;0;0;0;0;.00nan;0;0
1678;19640;41;46;4;1;3;.750;741000;0
1678;23075;41;21;24;6;18;.750;2859000;0
1678;32146;52;90;26;1;25;.962;3600000;0
1679;2796;59;0;0;0;0;.00nan;0;0
1679;4338;65;0;0;0;0;.00nan;0;0
1679;4987;65;91;35;1;34;.971;3600000;0
1679;31858;59;77;29;2;27;.931;3573000;0
1680;14874;36;50;19;2;17;.895;3600000;0
1680;23493;51;0;0;0;0;.00nan;0;0
1680;31822;51;52;28;3;25;.893;3600000;0
1680;42825;36;0;0;0;0;.00nan;0;0
1681;3847;38;96;36;1;35;.972;3600000;0
1681;6081;56;58;23;2;21;.913;3587000;0
1681;26824;56;0;0;0;0;.00nan;0;0
1681;31021;38;0;0;0;0;.00nan;0;0
1682;37;46;87;20;0;20;1.000;3600000;0
1682;1592;63;66;35;4;31;.886;3600000;0
1682;2553;46;0;0;0;0;.00nan;0;0
1682;34814;63;0;0;0;0;.00nan;0;0
1683;3;50;61;28;3;25;.893;3559000;0
1683;2296;37;0;0;0;0;.00nan;0;0
1683;5048;50;0;0;0;0;.00nan;0;0
1683;5883;37;71;28;2;26;.929;3600000;0
1684;2163;39;0;0;0;0;.00nan;0;0
1684;8046;57;0;0;0;0;.00nan;0;0
1684;9238;39;64;28;3;25;.893;3600000;0
1684;26865;57;62;41;4;37;.902;3600000;0
1685;5137;58;65;25;2;23;.920;3600000;0
1685;14321;58;0;0;0;0;.00nan;0;0
1685;28772;53;0;0;0;0;.00nan;0;0
1685;31156;53;40;30;6;24;.800;3600000;0
1686;751;64;0;0;0;0;.00nan;0;0
1686;4447;54;0;0;0;0;.00nan;0;0
1686;5146;64;76;48;6;42;.875;3600000;0
1686;31643;54;64;23;2;21;.913;3600000;0
1687;2198;45;0;0;0;0;.00nan;0;0
1687;34786;45;55;33;4;29;.879;3540000;0
1687;34788;42;0;0;0;0;.00nan;0;0
1687;37416;42;75;37;3;34;.919;3600000;0
1688;1051;44;85;38;2;36;.947;3547000;0
1688;2152;49;92;28;1;27;.964;3600000;0
1688;3281;44;0;0;0;0;.00nan;0;0
1688;4435;49;0;0;0;0;.00nan;0;0
1689;4716;4619;0;0;0;0;.00nan;0;0
1689;10698;4619;66;15;1;14;.933;3600000;0
1689;14351;40;46;39;5;34;.872;3600000;0
1689;26840;40;0;0;0;0;.00nan;0;0
1690;6572;62;78;55;4;51;.927;3845000;0
1690;20717;60;75;36;3;33;.917;3845000;0
1690;26919;62;0;0;0;0;.00nan;0;0
1690;35536;60;0;0;0;0;.00nan;0;0
1691;2016;61;0;0;0;0;.00nan;0;0
1691;3626;48;75;29;2;27;.931;3600000;0
1691;30971;61;74;31;3;28;.903;3551000;0
1691;38547;48;0;0;0;0;.00nan;0;0
1692;780;52;90;32;1;31;.969;3600000;0
1692;19640;41;69;27;2;25;.926;3551000;0
1692;23075;41;0;0;0;0;.00nan;0;0
1692;32146;52;0;0;0;0;.00nan;0;0
1693;5137;58;0;0;0;0;.00nan;0;0
1693;14321;58;51;22;3;19;.864;3600000;0
1693;28772;53;62;37;4;33;.892;3600000;0
1693;31156;53;0;0;0;0;.00nan;0;0
1694;37;46;84;35;2;33;.943;3600000;0
1694;1592;63;63;24;2;22;.917;856000;0
1694;2553;46;0;0;0;0;.00nan;0;0
1694;34814;63;37;33;6;27;.818;2744000;0
1695;2163;39;65;28;4;24;.857;3513000;0
1695;4338;65;70;25;2;23;.920;3600000;0
1695;4987;65;0;0;0;0;.00nan;0;0
1695;9238;39;0;0;0;0;.00nan;0;0
1696;2016;61;60;33;4;29;.879;3676000;0
1696;3626;48;0;0;0;0;.00nan;0;0
1696;30971;61;0;0;0;0;.00nan;0;0
1696;38547;48;61;25;3;22;.880;3676000;0
1697;1592;63;0;0;0;0;.00nan;0;0
1697;2796;59;0;0;0;0;.00nan;0;0
1697;31858;59;93;33;2;31;.939;3900000;0
1697;34814;63;68;25;2;23;.920;3900000;0
1698;5298;55;0;0;0;0;.00nan;0;0
1698;6081;56;95;24;0;24;1.000;3600000;0
1698;26824;56;0;0;0;0;.00nan;0;0
1698;34770;55;59;32;3;29;.906;3600000;0
1699;4447;54;0;0;0;0;.00nan;0;0
1699;31643;54;34;25;5;20;.800;3543000;0
1699;34788;42;54;30;4;26;.867;3600000;0
1699;37416;42;0;0;0;0;.00nan;0;0
1700;2198;45;67;19;2;17;.895;3600000;0
1700;2296;37;0;0;0;0;.00nan;0;0
1700;5883;37;48;30;4;26;.867;3600000;0
1700;34786;45;0;0;0;0;.00nan;0;0
1701;4716;4619;72;28;2;26;.929;3600000;0
1701;10698;4619;0;0;0;0;.00nan;0;0
1701;20717;60;0;0;0;0;.00nan;0;0
1701;35536;60;71;37;3;34;.919;3563000;0
1702;2198;45;0;0;0;0;.00nan;0;0
1702;2296;37;85;27;1;26;.963;3600000;0
1702;5883;37;0;0;0;0;.00nan;0;0
1702;34786;45;82;35;3;32;.914;3547000;0
1703;780;52;0;0;0;0;.00nan;0;0
1703;28772;53;90;31;1;30;.968;3600000;0
1703;31156;53;0;0;0;0;.00nan;0;0
1703;32146;52;55;33;4;29;.879;3600000;0
1704;4338;65;46;34;5;29;.853;3600000;0
1704;4987;65;0;0;0;0;.00nan;0;0
1704;8046;57;0;0;0;0;.00nan;0;0
1704;26865;57;87;35;2;33;.943;3600000;0
1705;3847;38;0;0;0;0;.00nan;0;0
1705;14874;36;90;18;0;18;1.000;3600000;0
1705;31021;38;89;38;2;36;.947;3566000;0
1705;42825;36;0;0;0;0;.00nan;0;0
1706;751;64;0;0;0;0;.00nan;0;0
1706;1486;43;54;30;4;26;.867;3600000;0
1706;3625;43;0;0;0;0;.00nan;0;0
1706;5146;64;96;32;1;31;.969;3600000;0
1707;37;46;73;22;1;21;.955;3600000;0
1707;2553;46;0;0;0;0;.00nan;0;0
1707;4447;54;74;28;2;26;.929;3551000;0
1707;31643;54;0;0;0;0;.00nan;0;0
1708;2163;39;0;0;0;0;.00nan;0;0
1708;2796;59;58;25;3;22;.880;3546000;0
1708;9238;39;80;33;2;31;.939;3600000;0
1708;31858;59;0;0;0;0;.00nan;0;0
1709;4716;4619;0;0;0;0;.00nan;0;0
1709;10698;4619;100;34;0;34;1.000;3600000;0
1709;20717;60;61;32;4;28;.875;3600000;0
1709;35536;60;0;0;0;0;.00nan;0;0
1710;6572;62;0;0;0;0;.00nan;0;0
1710;14351;40;43;4;1;3;.750;884000;0
1710;26840;40;20;31;7;24;.774;2716000;0
1710;26919;62;76;25;1;24;.960;3600000;0
1711;2152;49;0;0;0;0;.00nan;0;0
1711;3626;48;58;27;3;24;.889;3553000;0
1711;4435;49;91;30;1;29;.967;3600000;0
1711;38547;48;0;0;0;0;.00nan;0;0
1712;1051;44;93;31;1;30;.968;3600000;0
1712;2016;61;0;0;0;0;.00nan;0;0
1712;3281;44;0;0;0;0;.00nan;0;0
1712;30971;61;66;32;3;29;.906;3515000;0
1713;751;64;72;21;2;19;.905;3900000;0
1713;1486;43;0;0;0;0;.00nan;0;0
1713;3625;43;88;37;2;35;.946;3900000;0
1713;5146;64;0;0;0;0;.00nan;0;0
1714;1051;44;0;0;0;0;.00nan;0;0
1714;2016;61;43;23;4;19;.826;3549000;0
1714;3281;44;82;37;2;35;.946;3600000;0
1714;30971;61;0;0;0;0;.00nan;0;0
1715;1592;63;0;0;0;0;.00nan;0;0
1715;6081;56;0;0;0;0;.00nan;0;0
1715;26824;56;43;23;4;19;.826;3553000;0
1715;34814;63;72;36;3;33;.917;3600000;0
1716;37;46;62;24;2;22;.917;3581000;0
1716;1486;43;81;23;1;22;.957;3600000;0
1716;2553;46;0;0;0;0;.00nan;0;0
1716;3625;43;0;0;0;0;.00nan;0;0
1717;3;50;57;34;5;29;.853;3600000;0
1717;5048;50;0;0;0;0;.00nan;0;0
1717;34788;42;0;0;0;0;.00nan;0;0
1717;37416;42;74;28;2;26;.929;3600000;0
1718;2796;59;48;0;0;0;.00nan;318000;0
1718;4338;65;61;33;4;29;.879;3600000;0
1718;4987;65;0;0;0;0;.00nan;0;0
1718;31858;59;41;35;6;29;.829;3210000;0
1719;2163;39;0;0;0;0;.00nan;0;0
1719;5298;55;88;43;3;40;.930;3600000;0
1719;9238;39;88;16;0;16;1.000;3600000;0
1719;34770;55;0;0;0;0;.00nan;0;0
1720;2152;49;0;0;0;0;.00nan;0;0
1720;4435;49;73;24;1;23;.958;3600000;0
1720;6572;62;0;0;0;0;.00nan;0;0
1720;26919;62;65;29;3;26;.897;3586000;0
1721;7049;47;60;37;4;33;.892;3600000;0
1721;20717;60;0;0;0;0;.00nan;0;0
1721;33654;47;0;0;0;0;.00nan;0;0
1721;35536;60;55;13;1;12;.923;3600000;0
1722;780;52;0;0;0;0;.00nan;0;0
1722;5137;58;0;0;0;0;.00nan;0;0
1722;14321;58;85;37;2;35;.946;3600000;0
1722;32146;52;56;28;3;25;.893;3573000;0
1723;1592;63;70;31;3;28;.903;3600000;0
1723;3847;38;0;0;0;0;.00nan;0;0
1723;31021;38;60;31;4;27;.871;3600000;0
1723;34814;63;0;0;0;0;.00nan;0;0
1724;2900;36;0;0;0;0;.00nan;0;0
1724;6081;56;67;33;3;30;.909;3600000;0
1724;14874;36;68;41;5;36;.878;3595000;0
1724;26824;56;0;0;0;0;.00nan;0;0
1725;5137;58;59;37;4;33;.892;3600000;0
1725;5298;55;0;0;0;0;.00nan;0;0
1725;14321;58;0;0;0;0;.00nan;0;0
1725;34770;55;85;27;1;26;.963;3600000;0
1726;780;52;74;26;2;24;.923;3600000;0
1726;28772;53;64;27;3;24;.889;3545000;0
1726;31156;53;0;0;0;0;.00nan;0;0
1726;32146;52;0;0;0;0;.00nan;0;0
1727;2796;59;0;0;0;0;.00nan;0;0
1727;4338;65;46;28;4;24;.857;3596000;0
1727;4987;65;0;0;0;0;.00nan;0;0
1727;31858;59;74;30;3;27;.900;3600000;0
1728;3;50;56;23;3;20;.870;3600000;0
1728;4716;4619;0;0;0;0;.00nan;0;0
1728;5048;50;0;0;0;0;.00nan;0;0
1728;10698;4619;59;31;4;27;.871;3544000;0
1729;1486;43;68;25;2;23;.920;3600000;0
1729;3625;43;0;0;0;0;.00nan;0;0
1729;8046;57;0;0;0;0;.00nan;0;0
1729;26865;57;57;24;3;21;.875;3558000;0
1730;2163;39;0;0;0;0;.00nan;0;0
1730;3847;38;83;38;3;35;.921;3900000;0
1730;9238;39;65;28;3;25;.893;3900000;0
1730;31021;38;0;0;0;0;.00nan;0;0
1731;2900;36;0;0;0;0;.00nan;0;0
1731;14874;36;94;42;2;40;.952;3900000;0
1731;23493;51;80;32;2;30;.938;3900000;0
1731;31822;51;0;0;0;0;.00nan;0;0
1732;2152;49;0;0;0;0;.00nan;0;0
1732;4435;49;67;25;3;22;.880;3900000;0
1732;7049;47;0;0;0;0;.00nan;0;0
1732;33654;47;62;31;3;28;.903;3900000;0
1733;3626;48;30;36;7;29;.806;3600000;0
1733;6572;62;86;38;3;35;.921;3600000;0
1733;26919;62;0;0;0;0;.00nan;0;0
1733;38547;48;0;0;0;0;.00nan;0;0
1734;14351;40;0;0;0;0;.00nan;0;0
1734;20717;60;0;0;0;0;.00nan;0;0
1734;26840;40;59;41;5;36;.878;3600000;0
1734;35536;60;79;25;1;24;.960;3600000;0
1735;1592;63;0;0;0;0;.00nan;0;0
1735;6081;56;0;0;0;0;.00nan;0;0
1735;26824;56;83;36;2;34;.944;3600000;0
1735;34814;63;37;21;4;17;.810;3515000;0
1736;4447;54;0;0;0;0;.00nan;0;0
1736;31643;54;75;24;1;23;.958;3600000;0
1736;34788;42;65;36;4;32;.889;3600000;0
1736;37416;42;0;0;0;0;.00nan;0;0
1737;2016;61;0;0;0;0;.00nan;0;0
1737;2296;37;0;0;0;0;.00nan;0;0
1737;5883;37;68;18;1;17;.944;3600000;0
1737;30971;61;46;25;4;21;.840;3600000;0
1738;3847;38;0;0;0;0;.00nan;0;0
1738;28772;53;60;32;4;28;.875;3600000;0
1738;31021;38;63;27;3;24;.889;3600000;0
1738;31156;53;0;0;0;0;.00nan;0;0
1739;3;50;61;27;4;23;.852;3573000;0
1739;4716;4619;55;17;3;14;.824;3600000;0
1739;5048;50;0;0;0;0;.00nan;0;0
1739;10698;4619;0;0;0;0;.00nan;0;0
1740;14351;40;0;0;0;0;.00nan;0;0
1740;20717;60;0;0;0;0;.00nan;0;0
1740;26840;40;73;29;2;27;.931;3578000;0
1740;35536;60;95;29;1;28;.966;3600000;0
1741;5298;55;80;15;0;15;1.000;1313000;0
1741;8046;57;0;0;0;0;.00nan;0;0
1741;26865;57;41;35;6;29;.829;3900000;0
1741;34770;55;24;22;6;16;.727;2587000;0
1742;2016;61;93;44;3;41;.932;3594000;0
1742;2296;37;89;31;1;30;.968;3600000;0
1742;5883;37;0;0;0;0;.00nan;0;0
1742;30971;61;0;0;0;0;.00nan;0;0
1743;1486;43;34;31;6;25;.806;2920000;0
1743;2796;59;0;0;0;0;.00nan;0;0
1743;3625;43;58;6;0;6;1.000;680000;0
1743;31858;59;85;31;2;29;.935;3600000;0
1744;37;46;58;33;4;29;.879;3600000;0
1744;2553;46;0;0;0;0;.00nan;0;0
1744;4447;54;32;30;6;24;.800;3515000;0
1744;31643;54;0;0;0;0;.00nan;0;0
1745;751;64;0;0;0;0;.00nan;0;0
1745;5146;64;59;18;2;16;.889;3900000;0
1745;34788;42;0;0;0;0;.00nan;0;0
1745;37416;42;88;35;2;33;.943;3900000;0
1746;2198;45;46;44;7;37;.841;3600000;0
1746;19640;41;68;20;2;18;.900;3600000;0
1746;23075;41;0;0;0;0;.00nan;0;0
1746;34786;45;0;0;0;0;.00nan;0;0
1747;1051;44;79;40;3;37;.925;3768000;0
1747;3281;44;0;0;0;0;.00nan;0;0
1747;6572;62;0;0;0;0;.00nan;0;0
1747;26919;62;78;44;4;40;.909;3768000;0
1748;2152;49;54;23;3;20;.870;3558000;0
1748;3626;48;82;27;1;26;.963;3600000;0
1748;4435;49;0;0;0;0;.00nan;0;0
1748;38547;48;0;0;0;0;.00nan;0;0
1749;2163;39;0;0;0;0;.00nan;0;0
1749;5137;58;0;0;0;0;.00nan;0;0
1749;9238;39;99;38;1;37;.974;3600000;0
1749;14321;58;61;27;3;24;.889;3552000;0
1750;1592;63;82;41;3;38;.927;3600000;0
1750;6081;56;0;0;0;0;.00nan;0;0
1750;26824;56;33;30;6;24;.800;3600000;0
1750;34814;63;0;0;0;0;.00nan;0;0
1751;1486;43;0;0;0;0;.00nan;0;0
1751;2796;59;95;43;1;42;.977;3900000;0
1751;3625;43;100;44;1;43;.977;3900000;0
1751;31858;59;0;0;0;0;.00nan;0;0
1752;37;46;0;0;0;0;.00nan;0;0
1752;2553;46;32;43;8;35;.814;3600000;0
1752;4447;54;0;0;0;0;.00nan;0;0
1752;31643;54;59;27;3;24;.889;3600000;0
1753;751;64;68;31;3;28;.903;3600000;0
1753;5146;64;0;0;0;0;.00nan;0;0
1753;34788;42;61;34;4;30;.882;3595000;0
1753;37416;42;0;0;0;0;.00nan;0;0
1754;2198;45;0;0;0;0;.00nan;0;0
1754;19640;41;0;0;0;0;.00nan;0;0
1754;23075;41;66;28;3;25;.893;3900000;0
1754;34786;45;52;31;3;28;.903;3900000;0
1755;3626;48;59;9;1;8;.889;914000;0
1755;7049;47;0;0;0;0;.00nan;0;0
1755;33654;47;74;24;2;22;.917;3600000;0
1755;38547;48;19;26;6;20;.769;2686000;0
1756;2163;39;0;0;0;0;.00nan;0;0
1756;9238;39;63;36;4;32;.889;3600000;0
1756;28772;53;96;18;0;18;1.000;3600000;0
1756;31156;53;0;0;0;0;.00nan;0;0
1757;780;52;0;0;0;0;.00nan;0;0
1757;4338;65;0;0;0;0;.00nan;0;0
1757;4987;65;75;38;3;35;.921;3600000;0
1757;32146;52;88;17;0;17;1.000;3600000;0
1758;3;50;92;21;0;21;1.000;3600000;0
1758;2296;37;0;0;0;0;.00nan;0;0
1758;5048;50;0;0;0;0;.00nan;0;0
1758;5883;37;81;40;3;37;.925;3600000;0
1759;3847;38;0;0;0;0;.00nan;0;0
1759;5137;58;71;39;4;35;.897;3900000;0
1759;14321;58;0;0;0;0;.00nan;0;0
1759;31021;38;63;30;4;26;.867;3900000;0
1760;37;46;78;38;3;35;.921;3600000;0
1760;751;64;0;0;0;0;.00nan;0;0
1760;2553;46;0;0;0;0;.00nan;0;0
1760;5146;64;50;27;4;23;.852;3600000;0
1761;14351;40;0;0;0;0;.00nan;0;0
1761;20717;60;0;0;0;0;.00nan;0;0
1761;26840;40;57;25;3;22;.880;3600000;0
1761;35536;60;66;32;4;28;.875;3557000;0
1762;1051;44;0;0;0;0;.00nan;0;0
1762;3281;44;57;18;2;16;.889;3600000;0
1762;6572;62;0;0;0;0;.00nan;0;0
1762;26919;62;72;44;5;39;.886;3600000;0
1763;2152;49;0;0;0;0;.00nan;0;0
1763;4435;49;56;28;4;24;.857;3600000;0
1763;7049;47;99;49;1;48;.980;3600000;0
1763;33654;47;0;0;0;0;.00nan;0;0
1764;3;50;37;29;5;24;.828;3600000;0
1764;2296;37;0;0;0;0;.00nan;0;0
1764;5048;50;0;0;0;0;.00nan;0;0
1764;5883;37;72;28;2;26;.929;3600000;0
1765;1051;44;72;29;2;27;.931;3600000;0
1765;3281;44;0;0;0;0;.00nan;0;0
1765;14351;40;75;39;3;36;.923;3600000;0
1765;26840;40;0;0;0;0;.00nan;0;0
1766;780;52;0;0;0;0;.00nan;0;0
1766;3847;38;0;0;0;0;.00nan;0;0
1766;31021;38;100;25;0;25;1.000;3600000;0
1766;32146;52;75;36;3;33;.917;3600000;0
1767;1592;63;0;0;0;0;.00nan;0;0
1767;5298;55;55;24;3;21;.875;3567000;0
1767;34770;55;0;0;0;0;.00nan;0;0
1767;34814;63;75;36;2;34;.944;3600000;0
1768;37;46;50;30;4;26;.867;3580000;0
1768;2553;46;0;0;0;0;.00nan;0;0
1768;4447;54;0;0;0;0;.00nan;0;0
1768;31643;54;96;42;3;39;.929;3600000;0
1769;2163;39;0;0;0;0;.00nan;0;0
1769;6081;56;0;0;0;0;.00nan;0;0
1769;9238;39;100;33;0;33;1.000;3600000;0
1769;26824;56;79;31;2;29;.935;3555000;0
1770;5137;58;0;0;0;0;.00nan;0;0
1770;14321;58;50;26;4;22;.846;3600000;0
1770;23493;51;100;32;0;32;1.000;3600000;0
1770;31822;51;0;0;0;0;.00nan;0;0
1771;1051;44;0;0;0;0;.00nan;0;0
1771;3281;44;31;19;4;15;.789;3522000;0
1771;14351;40;0;0;0;0;.00nan;0;0
1771;26840;40;89;31;2;29;.935;3600000;0
1772;3626;48;0;0;0;0;.00nan;0;0
1772;6572;62;0;0;0;0;.00nan;0;0
1772;26919;62;77;40;3;37;.925;3574000;0
1772;38547;48;67;16;1;15;.938;3600000;0
1773;2900;36;0;0;0;0;.00nan;0;0
1773;4338;65;0;0;0;0;.00nan;0;0
1773;4987;65;53;31;4;27;.871;3529000;0
1773;14874;36;90;35;2;33;.943;3600000;0
1774;2796;59;0;0;0;0;.00nan;0;0
1774;5298;55;63;32;4;28;.875;3513000;0
1774;31858;59;89;37;2;35;.946;3600000;0
1774;34770;55;0;0;0;0;.00nan;0;0
1775;5137;58;0;0;0;0;.00nan;0;0
1775;6081;56;38;11;3;8;.727;572000;0
1775;14321;58;31;29;6;23;.793;3581000;0
1775;26824;56;67;23;2;21;.913;3028000;0
1776;1592;63;0;0;0;0;.00nan;0;0
1776;23493;51;83;37;3;34;.919;3900000;0
1776;31822;51;0;0;0;0;.00nan;0;0
1776;34814;63;62;28;3;25;.893;3879000;0
1777;3;50;88;17;0;17;1.000;3600000;0
1777;37;46;93;31;1;30;.968;3598000;0
1777;2553;46;0;0;0;0;.00nan;0;0
1777;5048;50;0;0;0;0;.00nan;0;0
1778;3847;38;0;0;0;0;.00nan;0;0
1778;8046;57;0;0;0;0;.00nan;0;0
1778;26865;57;76;26;2;24;.923;3573000;0
1778;31021;38;97;25;1;24;.960;3600000;0
1779;2163;39;0;0;0;0;.00nan;0;0
1779;9238;39;75;34;3;31;.912;3600000;0
1779;28772;53;66;23;2;21;.913;3600000;0
1779;31156;53;0;0;0;0;.00nan;0;0
1780;1486;43;56;16;2;14;.875;3600000;0
1780;3625;43;0;0;0;0;.00nan;0;0
1780;4447;54;0;0;0;0;.00nan;0;0
1780;31643;54;67;46;5;41;.891;3600000;0
1781;751;64;77;26;1;25;.962;3600000;0
1781;5146;64;0;0;0;0;.00nan;0;0
1781;34788;42;85;44;4;40;.909;3600000;0
1781;37416;42;0;0;0;0;.00nan;0;0
1782;2198;45;100;32;0;32;1.000;3600000;0
1782;2296;37;0;0;0;0;.00nan;0;0
1782;5883;37;76;32;2;30;.938;3550000;0
1782;34786;45;0;0;0;0;.00nan;0;0
1783;6572;62;0;0;0;0;.00nan;0;0
1783;14351;40;65;31;3;28;.903;3600000;0
1783;26840;40;0;0;0;0;.00nan;0;0
1783;26919;62;100;36;0;36;1.000;3600000;0
1784;3626;48;0;0;0;0;.00nan;0;0
1784;21324;60;0;0;0;0;.00nan;0;0
1784;35536;60;100;26;0;26;1.000;3615000;0
1784;38547;48;77;26;1;25;.962;3615000;0
1785;2016;61;78;27;1;26;.963;3600000;0
1785;7049;47;0;0;0;0;.00nan;0;0
1785;30971;61;0;0;0;0;.00nan;0;0
1785;33654;47;83;29;2;27;.931;3568000;0
1786;1592;63;73;17;1;16;.941;3600000;0
1786;23493;51;0;0;0;0;.00nan;0;0
1786;31822;51;72;43;5;38;.884;3600000;0
1786;34814;63;0;0;0;0;.00nan;0;0
1787;780;52;0;0;0;0;.00nan;0;0
1787;19640;41;0;0;0;0;.00nan;0;0
1787;23075;41;87;31;2;29;.935;3748000;0
1787;32146;52;57;24;3;21;.875;3748000;0
1788;2796;59;0;0;0;0;.00nan;0;0
1788;4338;65;84;32;2;30;.938;3600000;0
1788;4987;65;0;0;0;0;.00nan;0;0
1788;31858;59;48;32;5;27;.844;3600000;0
1789;2163;39;0;0;0;0;.00nan;0;0
1789;2900;36;70;31;3;28;.903;3577000;0
1789;9238;39;63;22;2;20;.909;3600000;0
1789;14874;36;0;0;0;0;.00nan;0;0
1790;5298;55;0;0;0;0;.00nan;0;0
1790;28772;53;0;0;0;0;.00nan;0;0
1790;31156;53;70;43;4;39;.907;3900000;0
1790;34770;55;87;44;4;40;.909;3900000;0
1791;5137;58;38;22;4;18;.818;3549000;0
1791;6081;56;77;36;3;33;.917;3600000;0
1791;14321;58;0;0;0;0;.00nan;0;0
1791;26824;56;0;0;0;0;.00nan;0;0
1792;4447;54;92;47;3;44;.936;3600000;0
1792;31643;54;0;0;0;0;.00nan;0;0
1792;34788;42;0;0;0;0;.00nan;0;0
1792;37416;42;46;34;5;29;.853;3572000;0
1793;37;46;0;0;0;0;.00nan;0;0
1793;1486;43;0;0;0;0;.00nan;0;0
1793;2553;46;65;31;3;28;.903;3600000;0
1793;3625;43;42;23;5;18;.783;3551000;0
1794;3;50;60;22;2;20;.909;3600000;0
1794;751;64;0;0;0;0;.00nan;0;0
1794;5048;50;0;0;0;0;.00nan;0;0
1794;5146;64;66;31;3;28;.903;3552000;0
1795;2198;45;98;40;2;38;.950;3600000;0
1795;2296;37;0;0;0;0;.00nan;0;0
1795;5883;37;71;30;3;27;.900;3543000;0
1795;34786;45;0;0;0;0;.00nan;0;0
1796;2152;49;0;0;0;0;.00nan;0;0
1796;4435;49;49;22;4;18;.818;3900000;0
1796;6572;62;0;0;0;0;.00nan;0;0
1796;26919;62;76;40;4;36;.900;3900000;0
1797;1051;44;23;6;3;3;.500;539000;0
1797;3281;44;76;34;2;32;.941;3017000;0
1797;4716;4619;0;0;0;0;.00nan;0;0
1797;10698;4619;40;21;4;17;.810;3600000;0
1798;3626;48;0;0;0;0;.00nan;0;0
1798;21324;60;0;0;0;0;.00nan;0;0
1798;35536;60;50;23;4;19;.826;3547000;0
1798;38547;48;72;27;2;25;.926;3600000;0
1799;780;52;20;29;8;21;.724;3600000;0
1799;19640;41;63;31;3;28;.903;3600000;0
1799;23075;41;0;0;0;0;.00nan;0;0
1799;32146;52;0;0;0;0;.00nan;0;0
1800;3847;38;0;0;0;0;.00nan;0;0
1800;8046;57;0;0;0;0;.00nan;0;0
1800;26865;57;96;25;0;25;1.000;3600000;0
1800;31021;38;81;32;2;30;.938;3518000;0
1801;751;64;95;33;1;32;.970;3600000;0
1801;1486;43;65;23;2;21;.913;3587000;0
1801;3625;43;0;0;0;0;.00nan;0;0
1801;5146;64;0;0;0;0;.00nan;0;0
1802;2796;59;0;0;0;0;.00nan;0;0
1802;4338;65;0;0;0;0;.00nan;0;0
1802;4987;65;62;27;3;24;.889;3600000;0
1802;31858;59;67;49;6;43;.878;3600000;0
1803;2152;49;97;31;0;31;1.000;3600000;0
1803;4435;49;0;0;0;0;.00nan;0;0
1803;14351;40;0;0;0;0;.00nan;0;0
1803;26840;40;43;36;5;31;.861;3600000;0
1804;1051;44;50;20;3;17;.850;3547000;0
1804;3281;44;0;0;0;0;.00nan;0;0
1804;4716;4619;58;20;2;18;.900;3600000;0
1804;10698;4619;0;0;0;0;.00nan;0;0
1805;2016;61;40;26;4;22;.846;3542000;0
1805;7049;47;0;0;0;0;.00nan;0;0
1805;30971;61;0;0;0;0;.00nan;0;0
1805;33654;47;67;27;2;25;.926;3600000;0
1806;3;50;40;20;4;16;.800;3564000;0
1806;5048;50;0;0;0;0;.00nan;0;0
1806;34788;42;63;32;3;29;.906;3600000;0
1806;37416;42;0;0;0;0;.00nan;0;0
1807;19640;41;0;0;0;0;.00nan;0;0
1807;23075;41;80;35;3;32;.914;3900000;0
1807;28772;53;76;31;3;28;.903;3885000;0
1807;31156;53;0;0;0;0;.00nan;0;0
1808;780;52;0;0;0;0;.00nan;0;0
1808;4338;65;51;35;5;30;.857;3600000;0
1808;4987;65;0;0;0;0;.00nan;0;0
1808;32146;52;61;39;4;35;.897;3600000;0
1809;1592;63;62;29;3;26;.897;3600000;0
1809;6081;56;27;32;7;25;.781;3600000;0
1809;26824;56;0;0;0;0;.00nan;0;0
1809;34814;63;0;0;0;0;.00nan;0;0
1810;2163;39;0;0;0;0;.00nan;0;0
1810;5298;55;85;30;1;29;.967;3561000;0
1810;9238;39;98;26;0;26;1.000;3600000;0
1810;34770;55;0;0;0;0;.00nan;0;0
1811;2900;36;0;0;0;0;.00nan;0;0
1811;14874;36;75;28;2;26;.929;3579000;0
1811;23493;51;100;46;1;45;.978;3600000;0
1811;31822;51;0;0;0;0;.00nan;0;0
1812;2296;37;0;0;0;0;.00nan;0;0
1812;4447;54;0;0;0;0;.00nan;0;0
1812;5883;37;87;31;2;29;.935;3620000;0
1812;31643;54;72;20;1;19;.950;3620000;0
1813;37;46;46;19;3;16;.842;3866000;0
1813;751;64;0;0;0;0;.00nan;0;0
1813;2553;46;0;0;0;0;.00nan;0;0
1813;5146;64;81;32;2;30;.938;3866000;0
1814;1051;44;0;0;0;0;.00nan;0;0
1814;3281;44;44;29;5;24;.828;3600000;0
1814;21324;60;0;0;0;0;.00nan;0;0
1814;35536;60;72;24;2;22;.917;3600000;0
1815;3626;48;0;0;0;0;.00nan;0;0
1815;14351;40;55;38;5;33;.868;3600000;0
1815;26840;40;0;0;0;0;.00nan;0;0
1815;38547;48;73;21;1;20;.952;3600000;0
1816;2900;36;0;0;0;0;.00nan;0;0
1816;5298;55;0;0;0;0;.00nan;0;0
1816;14874;36;87;26;1;25;.962;3600000;0
1816;34770;55;47;26;4;22;.846;3600000;0
1817;37;46;64;22;2;20;.909;3900000;0
1817;2296;37;0;0;0;0;.00nan;0;0
1817;5883;37;66;23;2;21;.913;3900000;0
1817;26929;46;0;0;0;0;.00nan;0;0
1818;3;50;76;27;2;25;.926;3600000;0
1818;751;64;0;0;0;0;.00nan;0;0
1818;5048;50;0;0;0;0;.00nan;0;0
1818;5146;64;87;46;4;42;.913;3562000;0
1819;3847;38;0;0;0;0;.00nan;0;0
1819;28772;53;0;0;0;0;.00nan;0;0
1819;31021;38;85;25;1;24;.960;3600000;0
1819;31156;53;39;20;4;16;.800;3600000;0
1820;2796;59;0;0;0;0;.00nan;0;0
1820;8046;57;0;0;0;0;.00nan;0;0
1820;26865;57;72;38;3;35;.921;3900000;0
1820;31858;59;52;21;3;18;.857;3900000;0
1821;5137;58;0;0;0;0;.00nan;0;0
1821;14321;58;62;31;3;28;.903;3600000;0
1821;23493;51;93;40;2;38;.950;3600000;0
1821;31822;51;0;0;0;0;.00nan;0;0
1822;2163;39;51;20;2;18;.900;1854000;0
1822;6081;56;0;0;0;0;.00nan;0;0
1822;9238;39;23;23;6;17;.739;1664000;0
1822;26824;56;45;37;6;31;.838;3600000;0
1823;1486;43;71;36;3;33;.917;3515000;0
1823;3625;43;0;0;0;0;.00nan;0;0
1823;34788;42;62;17;1;16;.941;3600000;0
1823;37416;42;0;0;0;0;.00nan;0;0
1824;4447;54;0;0;0;0;.00nan;0;0
1824;4716;4619;69;27;2;25;.926;3600000;0
1824;10698;4619;0;0;0;0;.00nan;0;0
1824;31643;54;52;21;3;18;.857;3563000;0
1825;7049;47;0;0;0;0;.00nan;0;0
1825;14351;40;79;46;4;42;.913;3566000;0
1825;26840;40;0;0;0;0;.00nan;0;0
1825;33654;47;62;23;3;20;.870;3600000;0
1826;2152;49;61;34;4;30;.882;3600000;0
1826;3626;48;22;21;6;15;.714;3008000;0
1826;4435;49;0;0;0;0;.00nan;0;0
1826;38547;48;60;8;0;8;1.000;582000;0
1827;2016;61;61;26;3;23;.885;3900000;0
1827;6572;62;0;0;0;0;.00nan;0;0
1827;26919;62;65;29;3;26;.897;3900000;0
1827;30971;61;0;0;0;0;.00nan;0;0
1828;1051;44;0;0;0;0;.00nan;0;0
1828;3281;44;72;26;2;24;.923;3600000;0
1828;21324;60;0;0;0;0;.00nan;0;0
1828;35536;60;79;39;4;35;.897;3586000;0
1829;3;50;0;0;0;0;.00nan;0;0
1829;751;64;59;45;5;40;.889;3600000;0
1829;5048;50;100;34;0;34;1.000;3600000;0
1829;5146;64;0;0;0;0;.00nan;0;0
1830;2198;45;91;40;3;37;.925;3600000;0
1830;19640;41;52;44;6;38;.864;3600000;0
1830;23075;41;0;0;0;0;.00nan;0;0
1830;34786;45;0;0;0;0;.00nan;0;0
1831;2163;39;0;0;0;0;.00nan;0;0
1831;6081;56;21;3;3;0;.000;433000;0
1831;9238;39;94;19;0;19;1.000;3600000;0
1831;26824;56;80;31;2;29;.935;3167000;0
1832;23493;51;23;9;4;5;.556;655000;0
1832;28772;53;80;37;3;34;.919;3600000;0
1832;31156;53;0;0;0;0;.00nan;0;0
1832;31822;51;67;23;2;21;.913;2945000;0
1833;1592;63;0;0;0;0;.00nan;0;0
1833;4338;65;74;34;3;31;.912;3636000;0
1833;4987;65;0;0;0;0;.00nan;0;0
1833;34814;63;100;47;2;45;.957;3636000;0
1834;2900;36;0;0;0;0;.00nan;0;0
1834;5298;55;66;20;2;18;.900;3900000;0
1834;14874;36;100;37;2;35;.946;3900000;0
1834;34770;55;0;0;0;0;.00nan;0;0
1835;37;46;0;0;0;0;.00nan;0;0
1835;2296;37;69;31;2;29;.935;3869000;0
1835;5883;37;0;0;0;0;.00nan;0;0
1835;26929;46;67;29;3;26;.897;3868000;0
1836;1486;43;0;0;0;0;.00nan;0;0
1836;3625;43;92;21;0;21;1.000;3600000;0
1836;34788;42;0;0;0;0;.00nan;0;0
1836;37416;42;74;28;2;26;.929;3544000;0
1837;2796;59;0;0;0;0;.00nan;0;0
1837;8046;57;66;16;1;15;.938;3600000;0
1837;26865;57;0;0;0;0;.00nan;0;0
1837;31858;59;57;35;4;31;.886;3600000;0
1838;3847;38;76;29;2;27;.931;3600000;0
1838;5137;58;97;36;1;35;.972;3600000;0
1838;14321;58;0;0;0;0;.00nan;0;0
1838;31021;38;0;0;0;0;.00nan;0;0
1839;4447;54;67;33;3;30;.909;3600000;0
1839;4716;4619;0;0;0;0;.00nan;0;0
1839;10698;4619;89;19;0;19;1.000;3600000;0
1839;31643;54;0;0;0;0;.00nan;0;0
1840;7049;47;85;37;3;34;.919;3900000;0
1840;20717;60;0;0;0;0;.00nan;0;0
1840;33654;47;0;0;0;0;.00nan;0;0
1840;35536;60;63;27;3;24;.889;3900000;0
1841;2016;61;0;0;0;0;.00nan;0;0
1841;6572;62;81;35;3;32;.914;3559000;0
1841;26919;62;0;0;0;0;.00nan;0;0
1841;30971;61;58;20;2;18;.900;3600000;0
1842;1051;44;64;19;2;17;.895;3600000;0
1842;3281;44;0;0;0;0;.00nan;0;0
1842;14351;40;0;0;0;0;.00nan;0;0
1842;26840;40;68;33;3;30;.909;3538000;0
1843;2152;49;0;0;0;0;.00nan;0;0
1843;3626;48;0;0;0;0;.00nan;0;0
1843;4435;49;47;27;4;23;.852;3900000;0
1843;38547;48;55;32;4;28;.875;3900000;0
1844;2198;45;44;4;1;3;.750;259000;0
1844;19640;41;0;0;0;0;.00nan;0;0
1844;23075;41;72;27;2;25;.926;3600000;0
1844;34786;45;48;34;6;28;.824;3341000;0
1845;780;52;0;0;0;0;.00nan;0;0
1845;3847;38;0;0;0;0;.00nan;0;0
1845;31021;38;79;32;2;30;.938;3561000;0
1845;32146;52;69;20;1;19;.950;3600000;0
1846;1592;63;88;33;2;31;.939;3600000;0
1846;8046;57;0;0;0;0;.00nan;0;0
1846;26865;57;71;37;3;34;.919;3597000;0
1846;34814;63;0;0;0;0;.00nan;0;0
1847;2796;59;86;30;2;28;.933;3600000;0
1847;4338;65;0;0;0;0;.00nan;0;0
1847;4987;65;41;24;4;20;.833;3577000;0
1847;31858;59;0;0;0;0;.00nan;0;0
1848;2900;36;0;0;0;0;.00nan;0;0
1848;6081;56;0;0;0;0;.00nan;0;0
1848;14874;36;46;28;5;23;.821;3598000;0
1848;26824;56;58;30;4;26;.867;3600000;0
1849;751;64;17;28;7;21;.750;3600000;0
1849;5146;64;0;0;0;0;.00nan;0;0
1849;34788;42;83;30;2;28;.933;3600000;0
1849;37416;42;0;0;0;0;.00nan;0;0
1850;3;50;0;0;0;0;.00nan;0;0
1850;4447;54;0;0;0;0;.00nan;0;0
1850;5048;50;63;18;2;16;.889;3600000;0
1850;31643;54;78;32;3;29;.906;3600000;0
1851;2016;61;85;43;4;39;.907;3566000;0
1851;2152;49;77;34;2;32;.941;3600000;0
1851;4435;49;0;0;0;0;.00nan;0;0
1851;30971;61;0;0;0;0;.00nan;0;0
1852;5137;58;59;44;6;38;.864;3600000;0
1852;14321;58;0;0;0;0;.00nan;0;0
1852;19640;41;44;14;2;12;.857;3600000;0
1852;23075;41;0;0;0;0;.00nan;0;0
1853;37;46;57;25;3;22;.880;3698000;0
1853;1486;43;0;0;0;0;.00nan;0;0
1853;3625;43;78;31;2;29;.935;3698000;0
1853;26929;46;0;0;0;0;.00nan;0;0
1854;6572;62;0;0;0;0;.00nan;0;0
1854;20717;60;0;0;0;0;.00nan;0;0
1854;26919;62;53;22;3;19;.864;3600000;0
1854;35536;60;40;30;5;25;.833;3538000;0
1855;1592;63;0;0;0;0;.00nan;0;0
1855;28772;53;92;25;1;24;.960;3600000;0
1855;31156;53;0;0;0;0;.00nan;0;0
1855;34814;63;74;28;2;26;.929;3545000;0
1856;2796;59;0;0;0;0;.00nan;0;0
1856;8046;57;0;0;0;0;.00nan;0;0
1856;26865;57;50;27;5;22;.815;3600000;0
1856;31858;59;68;24;2;22;.917;3600000;0
1857;2163;39;0;0;0;0;.00nan;0;0
1857;2900;36;0;0;0;0;.00nan;0;0
1857;9238;39;89;34;2;32;.941;3880000;0
1857;14874;36;57;24;3;21;.875;3880000;0
1858;5298;55;0;0;0;0;.00nan;0;0
1858;23493;51;86;35;2;33;.943;3900000;0
1858;31822;51;0;0;0;0;.00nan;0;0
1858;34770;55;70;30;2;28;.933;3900000;0
1859;2198;45;84;36;3;33;.917;3552000;0
1859;4447;54;0;0;0;0;.00nan;0;0
1859;31643;54;94;34;2;32;.941;3600000;0
1859;34786;45;0;0;0;0;.00nan;0;0
1860;1051;44;0;0;0;0;.00nan;0;0
1860;3281;44;33;22;5;17;.773;3702000;0
1860;7049;47;0;0;0;0;.00nan;0;0
1860;33654;47;70;37;4;33;.892;3702000;0
1861;6572;62;49;31;4;27;.871;3569000;0
1861;14351;40;72;33;3;30;.909;3600000;0
1861;26840;40;0;0;0;0;.00nan;0;0
1861;26919;62;0;0;0;0;.00nan;0;0
1862;5137;58;0;0;0;0;.00nan;0;0
1862;14321;58;71;35;3;32;.914;3600000;0
1862;19640;41;80;14;0;14;1.000;3600000;0
1862;23075;41;0;0;0;0;.00nan;0;0
1863;2900;36;0;0;0;0;.00nan;0;0
1863;5298;55;58;31;3;28;.903;3560000;0
1863;14874;36;71;25;2;23;.920;3600000;0
1863;34770;55;0;0;0;0;.00nan;0;0
1864;1486;43;47;30;5;25;.833;3893000;0
1864;2163;39;0;0;0;0;.00nan;0;0
1864;3625;43;0;0;0;0;.00nan;0;0
1864;9238;39;31;25;5;20;.800;3900000;0
1865;6081;56;99;26;0;26;1.000;3600000;0
1865;23493;51;56;26;3;23;.885;3600000;0
1865;26824;56;0;0;0;0;.00nan;0;0
1865;31822;51;0;0;0;0;.00nan;0;0
1866;780;52;0;0;0;0;.00nan;0;0
1866;3847;38;0;0;0;0;.00nan;0;0
1866;31021;38;82;34;3;31;.912;3600000;0
1866;32146;52;98;25;0;25;1.000;3600000;0
1867;1592;63;0;0;0;0;.00nan;0;0
1867;2796;59;0;0;0;0;.00nan;0;0
1867;31858;59;70;37;4;33;.892;3600000;0
1867;34814;63;91;38;1;37;.974;3600000;0
1868;2198;45;90;32;2;30;.938;3600000;0
1868;34786;45;0;0;0;0;.00nan;0;0
1868;34788;42;13;20;6;14;.700;2657000;0
1868;37416;42;46;7;1;6;.857;943000;0
1869;3;50;76;19;1;18;.947;3600000;0
1869;5048;50;0;0;0;0;.00nan;0;0
1869;10698;4619;59;27;3;24;.889;3600000;0
1869;35210;4619;0;0;0;0;.00nan;0;0
1870;3626;48;76;25;2;23;.920;3600000;0
1870;14351;40;0;0;0;0;.00nan;0;0
1870;26840;40;24;21;5;16;.762;3600000;0
1870;38547;48;0;0;0;0;.00nan;0;0
1871;1486;43;0;0;0;0;.00nan;0;0
1871;2163;39;0;0;0;0;.00nan;0;0
1871;3625;43;69;25;2;23;.920;3684000;0
1871;9238;39;100;35;1;34;.971;3684000;0
1872;2296;37;0;0;0;0;.00nan;0;0
1872;5146;64;0;0;0;0;.00nan;0;0
1872;5883;37;74;24;1;23;.958;3600000;0
1872;33661;64;45;27;4;23;.852;3600000;0
1873;8046;57;0;0;0;0;.00nan;0;0
1873;19640;41;61;28;3;25;.893;3600000;0
1873;23075;41;0;0;0;0;.00nan;0;0
1873;26865;57;46;36;6;30;.833;3600000;0
1874;1592;63;34;12;3;9;.750;496000;0
1874;2796;59;0;0;0;0;.00nan;0;0
1874;31858;59;100;33;0;33;1.000;3600000;0
1874;34814;63;84;37;2;35;.946;3104000;0
1875;780;52;0;0;0;0;.00nan;0;0
1875;3847;38;33;29;6;23;.793;3600000;0
1875;31021;38;0;0;0;0;.00nan;0;0
1875;32146;52;66;28;3;25;.893;3600000;0
1876;4338;65;30;30;6;24;.800;3357000;0
1876;4987;65;41;2;1;1;.500;243000;0
1876;28772;53;19;27;6;21;.778;3600000;0
1876;31156;53;0;0;0;0;.00nan;0;0
1877;2900;36;75;39;3;36;.923;3600000;0
1877;5298;55;0;0;0;0;.00nan;0;0
1877;14874;36;0;0;0;0;.00nan;0;0
1877;34770;55;100;41;0;41;1.000;3600000;0
1878;6081;56;58;42;5;37;.881;3527000;0
1878;23493;51;94;45;3;42;.933;3600000;0
1878;26824;56;0;0;0;0;.00nan;0;0
1878;31822;51;0;0;0;0;.00nan;0;0
1879;37;46;79;38;3;35;.921;3600000;0
1879;2553;46;0;0;0;0;.00nan;0;0
1879;4447;54;0;0;0;0;.00nan;0;0
1879;31643;54;88;19;0;19;1.000;3600000;0
1880;2198;45;0;0;0;0;.00nan;0;0
1880;34786;45;91;35;3;32;.914;3900000;0
1880;34788;42;0;0;0;0;.00nan;0;0
1880;37416;42;67;30;3;27;.900;3900000;0
1881;1051;44;64;27;2;25;.926;2704000;0
1881;2152;49;0;0;0;0;.00nan;0;0
1881;3281;44;19;8;4;4;.500;896000;0
1881;4435;49;77;30;2;28;.933;3600000;0
1882;3626;48;0;0;0;0;.00nan;0;0
1882;14351;40;29;33;7;26;.788;3600000;0
1882;26840;40;0;0;0;0;.00nan;0;0
1882;38547;48;94;34;2;32;.941;3600000;0
1883;3;50;0;0;0;0;.00nan;0;0
1883;5048;50;42;25;4;21;.840;3534000;0
1883;10698;4619;0;0;0;0;.00nan;0;0
1883;35210;4619;85;34;2;32;.941;3600000;0
1884;7049;47;0;0;0;0;.00nan;0;0
1884;20717;60;0;0;0;0;.00nan;0;0
1884;33654;47;34;17;4;13;.765;3900000;0
1884;35536;60;53;35;4;31;.886;3900000;0
1885;2016;61;83;25;1;24;.960;3600000;0
1885;6572;62;0;0;0;0;.00nan;0;0
1885;26919;62;41;23;4;19;.826;3600000;0
1885;30971;61;0;0;0;0;.00nan;0;0
1886;8046;57;89;42;3;39;.929;3543000;0
1886;19640;41;0;0;0;0;.00nan;0;0
1886;23075;41;73;22;1;21;.955;3600000;0
1886;26865;57;0;0;0;0;.00nan;0;0
1887;780;52;59;30;4;26;.867;3560000;0
1887;5137;58;0;0;0;0;.00nan;0;0
1887;14321;58;87;40;2;38;.950;3600000;0
1887;32146;52;0;0;0;0;.00nan;0;0
1888;4338;65;0;0;0;0;.00nan;0;0
1888;4987;65;84;34;1;33;.971;3600000;0
1888;28772;53;0;0;0;0;.00nan;0;0
1888;31156;53;72;29;2;27;.931;3549000;0
1889;2296;37;40;28;5;23;.821;3900000;0
1889;5146;64;89;51;5;46;.902;3900000;0
1889;5883;37;0;0;0;0;.00nan;0;0
1889;33661;64;0;0;0;0;.00nan;0;0
1890;1051;44;0;0;0;0;.00nan;0;0
1890;2152;49;52;27;4;23;.852;3555000;0
1890;3281;44;78;27;2;25;.926;3600000;0
1890;4435;49;0;0;0;0;.00nan;0;0
1891;2016;61;0;0;0;0;.00nan;0;0
1891;6572;62;68;33;5;28;.848;3600000;0
1891;26919;62;0;0;0;0;.00nan;0;0
1891;30971;61;100;28;0;28;1.000;3600000;0
1892;7049;47;34;40;7;33;.825;3600000;0
1892;20717;60;62;23;3;20;.870;3600000;0
1892;33654;47;0;0;0;0;.00nan;0;0
1892;35536;60;0;0;0;0;.00nan;0;0
1893;2796;59;0;0;0;0;.00nan;0;0
1893;4338;65;34;34;6;28;.824;3600000;0
1893;4987;65;0;0;0;0;.00nan;0;0
1893;31858;59;71;17;1;16;.941;3600000;0
1894;2152;49;0;0;0;0;.00nan;0;0
1894;4435;49;48;27;4;23;.852;3795000;0
1894;20717;60;0;0;0;0;.00nan;0;0
1894;35536;60;63;23;3;20;.870;3795000;0
1895;1486;43;0;0;0;0;.00nan;0;0
1895;2900;36;0;0;0;0;.00nan;0;0
1895;3625;43;85;27;1;26;.963;3600000;0
1895;14874;36;49;17;3;14;.824;3563000;0
1896;3847;38;0;0;0;0;.00nan;0;0
1896;5298;55;0;0;0;0;.00nan;0;0
1896;31021;38;69;38;5;33;.868;3600000;0
1896;34770;55;78;29;2;27;.931;3600000;0
1897;37;46;85;42;4;38;.905;3600000;0
1897;2553;46;0;0;0;0;.00nan;0;0
1897;4447;54;0;0;0;0;.00nan;0;0
1897;31643;54;40;28;5;23;.821;3576000;0
1898;2198;45;53;39;5;34;.872;3572000;0
1898;5146;64;51;28;4;24;.857;3600000;0
1898;33661;64;0;0;0;0;.00nan;0;0
1898;34786;45;0;0;0;0;.00nan;0;0
1899;3;50;63;38;4;34;.895;3600000;0
1899;5048;50;0;0;0;0;.00nan;0;0
1899;34788;42;78;35;2;33;.943;3600000;0
1899;37416;42;0;0;0;0;.00nan;0;0
1900;1051;44;69;36;4;32;.889;3600000;0
1900;3281;44;0;0;0;0;.00nan;0;0
1900;7049;47;0;0;0;0;.00nan;0;0
1900;33654;47;30;24;5;19;.792;3597000;0
1901;5182;4619;55;21;3;18;.857;3600000;0
1901;6572;62;62;48;5;43;.896;3585000;0
1901;10698;4619;0;0;0;0;.00nan;0;0
1901;26919;62;0;0;0;0;.00nan;0;0
1902;3847;38;0;0;0;0;.00nan;0;0
1902;28772;53;100;24;0;24;1.000;3600000;0
1902;31021;38;83;31;2;29;.935;3565000;0
1902;31156;53;0;0;0;0;.00nan;0;0
1903;1486;43;66;29;3;26;.897;3600000;0
1903;2796;59;0;0;0;0;.00nan;0;0
1903;3625;43;0;0;0;0;.00nan;0;0
1903;31858;59;41;24;4;20;.833;3574000;0
1904;5298;55;0;0;0;0;.00nan;0;0
1904;19640;41;0;0;0;0;.00nan;0;0
1904;23075;41;86;28;1;27;.964;3600000;0
1904;34770;55;67;32;3;29;.906;3545000;0
1905;1592;63;68;24;2;22;.917;3900000;0
1905;6081;56;0;0;0;0;.00nan;0;0
1905;26824;56;96;38;2;36;.947;3900000;0
1905;34814;63;0;0;0;0;.00nan;0;0
1906;5137;58;0;0;0;0;.00nan;0;0
1906;8046;57;0;0;0;0;.00nan;0;0
1906;14321;58;71;32;3;29;.906;3600000;0
1906;26865;57;45;33;5;28;.848;3598000;0
1907;2163;39;0;0;0;0;.00nan;0;0
1907;2900;36;0;0;0;0;.00nan;0;0
1907;9238;39;61;19;2;17;.895;3600000;0
1907;14874;36;52;32;5;27;.844;3600000;0
1908;4447;54;54;17;2;15;.882;3600000;0
1908;31643;54;0;0;0;0;.00nan;0;0
1908;34788;42;60;35;4;31;.886;3519000;0
1908;37416;42;0;0;0;0;.00nan;0;0
1909;37;46;91;27;1;26;.963;3600000;0
1909;2553;46;0;0;0;0;.00nan;0;0
1909;5146;64;74;29;2;27;.931;3583000;0
1909;33661;64;0;0;0;0;.00nan;0;0
1910;2198;45;68;29;3;26;.897;3572000;0
1910;23493;51;100;42;2;40;.952;3600000;0
1910;31822;51;0;0;0;0;.00nan;0;0
1910;34786;45;0;0;0;0;.00nan;0;0
1911;3;50;65;21;1;20;.952;3600000;0
1911;5048;50;0;0;0;0;.00nan;0;0
1911;6572;62;79;37;3;34;.919;3589000;0
1911;26919;62;0;0;0;0;.00nan;0;0
1912;1051;44;68;27;2;25;.926;3600000;0
1912;3281;44;0;0;0;0;.00nan;0;0
1912;7049;47;0;0;0;0;.00nan;0;0
1912;33654;47;63;29;3;26;.897;3600000;0
1913;2152;49;0;0;0;0;.00nan;0;0
1913;4435;49;66;31;3;28;.903;3900000;0
1913;20717;60;0;0;0;0;.00nan;0;0
1913;35536;60;73;31;3;28;.903;3900000;0
1914;3626;48;88;30;1;29;.967;3820000;0
1914;5182;4619;74;25;2;23;.920;3820000;0
1914;10698;4619;0;0;0;0;.00nan;0;0
1914;38547;48;0;0;0;0;.00nan;0;0
1915;2016;61;0;0;0;0;.00nan;0;0
1915;2296;37;0;0;0;0;.00nan;0;0
1915;5883;37;69;29;2;27;.931;3900000;0
1915;30971;61;100;40;2;38;.950;3900000;0
1916;2163;39;0;0;0;0;.00nan;0;0
1916;5298;55;50;28;4;24;.857;3600000;0
1916;9238;39;73;20;1;19;.950;3600000;0
1916;34770;55;0;0;0;0;.00nan;0;0
1917;8046;57;93;33;1;32;.970;3600000;0
1917;26865;57;0;0;0;0;.00nan;0;0
1917;28772;53;83;34;2;32;.941;3600000;0
1917;31156;53;0;0;0;0;.00nan;0;0
1918;780;52;0;0;0;0;.00nan;0;0
1918;4338;65;37;20;4;16;.800;3789000;0
1918;4987;65;0;0;0;0;.00nan;0;0
1918;32146;52;70;44;5;39;.886;3789000;0
1919;2900;36;0;0;0;0;.00nan;0;0
1919;14874;36;93;31;1;30;.968;3900000;0
1919;19640;41;85;32;1;31;.969;3900000;0
1919;23075;41;0;0;0;0;.00nan;0;0
1920;1486;43;0;0;0;0;.00nan;0;0
1920;2796;59;0;0;0;0;.00nan;0;0
1920;3625;43;91;31;1;30;.968;3600000;0
1920;31858;59;53;24;2;22;.917;3560000;0
1921;1592;63;0;0;0;0;.00nan;0;0
1921;6081;56;94;35;1;34;.971;3600000;0
1921;26824;56;0;0;0;0;.00nan;0;0
1921;34814;63;15;34;8;26;.765;3600000;0
1922;37;46;54;13;2;11;.846;1436000;0
1922;2553;46;56;39;5;34;.872;2164000;0
1922;4447;54;0;0;0;0;.00nan;0;0
1922;31643;54;75;27;2;25;.926;3600000;0
1923;3;50;0;0;0;0;.00nan;0;0
1923;5048;50;35;28;5;23;.821;3581000;0
1923;6572;62;0;0;0;0;.00nan;0;0
1923;26919;62;72;36;4;32;.889;3600000;0
1924;3847;38;65;50;6;44;.880;3058000;0
1924;5137;58;71;20;1;19;.950;3600000;0
1924;14321;58;0;0;0;0;.00nan;0;0
1924;31021;38;44;14;3;11;.786;542000;0
1925;5146;64;0;0;0;0;.00nan;0;0
1925;33661;64;80;33;1;32;.970;3600000;0
1925;34788;42;73;24;2;22;.917;3600000;0
1925;37416;42;0;0;0;0;.00nan;0;0
1926;2198;45;0;0;0;0;.00nan;0;0
1926;23493;51;0;0;0;0;.00nan;0;0
1926;31822;51;98;52;4;48;.923;3530000;0
1926;34786;45;63;19;2;17;.895;3600000;0
1927;2152;49;52;26;4;22;.846;3600000;0
1927;4435;49;0;0;0;0;.00nan;0;0
1927;14351;40;100;44;0;44;1.000;3600000;0
1927;26840;40;0;0;0;0;.00nan;0;0
1928;1051;44;0;0;0;0;.00nan;0;0
1928;3281;44;43;17;3;14;.824;3600000;0
1928;7049;47;99;47;2;45;.957;3600000;0
1928;33654;47;0;0;0;0;.00nan;0;0
1929;3626;48;0;0;0;0;.00nan;0;0
1929;5182;4619;0;0;0;0;.00nan;0;0
1929;10698;4619;49;21;3;18;.857;3600000;0
1929;38547;48;47;32;5;27;.844;3535000;0
1930;2016;61;53;40;5;35;.875;3600000;0
1930;2296;37;61;20;2;18;.900;3600000;0
1930;5883;37;0;0;0;0;.00nan;0;0
1930;30971;61;0;0;0;0;.00nan;0;0
1931;4338;65;0;0;0;0;.00nan;0;0
1931;4987;65;38;37;6;31;.838;3600000;0
1931;8046;57;0;0;0;0;.00nan;0;0
1931;26865;57;99;20;0;20;1.000;3600000;0
1932;780;52;0;0;0;0;.00nan;0;0
1932;8046;57;0;0;0;0;.00nan;0;0
1932;26865;57;26;35;7;28;.800;3600000;0
1932;32146;52;88;27;1;26;.963;3600000;0
1933;4338;65;0;0;0;0;.00nan;0;0
1933;4987;65;60;44;6;38;.864;3696000;0
1933;28772;53;52;30;5;25;.833;3696000;0
1933;31156;53;0;0;0;0;.00nan;0;0
1934;5298;55;76;17;1;16;.941;3600000;0
1934;23493;51;83;45;4;41;.911;3600000;0
1934;31822;51;0;0;0;0;.00nan;0;0
1934;34770;55;0;0;0;0;.00nan;0;0
1935;2900;36;0;0;0;0;.00nan;0;0
1935;6081;56;0;0;0;0;.00nan;0;0
1935;14874;36;67;19;2;17;.895;3900000;0
1935;26824;56;93;40;2;38;.950;3900000;0
1936;2796;59;0;0;0;0;.00nan;0;0
1936;5137;58;0;0;0;0;.00nan;0;0
1936;14321;58;92;35;1;34;.971;3600000;0
1936;31858;59;75;28;2;26;.929;3562000;0
1937;2163;39;0;0;0;0;.00nan;0;0
1937;9238;39;71;28;2;26;.929;3600000;0
1937;19640;41;77;36;3;33;.917;3573000;0
1937;23075;41;0;0;0;0;.00nan;0;0
1938;4447;54;61;29;3;26;.897;3900000;0
1938;31643;54;0;0;0;0;.00nan;0;0
1938;34788;42;56;22;3;19;.864;3900000;0
1938;37416;42;0;0;0;0;.00nan;0;0
1939;5182;4619;93;38;2;36;.947;3600000;0
1939;6572;62;0;0;0;0;.00nan;0;0
1939;10698;4619;0;0;0;0;.00nan;0;0
1939;26919;62;63;41;5;36;.878;3600000;0
1940;3626;48;74;45;4;41;.911;3600000;0
1940;20717;60;71;20;1;19;.950;3600000;0
1940;35536;60;0;0;0;0;.00nan;0;0
1940;38547;48;0;0;0;0;.00nan;0;0
1941;1486;43;0;0;0;0;.00nan;0;0
1941;1592;63;0;0;0;0;.00nan;0;0
1941;3625;43;100;38;0;38;1.000;3600000;0
1941;34814;63;26;19;5;14;.737;3600000;0
1942;3626;48;0;0;0;0;.00nan;0;0
1942;20717;60;0;0;0;0;.00nan;0;0
1942;35536;60;87;35;2;33;.943;3600000;0
1942;38547;48;48;32;4;28;.875;3526000;0
1943;2016;61;0;0;0;0;.00nan;0;0
1943;14351;40;55;31;3;28;.903;3600000;0
1943;26840;40;0;0;0;0;.00nan;0;0
1943;30971;61;75;25;2;23;.920;3600000;0
1944;1486;43;0;0;0;0;.00nan;0;0
1944;3625;43;52;26;4;22;.846;3556000;0
1944;4338;65;0;0;0;0;.00nan;0;0
1944;4987;65;71;29;3;26;.897;3600000;0
1945;5298;55;0;0;0;0;.00nan;0;0
1945;23493;51;75;36;3;33;.917;3900000;0
1945;31822;51;0;0;0;0;.00nan;0;0
1945;34770;55;57;28;3;25;.893;3900000;0
1946;2900;36;0;0;0;0;.00nan;0;0
1946;6081;56;91;47;3;44;.936;3563000;0
1946;14874;36;62;13;1;12;.923;3600000;0
1946;26628;56;0;0;0;0;.00nan;0;0
1947;37;46;52;24;3;21;.875;3542000;0
1947;2152;49;72;23;1;22;.957;3600000;0
1947;2553;46;0;0;0;0;.00nan;0;0
1947;4435;49;0;0;0;0;.00nan;0;0
1948;3847;38;0;0;0;0;.00nan;0;0
1948;8046;57;90;48;3;45;.938;3600000;0
1948;26865;57;0;0;0;0;.00nan;0;0
1948;31021;38;91;22;0;22;1.000;3600000;0
1949;780;52;100;38;1;37;.974;3900000;0
1949;2796;59;0;0;0;0;.00nan;0;0
1949;31858;59;70;20;1;19;.950;3900000;0
1949;32146;52;0;0;0;0;.00nan;0;0
1950;5137;58;54;3;0;3;1.000;820000;0
1950;14321;58;13;25;7;18;.720;2780000;0
1950;28772;53;74;38;3;35;.921;3600000;0
1950;31156;53;0;0;0;0;.00nan;0;0
1951;2163;39;0;0;0;0;.00nan;0;0
1951;9238;39;71;32;3;29;.906;3600000;0
1951;19640;41;73;27;2;25;.926;3600000;0
1951;23075;41;0;0;0;0;.00nan;0;0
1952;2198;45;44;33;5;28;.848;3600000;0
1952;2296;37;0;0;0;0;.00nan;0;0
1952;5883;37;100;29;0;29;1.000;3600000;0
1952;34786;45;0;0;0;0;.00nan;0;0
1953;4447;54;0;0;0;0;.00nan;0;0
1953;5146;64;35;25;5;20;.800;3600000;0
1953;28845;64;0;0;0;0;.00nan;0;0
1953;31643;54;91;28;1;27;.964;3600000;0
1954;3;50;57;34;5;29;.853;3575000;0
1954;5048;50;0;0;0;0;.00nan;0;0
1954;34788;42;0;0;0;0;.00nan;0;0
1954;37416;42;80;37;3;34;.919;3600000;0
1955;7049;47;0;0;0;0;.00nan;0;0
1955;10698;4619;0;0;0;0;.00nan;0;0
1955;17360;4619;88;30;1;29;.967;3600000;0
1955;33654;47;61;36;5;31;.861;3600000;0
1956;1051;44;69;20;1;19;.950;3600000;0
1956;3281;44;0;0;0;0;.00nan;0;0
1956;6572;62;50;1;0;1;1.000;368000;0
1956;26919;62;32;37;6;31;.838;3232000;0
1957;2016;61;72;33;3;30;.909;3748000;0
1957;14351;40;0;0;0;0;.00nan;0;0
1957;26840;40;59;25;4;21;.840;3748000;0
1957;30971;61;0;0;0;0;.00nan;0;0
1958;1486;43;78;26;2;24;.923;3557000;0
1958;3625;43;0;0;0;0;.00nan;0;0
1958;4338;65;87;31;1;30;.968;3600000;0
1958;4987;65;0;0;0;0;.00nan;0;0
1959;1592;63;100;39;1;38;.974;3600000;0
1959;2163;39;50;29;4;25;.862;3600000;0
1959;9238;39;0;0;0;0;.00nan;0;0
1959;34814;63;0;0;0;0;.00nan;0;0
1960;2796;59;33;30;6;24;.800;2870000;0
1960;3847;38;0;0;0;0;.00nan;0;0
1960;31021;38;87;17;0;17;1.000;3600000;0
1960;31858;59;61;7;0;7;1.000;730000;0
1961;2900;36;79;32;3;29;.906;3586000;0
1961;14874;36;0;0;0;0;.00nan;0;0
1961;19640;41;0;0;0;0;.00nan;0;0
1961;23075;41;56;19;2;17;.895;3600000;0
1962;5137;58;0;0;0;0;.00nan;0;0
1962;5298;55;71;31;3;28;.903;3895000;0
1962;14321;58;96;46;2;44;.957;3895000;0
1962;34770;55;0;0;0;0;.00nan;0;0
1963;6081;56;0;0;0;0;.00nan;0;0
1963;14061;56;81;38;3;35;.921;3600000;0
1963;23493;51;0;0;0;0;.00nan;0;0
1963;31822;51;73;30;2;28;.933;3600000;0
1964;2198;45;0;0;0;0;.00nan;0;0
1964;2296;37;0;0;0;0;.00nan;0;0
1964;5883;37;71;22;1;21;.955;3600000;0
1964;34786;45;54;37;5;32;.865;3600000;0
1965;4447;54;75;23;1;22;.957;3600000;0
1965;5146;64;64;18;1;17;.944;2051000;0
1965;28845;64;31;24;5;19;.792;1549000;0
1965;31643;54;0;0;0;0;.00nan;0;0
1966;37;46;42;29;5;24;.828;2140000;0
1966;2152;49;0;0;0;0;.00nan;0;0
1966;2553;46;75;20;0;20;1.000;1460000;0
1966;4435;49;94;31;1;30;.968;3600000;0
1967;3;50;0;0;0;0;.00nan;0;0
1967;5048;50;78;29;2;27;.931;3600000;0
1967;34788;42;40;37;6;31;.838;3600000;0
1967;37416;42;0;0;0;0;.00nan;0;0
1968;780;52;0;0;0;0;.00nan;0;0
1968;8046;57;0;0;0;0;.00nan;0;0
1968;26865;57;100;39;0;39;1.000;3600000;0
1968;32146;52;85;28;1;27;.964;3568000;0
1969;7049;47;81;48;4;44;.917;3567000;0
1969;10698;4619;65;22;2;20;.909;3600000;0
1969;17360;4619;0;0;0;0;.00nan;0;0
1969;33654;47;0;0;0;0;.00nan;0;0
1970;1051;44;0;0;0;0;.00nan;0;0
1970;3281;44;50;26;4;22;.846;3870000;0
1970;6572;62;90;38;3;35;.921;3870000;0
1970;26919;62;0;0;0;0;.00nan;0;0
1971;3;50;57;24;3;21;.875;3600000;0
1971;37;46;44;24;4;20;.833;3547000;0
1971;2553;46;0;0;0;0;.00nan;0;0
1971;5048;50;0;0;0;0;.00nan;0;0
1972;5137;58;0;0;0;0;.00nan;0;0
1972;14321;58;52;35;5;30;.857;3590000;0
1972;28772;53;80;35;3;32;.914;3600000;0
1972;31156;53;0;0;0;0;.00nan;0;0
1973;780;52;0;0;0;0;.00nan;0;0
1973;19640;41;78;21;1;20;.952;3600000;0
1973;23075;41;0;0;0;0;.00nan;0;0
1973;32146;52;85;42;3;39;.929;3560000;0
1974;1486;43;0;0;0;0;.00nan;0;0
1974;3625;43;71;29;3;26;.897;3600000;0
1974;5298;55;0;0;0;0;.00nan;0;0
1974;34770;55;60;32;4;28;.875;3596000;0
1975;714;51;0;0;0;0;.00nan;0;0
1975;2900;36;0;0;0;0;.00nan;0;0
1975;14874;36;46;20;3;17;.850;3557000;0
1975;23493;51;81;27;1;26;.963;3600000;0
1976;2163;39;0;0;0;0;.00nan;0;0
1976;3847;38;0;0;0;0;.00nan;0;0
1976;9238;39;65;28;3;25;.893;3563000;0
1976;31021;38;70;25;1;24;.960;3600000;0
1977;4338;65;0;0;0;0;.00nan;0;0
1977;4987;65;66;27;3;24;.889;3900000;0
1977;8046;57;0;0;0;0;.00nan;0;0
1977;26865;57;67;28;3;25;.893;3900000;0
1978;2796;59;0;0;0;0;.00nan;0;0
1978;6081;56;89;42;3;39;.929;3514000;0
1978;14061;56;0;0;0;0;.00nan;0;0
1978;31858;59;74;24;1;23;.958;3600000;0
1979;5146;64;85;29;1;28;.966;3600000;0
1979;28845;64;0;0;0;0;.00nan;0;0
1979;34788;42;79;30;2;28;.933;3600000;0
1979;37416;42;0;0;0;0;.00nan;0;0
1980;2198;45;94;45;3;42;.933;3793000;0
1980;4447;54;0;0;0;0;.00nan;0;0
1980;31643;54;71;28;2;26;.929;3793000;0
1980;34786;45;0;0;0;0;.00nan;0;0
1981;3;50;0;0;0;0;.00nan;0;0
1981;37;46;50;36;6;30;.833;3600000;0
1981;2553;46;0;0;0;0;.00nan;0;0
1981;5048;50;62;19;2;17;.895;3600000;0
1982;1051;44;82;27;2;25;.926;3600000;0
1982;3281;44;0;0;0;0;.00nan;0;0
1982;10698;4619;0;0;0;0;.00nan;0;0
1982;17360;4619;67;33;3;30;.909;3600000;0
1983;3626;48;46;26;4;22;.846;3550000;0
1983;7049;47;0;0;0;0;.00nan;0;0
1983;33654;47;84;30;2;28;.933;3600000;0
1983;38547;48;0;0;0;0;.00nan;0;0
1984;6572;62;92;36;2;34;.944;3600000;0
1984;20717;60;50;25;4;21;.840;3582000;0
1984;26919;62;0;0;0;0;.00nan;0;0
1984;35536;60;0;0;0;0;.00nan;0;0
1985;2152;49;91;30;1;29;.967;3600000;0
1985;4435;49;0;0;0;0;.00nan;0;0
1985;14351;40;67;28;2;26;.929;3573000;0
1985;26840;40;0;0;0;0;.00nan;0;0
1986;2016;61;92;34;1;33;.971;3900000;0
1986;2296;37;0;0;0;0;.00nan;0;0
1986;5883;37;71;25;1;24;.960;3900000;0
1986;35538;61;0;0;0;0;.00nan;0;0
1987;714;51;58;24;3;21;.875;3900000;0
1987;2900;36;68;30;3;27;.900;3900000;0
1987;14874;36;0;0;0;0;.00nan;0;0
1987;23493;51;0;0;0;0;.00nan;0;0
1988;780;52;51;24;5;19;.792;3570000;0
1988;19640;41;0;0;0;0;.00nan;0;0
1988;23075;41;82;48;4;44;.917;3600000;0
1988;32146;52;0;0;0;0;.00nan;0;0
1989;2163;39;89;28;1;27;.964;3600000;0
1989;9238;39;0;0;0;0;.00nan;0;0
1989;28772;53;0;0;0;0;.00nan;0;0
1989;31156;53;62;39;4;35;.897;3600000;0
1990;4338;65;100;41;0;41;1.000;3600000;0
1990;4987;65;0;0;0;0;.00nan;0;0
1990;6081;56;0;0;0;0;.00nan;0;0
1990;14061;56;68;33;3;30;.909;3600000;0
1991;1486;43;88;36;2;34;.944;3600000;0
1991;3625;43;0;0;0;0;.00nan;0;0
1991;5298;55;74;39;3;36;.923;3557000;0
1991;34770;55;0;0;0;0;.00nan;0;0
1992;2796;59;44;4;1;3;.750;411000;0
1992;8046;57;89;28;1;27;.964;3600000;0
1992;26865;57;0;0;0;0;.00nan;0;0
1992;31858;59;51;38;5;33;.868;3189000;0
1993;3847;38;88;31;1;30;.968;3600000;0
1993;5137;58;34;16;4;12;.750;976000;0
1993;26622;58;54;24;3;21;.875;2624000;0
1993;31021;38;0;0;0;0;.00nan;0;0
1994;5146;64;0;0;0;0;.00nan;0;0
1994;28845;64;68;31;3;28;.903;3900000;0
1994;34788;42;0;0;0;0;.00nan;0;0
1994;37416;42;77;39;3;36;.923;3900000;0
1995;2198;45;0;0;0;0;.00nan;0;0
1995;4447;54;61;23;2;21;.913;3600000;0
1995;31643;54;0;0;0;0;.00nan;0;0
1995;34786;45;76;45;4;41;.911;3560000;0
1996;2152;49;0;0;0;0;.00nan;0;0
1996;4435;49;58;22;3;19;.864;3776000;0
1996;14351;40;0;0;0;0;.00nan;0;0
1996;26840;40;90;40;2;38;.950;3776000;0
1997;1051;44;0;0;0;0;.00nan;0;0
1997;3281;44;61;45;5;40;.889;3566000;0
1997;10698;4619;72;36;4;32;.889;3600000;0
1997;17360;4619;0;0;0;0;.00nan;0;0
1998;3626;48;0;0;0;0;.00nan;0;0
1998;7049;47;31;26;5;21;.808;3600000;0
1998;33654;47;0;0;0;0;.00nan;0;0
1998;38547;48;80;25;1;24;.960;3600000;0
1999;2016;61;0;0;0;0;.00nan;0;0
1999;2296;37;48;25;3;22;.880;3582000;0
1999;5883;37;0;0;0;0;.00nan;0;0
1999;35538;61;100;35;1;34;.971;3600000;0
2000;4447;54;0;0;0;0;.00nan;0;0
2000;5146;64;0;0;0;0;.00nan;0;0
2000;28845;64;81;29;1;28;.966;3600000;0
2000;35595;54;58;25;3;22;.880;3581000;0
2001;780;52;0;0;0;0;.00nan;0;0
2001;2163;39;0;0;0;0;.00nan;0;0
2001;9238;39;84;33;2;31;.939;3735000;0
2001;32146;52;85;35;3;32;.914;3735000;0
2002;2796;59;0;0;0;0;.00nan;0;0
2002;19640;41;75;40;3;37;.925;3554000;0
2002;23075;41;0;0;0;0;.00nan;0;0
2002;31858;59;72;25;2;23;.920;3600000;0
2003;37;46;0;0;0;0;.00nan;0;0
2003;2198;45;71;21;2;19;.905;3900000;0
2003;2553;46;79;26;2;24;.923;3900000;0
2003;34786;45;0;0;0;0;.00nan;0;0
2004;3626;48;51;40;6;34;.850;3600000;0
2004;10698;4619;0;0;0;0;.00nan;0;0
2004;17360;4619;71;27;2;25;.926;3600000;0
2004;38547;48;0;0;0;0;.00nan;0;0
2005;1592;63;0;0;0;0;.00nan;0;0
2005;5298;55;100;43;2;41;.953;3900000;0
2005;34770;55;0;0;0;0;.00nan;0;0
2005;34814;63;79;32;2;30;.938;3900000;0
2006;2796;59;48;0;0;0;.00nan;288000;0
2006;15437;41;0;0;0;0;.00nan;0;0
2006;19640;41;91;35;1;34;.971;3600000;0
2006;31858;59;15;24;7;17;.708;3312000;0
2007;714;51;0;0;0;0;.00nan;0;0
2007;6081;56;75;32;2;30;.938;3600000;0
2007;14061;56;0;0;0;0;.00nan;0;0
2007;23493;51;73;38;4;34;.895;3563000;0
2008;5137;58;0;0;0;0;.00nan;0;0
2008;8046;57;67;16;1;15;.938;3600000;0
2008;26622;58;72;40;3;37;.925;3592000;0
2008;26865;57;0;0;0;0;.00nan;0;0
2009;4447;54;62;25;2;23;.920;3900000;0
2009;34788;42;79;28;2;26;.929;3900000;0
2009;35595;54;0;0;0;0;.00nan;0;0
2009;37416;42;0;0;0;0;.00nan;0;0
2010;37;46;98;39;1;38;.974;3600000;0
2010;2198;45;0;0;0;0;.00nan;0;0
2010;2553;46;0;0;0;0;.00nan;0;0
2010;34786;45;100;27;0;27;1.000;3600000;0
2011;3626;48;0;0;0;0;.00nan;0;0
2011;10698;4619;63;28;3;25;.893;3580000;0
2011;17360;4619;0;0;0;0;.00nan;0;0
2011;38547;48;88;26;1;25;.962;3600000;0
2012;2016;61;83;25;1;24;.960;3600000;0
2012;7049;47;0;0;0;0;.00nan;0;0
2012;33654;47;43;28;5;23;.821;3600000;0
2012;35538;61;0;0;0;0;.00nan;0;0
2013;6572;62;0;0;0;0;.00nan;0;0
2013;20717;60;0;0;0;0;.00nan;0;0
2013;26919;62;58;28;3;25;.893;3573000;0
2013;35536;60;95;33;1;32;.970;3600000;0
2014;714;51;0;0;0;0;.00nan;0;0
2014;2900;36;0;0;0;0;.00nan;0;0
2014;14874;36;63;34;4;30;.882;3591000;0
2014;23493;51;64;28;3;25;.893;3600000;0
2015;2163;39;0;0;0;0;.00nan;0;0
2015;5298;55;0;0;0;0;.00nan;0;0
2015;9238;39;100;30;0;30;1.000;3600000;0
2015;34770;55;85;29;1;28;.966;3555000;0
2016;6081;56;61;21;2;19;.905;3546000;0
2016;14061;56;0;0;0;0;.00nan;0;0
2016;31994;63;98;38;1;37;.974;3600000;0
2016;34814;63;0;0;0;0;.00nan;0;0
2017;3847;38;0;0;0;0;.00nan;0;0
2017;4338;65;44;26;4;22;.846;3600000;0
2017;4987;65;0;0;0;0;.00nan;0;0
2017;31021;38;62;32;3;29;.906;3600000;0
2018;6081;56;0;0;0;0;.00nan;0;0
2018;14061;56;67;20;2;18;.900;3600000;0
2018;26967;63;0;0;0;0;.00nan;0;0
2018;34814;63;47;38;5;33;.868;3600000;0
2019;159;43;0;0;0;0;.00nan;0;0
2019;1486;43;58;25;3;22;.880;3563000;0
2019;19640;41;100;39;2;37;.949;3600000;0
2019;23075;41;0;0;0;0;.00nan;0;0
2020;2796;59;0;0;0;0;.00nan;0;0
2020;5137;58;0;0;0;0;.00nan;0;0
2020;26622;58;74;26;1;25;.962;3600000;0
2020;31858;59;50;35;5;30;.857;3600000;0
2021;904;53;0;0;0;0;.00nan;0;0
2021;22970;38;0;0;0;0;.00nan;0;0
2021;28772;53;76;20;1;19;.950;3600000;0
2021;31021;38;37;30;5;25;.833;3600000;0
2022;780;52;0;0;0;0;.00nan;0;0
2022;4338;65;0;0;0;0;.00nan;0;0
2022;4987;65;45;29;4;25;.862;3600000;0
2022;32146;52;63;15;1;14;.933;3600000;0
2023;2163;39;51;2;0;2;1.000;485000;0
2023;2900;36;78;38;3;35;.921;3600000;0
2023;9238;39;34;29;6;23;.793;3115000;0
2023;14874;36;0;0;0;0;.00nan;0;0
2024;37;46;89;22;0;22;1.000;3600000;0
2024;2553;46;0;0;0;0;.00nan;0;0
2024;34788;42;37;35;6;29;.829;3600000;0
2024;37416;42;0;0;0;0;.00nan;0;0
2025;5298;55;69;26;3;23;.885;3583000;0
2025;8046;57;0;0;0;0;.00nan;0;0
2025;26865;57;74;29;2;27;.931;3600000;0
2025;34770;55;0;0;0;0;.00nan;0;0
2026;3;50;77;27;1;26;.963;3600000;0
2026;2267;50;0;0;0;0;.00nan;0;0
2026;5146;64;0;0;0;0;.00nan;0;0
2026;28845;64;52;44;6;38;.864;3600000;0
2027;2198;45;63;35;4;31;.886;3576000;0
2027;20717;60;55;28;3;25;.893;3600000;0
2027;35536;60;0;0;0;0;.00nan;0;0
2027;35622;45;0;0;0;0;.00nan;0;0
2028;1051;44;44;28;5;23;.821;2754000;0
2028;3281;44;49;2;0;2;1.000;820000;0
2028;3626;48;69;41;4;37;.902;3600000;0
2028;38547;48;0;0;0;0;.00nan;0;0
2029;2016;61;78;24;1;23;.958;3600000;0
2029;10698;4619;0;0;0;0;.00nan;0;0
2029;17360;4619;51;19;2;17;.895;3556000;0
2029;30971;61;0;0;0;0;.00nan;0;0
2030;7049;47;33;23;5;18;.783;3600000;0
2030;14351;40;61;26;3;23;.885;3600000;0
2030;28712;40;0;0;0;0;.00nan;0;0
2030;42603;47;0;0;0;0;.00nan;0;0
2031;2152;49;89;28;1;27;.964;3600000;0
2031;4435;49;0;0;0;0;.00nan;0;0
2031;6572;62;48;31;5;26;.839;3600000;0
2031;26919;62;0;0;0;0;.00nan;0;0
2032;159;43;0;0;0;0;.00nan;0;0
2032;1486;43;71;31;3;28;.903;3600000;0
2032;19640;41;0;0;0;0;.00nan;0;0
2032;23075;41;65;41;4;37;.902;3563000;0
2033;780;52;38;32;6;26;.813;3552000;0
2033;904;53;0;0;0;0;.00nan;0;0
2033;28772;53;62;30;4;26;.867;3600000;0
2033;32146;52;0;0;0;0;.00nan;0;0
2034;2296;37;58;19;2;17;.895;3600000;0
2034;4447;54;0;0;0;0;.00nan;0;0
2034;23043;37;0;0;0;0;.00nan;0;0
2034;31643;54;59;29;4;25;.862;3552000;0
2035;4338;65;0;0;0;0;.00nan;0;0
2035;4987;65;97;38;1;37;.974;3545000;0
2035;22970;38;100;29;0;29;1.000;3600000;0
2035;31021;38;0;0;0;0;.00nan;0;0
2036;5137;58;87;43;4;39;.907;3600000;0
2036;8046;57;37;27;5;22;.815;3582000;0
2036;26622;58;0;0;0;0;.00nan;0;0
2036;26865;57;0;0;0;0;.00nan;0;0
2037;2163;39;43;30;5;25;.833;3568000;0
2037;9238;39;0;0;0;0;.00nan;0;0
2037;23493;51;75;37;3;34;.919;3600000;0
2037;31822;51;0;0;0;0;.00nan;0;0
2038;3;50;0;0;0;0;.00nan;0;0
2038;2267;50;89;17;0;17;1.000;3600000;0
2038;5146;64;50;36;5;31;.861;3600000;0
2038;28845;64;0;0;0;0;.00nan;0;0
2039;37;46;92;40;2;38;.950;3546000;0
2039;2553;46;0;0;0;0;.00nan;0;0
2039;34788;42;0;0;0;0;.00nan;0;0
2039;37416;42;80;25;1;24;.960;3600000;0
2040;2016;61;0;0;0;0;.00nan;0;0
2040;10698;4619;72;36;3;33;.917;3600000;0
2040;17360;4619;0;0;0;0;.00nan;0;0
2040;30971;61;54;31;4;27;.871;3544000;0
2041;2198;45;0;0;0;0;.00nan;0;0
2041;20717;60;0;0;0;0;.00nan;0;0
2041;35536;60;99;43;2;41;.953;3600000;0
2041;35622;45;39;20;4;16;.800;3581000;0
2042;2152;49;0;0;0;0;.00nan;0;0
2042;4435;49;53;18;2;16;.889;3600000;0
2042;6572;62;53;33;6;27;.818;3600000;0
2042;26919;62;0;0;0;0;.00nan;0;0
2043;7049;47;0;0;0;0;.00nan;0;0
2043;14351;40;0;0;0;0;.00nan;0;0
2043;26840;40;63;27;3;24;.889;3566000;0
2043;42603;47;83;29;2;27;.931;3600000;0
2044;23493;51;0;0;0;0;.00nan;0;0
2044;26967;63;47;26;4;22;.846;3600000;0
2044;31822;51;100;27;0;27;1.000;3600000;0
2044;34814;63;0;0;0;0;.00nan;0;0
2045;2900;36;37;6;2;4;.667;380000;0
2045;6081;56;81;36;2;34;.944;3600000;0
2045;14061;56;0;0;0;0;.00nan;0;0
2045;14874;36;41;35;6;29;.829;3220000;0
2046;2296;37;0;0;0;0;.00nan;0;0
2046;4447;54;76;22;1;21;.955;3600000;0
2046;23043;37;98;46;2;44;.957;3544000;0
2046;31643;54;0;0;0;0;.00nan;0;0
2047;1051;44;60;19;3;16;.842;3600000;0
2047;3281;44;0;0;0;0;.00nan;0;0
2047;3626;48;54;41;7;34;.829;3600000;0
2047;38547;48;0;0;0;0;.00nan;0;0
2048;3;50;0;0;0;0;.00nan;0;0
2048;2198;45;84;36;2;34;.944;3574000;0
2048;2267;50;76;24;1;23;.958;3600000;0
2048;35622;45;0;0;0;0;.00nan;0;0
2049;23493;51;0;0;0;0;.00nan;0;0
2049;26967;63;0;0;0;0;.00nan;0;0
2049;31822;51;72;25;2;23;.920;3600000;0
2049;34814;63;84;50;4;46;.920;3554000;0
2050;37;46;57;25;3;22;.880;3900000;0
2050;1486;43;0;0;0;0;.00nan;0;0
2050;2553;46;0;0;0;0;.00nan;0;0
2050;3625;43;71;35;3;32;.914;3900000;0
2051;2796;59;0;0;0;0;.00nan;0;0
2051;8046;57;0;0;0;0;.00nan;0;0
2051;26865;57;100;25;0;25;1.000;3600000;0
2051;31858;59;98;41;2;39;.951;3599000;0
2052;780;52;0;0;0;0;.00nan;0;0
2052;5137;58;0;0;0;0;.00nan;0;0
2052;26622;58;79;28;1;27;.964;3600000;0
2052;32146;52;72;41;5;36;.878;3600000;0
2053;2296;37;40;29;5;24;.828;2991000;0
2053;4447;54;0;0;0;0;.00nan;0;0
2053;5883;37;20;10;4;6;.600;609000;0
2053;31643;54;68;30;3;27;.900;3600000;0
2054;20717;60;49;1;0;1;1.000;363000;0
2054;25787;47;0;0;0;0;.00nan;0;0
2054;33654;47;78;35;3;32;.914;3600000;0
2054;35536;60;61;43;7;36;.837;3237000;0
2055;2152;49;73;30;2;28;.933;3600000;0
2055;3626;48;74;36;3;33;.917;3559000;0
2055;4435;49;0;0;0;0;.00nan;0;0
2055;38547;48;0;0;0;0;.00nan;0;0
2056;3;50;95;23;0;23;1.000;3600000;0
2056;2198;45;0;0;0;0;.00nan;0;0
2056;5048;50;0;0;0;0;.00nan;0;0
2056;34786;45;74;41;4;37;.902;3600000;0
2057;2163;39;0;0;0;0;.00nan;0;0
2057;2900;36;0;0;0;0;.00nan;0;0
2057;9238;39;65;33;3;30;.909;3900000;0
2057;14874;36;66;30;3;27;.900;3900000;0
2058;1486;43;0;0;0;0;.00nan;0;0
2058;2841;57;0;0;0;0;.00nan;0;0
2058;3625;43;70;20;2;18;.900;3600000;0
2058;8046;57;65;29;3;26;.897;3523000;0
2059;4338;65;0;0;0;0;.00nan;0;0
2059;4987;65;92;20;0;20;1.000;3600000;0
2059;5298;55;0;0;0;0;.00nan;0;0
2059;34770;55;72;21;1;20;.952;3565000;0
2060;6081;56;54;23;3;20;.870;3600000;0
2060;14061;56;0;0;0;0;.00nan;0;0
2060;23493;51;38;28;5;23;.821;3600000;0
2060;31822;51;0;0;0;0;.00nan;0;0
2061;37;46;75;22;2;20;.909;3900000;0
2061;2553;46;0;0;0;0;.00nan;0;0
2061;25787;47;0;0;0;0;.00nan;0;0
2061;33654;47;79;33;2;31;.939;3900000;0
2062;3847;38;0;0;0;0;.00nan;0;0
2062;19640;41;65;23;2;21;.913;3600000;0
2062;23075;41;0;0;0;0;.00nan;0;0
2062;31021;38;59;26;3;23;.885;3584000;0
2063;5137;58;0;0;0;0;.00nan;0;0
2063;26622;58;100;41;1;40;.976;3600000;0
2063;28772;53;51;17;2;15;.882;3544000;0
2063;31156;53;0;0;0;0;.00nan;0;0
2064;3;50;89;35;2;33;.943;3600000;0
2064;5048;50;0;0;0;0;.00nan;0;0
2064;34788;42;43;32;5;27;.844;3600000;0
2064;37416;42;0;0;0;0;.00nan;0;0
2065;3626;48;64;23;3;20;.870;3600000;0
2065;6572;62;71;41;4;37;.902;3590000;0
2065;26919;62;0;0;0;0;.00nan;0;0
2065;38547;48;0;0;0;0;.00nan;0;0
2066;2016;61;63;27;3;24;.889;3549000;0
2066;14351;40;0;0;0;0;.00nan;0;0
2066;26840;40;73;31;2;29;.935;3600000;0
2066;30971;61;0;0;0;0;.00nan;0;0
2067;1486;43;53;34;5;29;.853;3600000;0
2067;2841;57;98;35;1;34;.971;3600000;0
2067;3625;43;0;0;0;0;.00nan;0;0
2067;8046;57;0;0;0;0;.00nan;0;0
2068;6081;56;0;0;0;0;.00nan;0;0
2068;14061;56;72;33;3;30;.909;3571000;0
2068;23493;51;0;0;0;0;.00nan;0;0
2068;31822;51;81;27;2;25;.926;3600000;0
2069;2296;37;0;0;0;0;.00nan;0;0
2069;5146;64;81;30;2;28;.933;3600000;0
2069;5883;37;53;23;3;20;.870;3547000;0
2069;28845;64;0;0;0;0;.00nan;0;0
2070;1592;63;98;43;2;41;.953;3600000;0
2070;2163;39;88;25;1;24;.960;3600000;0
2070;9238;39;0;0;0;0;.00nan;0;0
2070;34814;63;0;0;0;0;.00nan;0;0
2071;3847;38;51;26;4;22;.846;3600000;0
2071;28772;53;0;0;0;0;.00nan;0;0
2071;31021;38;0;0;0;0;.00nan;0;0
2071;31156;53;51;40;5;35;.875;3580000;0
2072;780;52;0;0;0;0;.00nan;0;0
2072;2796;59;0;0;0;0;.00nan;0;0
2072;31858;59;63;29;3;26;.897;3600000;0
2072;32146;52;66;35;4;31;.886;3600000;0
2073;2900;36;67;28;3;25;.893;3600000;0
2073;5298;55;62;25;4;21;.840;3595000;0
2073;14874;36;0;0;0;0;.00nan;0;0
2073;34770;55;0;0;0;0;.00nan;0;0
2074;4447;54;0;0;0;0;.00nan;0;0
2074;5182;4619;58;30;3;27;.900;3900000;0
2074;17360;4619;0;0;0;0;.00nan;0;0
2074;31643;54;75;39;3;36;.923;3900000;0
2075;37;46;0;0;0;0;.00nan;0;0
2075;2553;46;100;37;0;37;1.000;3600000;0
2075;25787;47;55;33;4;29;.879;3600000;0
2075;33654;47;0;0;0;0;.00nan;0;0
2076;2198;45;66;32;3;29;.906;3640000;0
2076;34786;45;0;0;0;0;.00nan;0;0
2076;34788;42;0;0;0;0;.00nan;0;0
2076;37416;42;51;29;4;25;.862;3665000;0
2077;5137;58;61;13;1;12;.923;3600000;0
2077;6847;58;0;0;0;0;.00nan;0;0
2077;19640;41;98;23;0;23;1.000;3184000;0
2077;23075;41;25;6;3;3;.500;387000;0
2078;1051;44;55;38;5;33;.868;3600000;0
2078;2152;49;0;0;0;0;.00nan;0;0
2078;3281;44;0;0;0;0;.00nan;0;0
2078;4435;49;29;25;6;19;.760;3552000;0
2079;3626;48;0;0;0;0;.00nan;0;0
2079;6572;62;94;34;1;33;.971;3900000;0
2079;26919;62;0;0;0;0;.00nan;0;0
2079;38547;48;95;33;1;32;.970;3900000;0
2080;780;52;54;23;2;21;.913;3600000;0
2080;19640;41;0;0;0;0;.00nan;0;0
2080;23075;41;65;29;3;26;.897;3572000;0
2080;32146;52;0;0;0;0;.00nan;0;0
2081;2296;37;62;24;2;22;.917;3900000;0
2081;5146;64;0;0;0;0;.00nan;0;0
2081;5883;37;0;0;0;0;.00nan;0;0
2081;28845;64;91;34;2;32;.941;3900000;0
2082;3847;38;0;0;0;0;.00nan;0;0
2082;28772;53;47;35;5;30;.857;3558000;0
2082;31021;38;64;25;3;22;.880;3600000;0
2082;31156;53;0;0;0;0;.00nan;0;0
2083;2796;59;70;31;2;29;.935;3577000;0
2083;2900;36;0;0;0;0;.00nan;0;0
2083;14874;36;74;24;1;23;.958;3600000;0
2083;31858;59;0;0;0;0;.00nan;0;0
2084;1592;63;0;0;0;0;.00nan;0;0
2084;2163;39;0;0;0;0;.00nan;0;0
2084;9238;39;89;41;3;38;.927;3554000;0
2084;34814;63;76;26;1;25;.962;3600000;0
2085;4447;54;64;31;4;27;.871;3623000;0
2085;5182;4619;0;0;0;0;.00nan;0;0
2085;17360;4619;91;42;3;39;.929;3623000;0
2085;31643;54;0;0;0;0;.00nan;0;0
2086;4338;65;0;0;0;0;.00nan;0;0
2086;4987;65;56;28;4;24;.857;3900000;0
2086;5298;55;0;0;0;0;.00nan;0;0
2086;34770;55;57;40;4;36;.900;3900000;0
2087;2198;45;0;0;0;0;.00nan;0;0
2087;34786;45;84;37;2;35;.946;3555000;0
2087;34788;42;80;21;1;20;.952;3600000;0
2087;37416;42;0;0;0;0;.00nan;0;0
2088;1051;44;0;0;0;0;.00nan;0;0
2088;2152;49;87;18;0;18;1.000;3600000;0
2088;3281;44;76;32;2;30;.938;3550000;0
2088;4435;49;0;0;0;0;.00nan;0;0
2089;2016;61;83;33;2;31;.939;3600000;0
2089;14351;40;0;0;0;0;.00nan;0;0
2089;26840;40;54;35;4;31;.886;3515000;0
2089;30971;61;0;0;0;0;.00nan;0;0
2090;1486;43;0;0;0;0;.00nan;0;0
2090;3625;43;76;40;4;36;.900;3627000;0
2090;23493;51;75;32;3;29;.906;3627000;0
2090;31822;51;0;0;0;0;.00nan;0;0
2091;4338;65;78;32;3;29;.906;3900000;0
2091;4987;65;0;0;0;0;.00nan;0;0
2091;19640;41;85;41;3;38;.927;3900000;0
2091;23075;41;0;0;0;0;.00nan;0;0
2092;1592;63;89;22;0;22;1.000;3900000;0
2092;2016;61;99;21;0;21;1.000;3900000;0
2092;30971;61;0;0;0;0;.00nan;0;0
2092;34814;63;0;0;0;0;.00nan;0;0
2093;2841;57;0;0;0;0;.00nan;0;0
2093;3847;38;0;0;0;0;.00nan;0;0
2093;8046;57;62;15;2;13;.867;3600000;0
2093;31021;38;54;32;4;28;.875;3528000;0
2094;2163;39;0;0;0;0;.00nan;0;0
2094;2900;36;0;0;0;0;.00nan;0;0
2094;9238;39;65;34;4;30;.882;3600000;0
2094;14874;36;91;31;1;30;.968;3600000;0
2095;1486;43;84;31;2;29;.935;3600000;0
2095;3625;43;0;0;0;0;.00nan;0;0
2095;23493;51;57;27;3;24;.889;3564000;0
2095;31822;51;0;0;0;0;.00nan;0;0
2096;2198;45;71;30;3;27;.900;3600000;0
2096;5146;64;0;0;0;0;.00nan;0;0
2096;28845;64;92;33;2;31;.939;3600000;0
2096;34786;45;0;0;0;0;.00nan;0;0
2097;5182;4619;53;18;2;16;.889;3881000;0
2097;6572;62;0;0;0;0;.00nan;0;0
2097;17360;4619;0;0;0;0;.00nan;0;0
2097;26919;62;84;43;3;40;.930;3881000;0
2098;1051;44;70;32;4;28;.875;3544000;0
2098;2152;49;77;30;2;28;.933;3600000;0
2098;3281;44;0;0;0;0;.00nan;0;0
2098;4435;49;0;0;0;0;.00nan;0;0
2099;2296;37;0;0;0;0;.00nan;0;0
2099;5883;37;57;27;4;23;.852;3600000;0
2099;34788;42;90;32;1;31;.969;3600000;0
2099;37416;42;0;0;0;0;.00nan;0;0
2100;780;52;0;0;0;0;.00nan;0;0
2100;2796;59;0;0;0;0;.00nan;0;0
2100;31858;59;75;32;3;29;.906;3900000;0
2100;32146;52;64;29;3;26;.897;3883000;0
2101;2900;36;0;0;0;0;.00nan;0;0
2101;5298;55;0;0;0;0;.00nan;0;0
2101;14874;36;62;25;2;23;.920;3574000;0
2101;34770;55;96;40;1;39;.975;3600000;0
2102;2163;39;0;0;0;0;.00nan;0;0
2102;6081;56;67;38;4;34;.895;3526000;0
2102;9238;39;68;27;2;25;.926;3600000;0
2102;14061;56;0;0;0;0;.00nan;0;0
2103;2016;61;84;29;1;28;.966;3600000;0
2103;23493;51;64;40;5;35;.875;3600000;0
2103;30971;61;0;0;0;0;.00nan;0;0
2103;31822;51;0;0;0;0;.00nan;0;0
2104;3;50;80;30;1;29;.967;3600000;0
2104;37;46;0;0;0;0;.00nan;0;0
2104;2553;46;50;22;3;19;.864;3524000;0
2104;5048;50;0;0;0;0;.00nan;0;0
2105;8046;57;0;0;0;0;.00nan;0;0
2105;19640;41;53;51;7;44;.863;3600000;0
2105;23075;41;0;0;0;0;.00nan;0;0
2105;26865;57;67;27;4;23;.852;3600000;0
2106;4338;65;90;19;0;19;1.000;3600000;0
2106;4987;65;0;0;0;0;.00nan;0;0
2106;5137;58;0;0;0;0;.00nan;0;0
2106;6847;58;80;43;3;40;.930;3600000;0
2107;2198;45;92;49;3;46;.939;3626000;0
2107;4447;54;68;24;2;22;.917;3626000;0
2107;31643;54;0;0;0;0;.00nan;0;0
2107;34786;45;0;0;0;0;.00nan;0;0
2108;6572;62;0;0;0;0;.00nan;0;0
2108;10698;4619;0;0;0;0;.00nan;0;0
2108;17360;4619;54;15;2;13;.867;3600000;0
2108;26919;62;66;37;3;34;.919;3600000;0
2109;2152;49;78;23;1;22;.957;3600000;0
2109;3626;48;97;43;2;41;.953;3595000;0
2109;4435;49;0;0;0;0;.00nan;0;0
2109;38547;48;0;0;0;0;.00nan;0;0
2110;14351;40;72;21;2;19;.905;3600000;0
2110;25787;47;0;0;0;0;.00nan;0;0
2110;26840;40;0;0;0;0;.00nan;0;0
2110;33654;47;74;37;3;34;.919;3582000;0
2111;2016;61;0;0;0;0;.00nan;0;0
2111;23493;51;0;0;0;0;.00nan;0;0
2111;30971;61;93;34;1;33;.971;3600000;0
2111;31822;51;68;35;4;31;.886;3600000;0
2112;2296;37;0;0;0;0;.00nan;0;0
2112;5883;37;73;37;3;34;.919;3600000;0
2112;34788;42;44;32;5;27;.844;3563000;0
2112;37416;42;0;0;0;0;.00nan;0;0
2113;780;52;88;26;1;25;.962;3600000;0
2113;2796;59;0;0;0;0;.00nan;0;0
2113;31858;59;36;20;4;16;.800;3600000;0
2113;32146;52;0;0;0;0;.00nan;0;0
2114;2900;36;25;27;6;21;.778;2995000;0
2114;5298;55;84;36;3;33;.917;3600000;0
2114;14874;36;48;7;1;6;.857;605000;0
2114;34770;55;0;0;0;0;.00nan;0;0
2115;1486;43;0;0;0;0;.00nan;0;0
2115;1592;63;100;28;0;28;1.000;3600000;0
2115;3625;43;53;30;4;26;.867;3600000;0
2115;34814;63;0;0;0;0;.00nan;0;0
2116;2163;39;80;26;2;24;.923;3900000;0
2116;6081;56;0;0;0;0;.00nan;0;0
2116;9238;39;0;0;0;0;.00nan;0;0
2116;14061;56;73;33;2;31;.939;3900000;0
2117;3;50;0;0;0;0;.00nan;0;0
2117;37;46;74;44;4;40;.909;3600000;0
2117;2553;46;0;0;0;0;.00nan;0;0
2117;5048;50;47;31;5;26;.839;3574000;0
2118;8046;57;59;25;3;22;.880;3600000;0
2118;19640;41;0;0;0;0;.00nan;0;0
2118;23075;41;78;28;2;26;.929;3600000;0
2118;26865;57;0;0;0;0;.00nan;0;0
2119;3847;38;0;0;0;0;.00nan;0;0
2119;5137;58;0;0;0;0;.00nan;0;0
2119;6847;58;40;40;6;34;.850;3600000;0
2119;31021;38;62;19;1;18;.947;3600000;0
2120;4338;65;0;0;0;0;.00nan;0;0
2120;4987;65;70;35;3;32;.914;3579000;0
2120;28772;53;69;25;2;23;.920;3600000;0
2120;31156;53;0;0;0;0;.00nan;0;0
2121;751;64;51;16;2;14;.875;1448000;0
2121;2198;45;0;0;0;0;.00nan;0;0
2121;5146;64;30;16;4;12;.750;2152000;0
2121;34786;45;98;43;2;41;.953;3600000;0
2122;2152;49;0;0;0;0;.00nan;0;0
2122;3626;48;0;0;0;0;.00nan;0;0
2122;4435;49;70;23;2;21;.913;3600000;0
2122;38547;48;36;28;6;22;.786;3600000;0
2123;14351;40;0;0;0;0;.00nan;0;0
2123;20717;60;0;0;0;0;.00nan;0;0
2123;26840;40;28;25;5;20;.800;3550000;0
2123;35536;60;72;38;4;34;.895;3600000;0
2124;6572;62;84;32;2;30;.938;3561000;0
2124;10698;4619;84;24;1;23;.958;3600000;0
2124;17360;4619;0;0;0;0;.00nan;0;0
2124;26919;62;0;0;0;0;.00nan;0;0
2125;1051;44;71;29;3;26;.897;3600000;0
2125;3281;44;0;0;0;0;.00nan;0;0
2125;25787;47;61;35;4;31;.886;3572000;0
2125;33654;47;0;0;0;0;.00nan;0;0
2126;780;52;0;0;0;0;.00nan;0;0
2126;28772;53;0;0;0;0;.00nan;0;0
2126;31156;53;65;32;3;29;.906;3900000;0
2126;32146;52;99;49;3;46;.939;3900000;0
2127;2796;59;0;0;0;0;.00nan;0;0
2127;3847;38;100;26;0;26;1.000;3600000;0
2127;31021;38;0;0;0;0;.00nan;0;0
2127;31858;59;58;29;4;25;.862;3600000;0
2128;3;50;89;30;2;28;.933;3600000;0
2128;751;64;0;0;0;0;.00nan;0;0
2128;5048;50;0;0;0;0;.00nan;0;0
2128;5146;64;46;26;4;22;.846;3540000;0
2129;37;46;0;0;0;0;.00nan;0;0
2129;2553;46;92;55;4;51;.927;3820000;0
2129;4447;54;0;0;0;0;.00nan;0;0
2129;31643;54;50;21;3;18;.857;3820000;0
2130;1051;44;79;36;2;34;.944;3600000;0
2130;3281;44;0;0;0;0;.00nan;0;0
2130;20717;60;77;23;1;22;.957;3600000;0
2130;35536;60;0;0;0;0;.00nan;0;0
2131;1592;63;89;32;1;31;.969;3600000;0
2131;2016;61;58;26;3;23;.885;3534000;0
2131;30971;61;0;0;0;0;.00nan;0;0
2131;34814;63;0;0;0;0;.00nan;0;0
2132;3;50;99;45;1;44;.978;3600000;0
2132;4447;54;0;0;0;0;.00nan;0;0
2132;5048;50;0;0;0;0;.00nan;0;0
2132;31643;54;52;27;4;23;.852;3600000;0
2133;2900;36;0;0;0;0;.00nan;0;0
2133;5298;55;0;0;0;0;.00nan;0;0
2133;14874;36;64;27;3;24;.889;3579000;0
2133;34770;55;99;35;1;34;.971;3600000;0
2134;37;46;53;30;4;26;.867;3600000;0
2134;751;64;0;0;0;0;.00nan;0;0
2134;2553;46;0;0;0;0;.00nan;0;0
2134;5146;64;86;36;3;33;.917;3600000;0
2135;3847;38;64;19;1;18;.947;3600000;0
2135;5137;58;0;0;0;0;.00nan;0;0
2135;6847;58;90;42;2;40;.952;3600000;0
2135;31021;38;0;0;0;0;.00nan;0;0
2136;2796;59;0;0;0;0;.00nan;0;0
2136;4338;65;99;23;0;23;1.000;3600000;0
2136;4987;65;0;0;0;0;.00nan;0;0
2136;31858;59;73;40;4;36;.900;3600000;0
2137;2163;39;0;0;0;0;.00nan;0;0
2137;9238;39;79;24;1;23;.958;3600000;0
2137;23493;51;74;44;5;39;.886;3600000;0
2137;31822;51;0;0;0;0;.00nan;0;0
2138;6572;62;0;0;0;0;.00nan;0;0
2138;14351;40;57;32;4;28;.875;3600000;0
2138;26840;40;0;0;0;0;.00nan;0;0
2138;26919;62;88;55;5;50;.909;3546000;0
2139;2152;49;89;33;2;31;.939;3723000;0
2139;4435;49;0;0;0;0;.00nan;0;0
2139;20717;60;0;0;0;0;.00nan;0;0
2139;35536;60;55;30;3;27;.900;3723000;0
2140;780;52;0;0;0;0;.00nan;0;0
2140;4338;65;46;25;4;21;.840;3600000;0
2140;4987;65;0;0;0;0;.00nan;0;0
2140;32146;52;73;16;1;15;.938;3600000;0
2141;5137;58;0;0;0;0;.00nan;0;0
2141;6847;58;80;31;2;29;.935;3554000;0
2141;19640;41;68;19;1;18;.947;3600000;0
2141;23075;41;0;0;0;0;.00nan;0;0
2142;1592;63;54;31;4;27;.871;3600000;0
2142;5298;55;0;0;0;0;.00nan;0;0
2142;34770;55;100;39;1;38;.974;3600000;0
2142;34814;63;0;0;0;0;.00nan;0;0
2143;37;46;0;0;0;0;.00nan;0;0
2143;1486;43;0;0;0;0;.00nan;0;0
2143;2553;46;59;27;3;24;.889;3588000;0
2143;3625;43;96;35;2;33;.943;3600000;0
2144;8046;57;0;0;0;0;.00nan;0;0
2144;23493;51;84;31;2;29;.935;3600000;0
2144;26865;57;55;28;4;24;.857;3516000;0
2144;31822;51;0;0;0;0;.00nan;0;0
2145;2163;39;0;0;0;0;.00nan;0;0
2145;2900;36;0;0;0;0;.00nan;0;0
2145;9238;39;90;43;2;41;.953;3900000;0
2145;14874;36;66;19;2;17;.895;3900000;0
2146;2296;37;0;0;0;0;.00nan;0;0
2146;5883;37;99;40;2;38;.950;3600000;0
2146;6081;56;51;35;5;30;.857;3600000;0
2146;14061;56;0;0;0;0;.00nan;0;0
2147;4447;54;82;36;2;34;.944;3600000;0
2147;31643;54;0;0;0;0;.00nan;0;0
2147;34788;42;0;0;0;0;.00nan;0;0
2147;37416;42;40;28;5;23;.821;3600000;0
2148;1051;44;90;23;2;21;.913;3600000;0
2148;2198;45;78;38;3;35;.921;3541000;0
2148;3281;44;0;0;0;0;.00nan;0;0
2148;34786;45;0;0;0;0;.00nan;0;0
2149;6572;62;0;0;0;0;.00nan;0;0
2149;25787;47;0;0;0;0;.00nan;0;0
2149;26919;62;73;39;4;35;.897;3600000;0
2149;33654;47;54;31;5;26;.839;3551000;0
2150;14351;40;0;0;0;0;.00nan;0;0
2150;20717;60;99;32;1;31;.969;3600000;0
2150;26840;40;85;35;3;32;.914;3571000;0
2150;35536;60;0;0;0;0;.00nan;0;0
2151;2016;61;67;38;4;34;.895;3555000;0
2151;5182;4619;42;15;3;12;.800;3600000;0
2151;17360;4619;0;0;0;0;.00nan;0;0
2151;30971;61;0;0;0;0;.00nan;0;0
2152;5137;58;0;0;0;0;.00nan;0;0
2152;6847;58;73;32;3;29;.906;3600000;0
2152;19640;41;0;0;0;0;.00nan;0;0
2152;23075;41;56;31;4;27;.871;3590000;0
2153;2796;59;0;0;0;0;.00nan;0;0
2153;23493;51;0;0;0;0;.00nan;0;0
2153;31822;51;49;42;6;36;.857;3595000;0
2153;31858;59;58;31;4;27;.871;3600000;0
2154;1592;63;44;14;3;11;.786;1296000;0
2154;2900;36;73;24;1;23;.958;3600000;0
2154;14874;36;0;0;0;0;.00nan;0;0
2154;34814;63;31;22;5;17;.773;2304000;0
2155;2163;39;64;40;5;35;.875;3568000;0
2155;5298;55;73;37;3;34;.919;3600000;0
2155;9238;39;0;0;0;0;.00nan;0;0
2155;34770;55;0;0;0;0;.00nan;0;0
2156;2296;37;76;26;3;23;.885;3574000;0
2156;5883;37;0;0;0;0;.00nan;0;0
2156;6081;56;0;0;0;0;.00nan;0;0
2156;14061;56;66;17;1;16;.941;3600000;0
2157;751;64;0;0;0;0;.00nan;0;0
2157;4447;54;0;0;0;0;.00nan;0;0
2157;5146;64;69;26;3;23;.885;3900000;0
2157;31643;54;61;33;3;30;.909;3900000;0
2158;3;50;69;34;3;31;.912;3600000;0
2158;3626;48;43;27;4;23;.852;3551000;0
2158;5048;50;0;0;0;0;.00nan;0;0
2158;38547;48;0;0;0;0;.00nan;0;0
2159;780;52;98;44;2;42;.955;3600000;0
2159;3847;38;0;0;0;0;.00nan;0;0
2159;31021;38;74;19;1;18;.947;3600000;0
2159;32146;52;0;0;0;0;.00nan;0;0
2160;8046;57;57;38;5;33;.868;3600000;0
2160;26865;57;0;0;0;0;.00nan;0;0
2160;28772;53;0;0;0;0;.00nan;0;0
2160;31156;53;64;14;1;13;.929;3600000;0
2161;1051;44;84;30;1;29;.967;3600000;0
2161;2198;45;0;0;0;0;.00nan;0;0
2161;3281;44;0;0;0;0;.00nan;0;0
2161;34786;45;38;31;6;25;.806;3600000;0
2162;14351;40;84;38;2;36;.947;3600000;0
2162;20717;60;0;0;0;0;.00nan;0;0
2162;26840;40;0;0;0;0;.00nan;0;0
2162;35536;60;87;41;3;38;.927;3559000;0
2163;2152;49;72;18;1;17;.944;3600000;0
2163;4435;49;0;0;0;0;.00nan;0;0
2163;6572;62;97;42;2;40;.952;3558000;0
2163;26919;62;0;0;0;0;.00nan;0;0
2164;1486;43;0;0;0;0;.00nan;0;0
2164;3625;43;56;21;3;18;.857;3600000;0
2164;34788;42;58;34;4;30;.882;3547000;0
2164;37416;42;0;0;0;0;.00nan;0;0
2165;780;52;0;0;0;0;.00nan;0;0
2165;3847;38;60;16;1;15;.938;3600000;0
2165;31021;38;0;0;0;0;.00nan;0;0
2165;32146;52;89;68;6;62;.912;3600000;0
2166;2796;59;55;5;0;5;1.000;512000;0
2166;28772;53;78;26;2;24;.923;3600000;0
2166;31156;53;0;0;0;0;.00nan;0;0
2166;31858;59;17;40;8;32;.800;3088000;0
2167;37;46;0;0;0;0;.00nan;0;0
2167;751;64;74;36;2;34;.944;3600000;0
2167;2553;46;86;28;1;27;.964;3600000;0
2167;5146;64;0;0;0;0;.00nan;0;0
2168;3;50;0;0;0;0;.00nan;0;0
2168;3626;48;0;0;0;0;.00nan;0;0
2168;5048;50;70;29;2;27;.931;3744000;0
2168;38547;48;78;24;1;23;.958;3765000;0
2169;4338;65;84;24;2;22;.917;3600000;0
2169;4987;65;0;0;0;0;.00nan;0;0
2169;8046;57;0;0;0;0;.00nan;0;0
2169;26865;57;55;24;3;21;.875;3544000;0
2170;2016;61;100;32;1;31;.969;3900000;0
2170;5182;4619;97;35;1;34;.971;3900000;0
2170;17360;4619;0;0;0;0;.00nan;0;0
2170;30971;61;0;0;0;0;.00nan;0;0
2171;1486;43;0;0;0;0;.00nan;0;0
2171;3625;43;63;19;2;17;.895;3845000;0
2171;34788;42;49;22;3;19;.864;3845000;0
2171;37416;42;0;0;0;0;.00nan;0;0
2172;2016;61;83;23;1;22;.957;3600000;0
2172;2296;37;0;0;0;0;.00nan;0;0
2172;5883;37;84;34;2;32;.941;3564000;0
2172;30971;61;0;0;0;0;.00nan;0;0
2173;780;52;0;0;0;0;.00nan;0;0
2173;5137;58;0;0;0;0;.00nan;0;0
2173;6847;58;74;38;2;36;.947;3900000;0
2173;32146;52;91;36;2;34;.944;3900000;0
2174;2900;36;0;0;0;0;.00nan;0;0
2174;14874;36;86;31;2;29;.935;3652000;0
2174;28772;53;0;0;0;0;.00nan;0;0
2174;31156;53;85;26;1;25;.962;3652000;0
2175;37;46;94;48;4;44;.917;3600000;0
2175;2198;45;78;23;1;22;.957;3600000;0
2175;2553;46;0;0;0;0;.00nan;0;0
2175;34786;45;0;0;0;0;.00nan;0;0
2176;751;64;0;0;0;0;.00nan;0;0
2176;4447;54;0;0;0;0;.00nan;0;0
2176;5146;64;70;22;1;21;.955;3600000;0
2176;31643;54;61;21;2;19;.905;3596000;0
2177;14351;40;38;28;6;22;.786;2838000;0
2177;25787;47;0;0;0;0;.00nan;0;0
2177;26840;40;50;3;0;3;1.000;762000;0
2177;33654;47;75;23;2;21;.913;3600000;0
2178;1051;44;72;35;4;31;.886;3600000;0
2178;3281;44;0;0;0;0;.00nan;0;0
2178;20717;60;27;29;6;23;.793;3553000;0
2178;35536;60;0;0;0;0;.00nan;0;0
2179;3626;48;60;23;3;20;.870;3600000;0
2179;6572;62;0;0;0;0;.00nan;0;0
2179;26919;62;56;30;4;26;.867;3551000;0
2179;38547;48;0;0;0;0;.00nan;0;0
2180;2016;61;0;0;0;0;.00nan;0;0
2180;2296;37;96;33;1;32;.970;3600000;0
2180;5883;37;0;0;0;0;.00nan;0;0
2180;30971;61;66;25;2;23;.920;3543000;0
2181;1592;63;0;0;0;0;.00nan;0;0
2181;4338;65;65;30;3;27;.900;3600000;0
2181;4987;65;0;0;0;0;.00nan;0;0
2181;34814;63;75;52;5;47;.904;3523000;0
2182;3847;38;0;0;0;0;.00nan;0;0
2182;19640;41;85;37;3;34;.919;3600000;0
2182;23075;41;0;0;0;0;.00nan;0;0
2182;31021;38;25;21;5;16;.762;3582000;0
2183;780;52;0;0;0;0;.00nan;0;0
2183;2900;36;54;25;4;21;.840;3567000;0
2183;14874;36;0;0;0;0;.00nan;0;0
2183;32146;52;99;49;2;47;.959;3600000;0
2184;4338;65;0;0;0;0;.00nan;0;0
2184;4987;65;58;43;6;37;.860;3900000;0
2184;6081;56;26;10;4;6;.600;943000;0
2184;14061;56;68;22;2;20;.909;2957000;0
2185;23493;51;58;45;6;39;.867;3600000;0
2185;28772;53;45;30;5;25;.833;3600000;0
2185;31156;53;0;0;0;0;.00nan;0;0
2185;31822;51;0;0;0;0;.00nan;0;0
2186;37;46;77;28;2;26;.929;3557000;0
2186;2198;45;98;27;1;26;.963;3600000;0
2186;2553;46;0;0;0;0;.00nan;0;0
2186;34786;45;0;0;0;0;.00nan;0;0
2187;2796;59;0;0;0;0;.00nan;0;0
2187;5298;55;0;0;0;0;.00nan;0;0
2187;31858;59;33;23;5;18;.783;3562000;0
2187;34770;55;54;27;4;23;.852;3600000;0
2188;5137;58;0;0;0;0;.00nan;0;0
2188;6847;58;90;21;0;21;1.000;3600000;0
2188;8046;57;0;0;0;0;.00nan;0;0
2188;26865;57;75;29;2;27;.931;3578000;0
2189;1486;43;0;0;0;0;.00nan;0;0
2189;2163;39;0;0;0;0;.00nan;0;0
2189;3625;43;97;46;1;45;.978;3561000;0
2189;9238;39;86;14;0;14;1.000;3600000;0
2190;5182;4619;76;20;1;19;.950;3600000;0
2190;14351;40;0;0;0;0;.00nan;0;0
2190;17360;4619;0;0;0;0;.00nan;0;0
2190;26840;40;31;34;7;27;.794;3600000;0
2191;2152;49;74;22;1;21;.955;3600000;0
2191;4435;49;0;0;0;0;.00nan;0;0
2191;25787;47;0;0;0;0;.00nan;0;0
2191;33654;47;67;31;3;28;.903;3567000;0
2192;3626;48;65;28;3;25;.893;3600000;0
2192;6572;62;0;0;0;0;.00nan;0;0
2192;26919;62;71;34;4;30;.882;3553000;0
2192;38547;48;0;0;0;0;.00nan;0;0
2193;1051;44;57;29;5;24;.828;2242000;0
2193;3281;44;52;13;1;12;.923;1358000;0
2193;20717;60;71;31;3;28;.903;3600000;0
2193;35536;60;0;0;0;0;.00nan;0;0
2194;4338;65;65;34;4;30;.882;3600000;0
2194;4987;65;0;0;0;0;.00nan;0;0
2194;23493;51;0;0;0;0;.00nan;0;0
2194;31822;51;87;27;1;26;.963;3600000;0
2195;751;64;0;0;0;0;.00nan;0;0
2195;1592;63;68;45;5;40;.889;3600000;0
2195;5146;64;98;25;0;25;1.000;3600000;0
2195;34814;63;0;0;0;0;.00nan;0;0
2196;3847;38;87;24;1;23;.958;3600000;0
2196;19640;41;81;31;2;29;.935;3600000;0
2196;23075;41;0;0;0;0;.00nan;0;0
2196;31021;38;0;0;0;0;.00nan;0;0
2197;2796;59;0;0;0;0;.00nan;0;0
2197;2900;36;0;0;0;0;.00nan;0;0
2197;14874;36;47;15;3;12;.800;3600000;0
2197;31858;59;97;23;0;23;1.000;3600000;0
2198;1486;43;34;29;6;23;.793;3600000;0
2198;2163;39;0;0;0;0;.00nan;0;0
2198;3625;43;0;0;0;0;.00nan;0;0
2198;9238;39;86;37;2;35;.946;3600000;0
2199;780;52;80;34;3;31;.912;3900000;0
2199;5298;55;61;27;3;24;.889;3900000;0
2199;32146;52;0;0;0;0;.00nan;0;0
2199;34770;55;0;0;0;0;.00nan;0;0
2200;6081;56;63;33;4;29;.879;3547000;0
2200;14061;56;0;0;0;0;.00nan;0;0
2200;28772;53;58;24;3;21;.875;3600000;0
2200;31156;53;0;0;0;0;.00nan;0;0
2201;2198;45;0;0;0;0;.00nan;0;0
2201;4447;54;60;13;1;12;.923;3600000;0
2201;31643;54;0;0;0;0;.00nan;0;0
2201;34786;45;92;49;3;46;.939;3586000;0
2202;37;46;0;0;0;0;.00nan;0;0
2202;1098;42;0;0;0;0;.00nan;0;0
2202;2553;46;54;24;3;21;.875;3802000;0
2202;37416;42;82;41;2;39;.951;3802000;0
2203;3;50;63;23;3;20;.870;3561000;0
2203;2296;37;0;0;0;0;.00nan;0;0
2203;5048;50;0;0;0;0;.00nan;0;0
2203;5883;37;83;30;2;28;.933;3600000;0
2204;5137;58;0;0;0;0;.00nan;0;0
2204;6847;58;88;55;3;52;.945;3818000;0
2204;8046;57;52;18;2;16;.889;3818000;0
2204;26865;57;0;0;0;0;.00nan;0;0
2205;5182;4619;0;0;0;0;.00nan;0;0
2205;14351;40;56;36;5;31;.861;3543000;0
2205;17360;4619;60;34;4;30;.882;3600000;0
2205;26840;40;0;0;0;0;.00nan;0;0
2206;2016;61;71;27;2;25;.926;3544000;0
2206;25787;47;79;25;1;24;.960;3600000;0
2206;30971;61;0;0;0;0;.00nan;0;0
2206;33654;47;0;0;0;0;.00nan;0;0
2207;1051;44;49;31;5;26;.839;3600000;0
2207;3281;44;0;0;0;0;.00nan;0;0
2207;20717;60;0;0;0;0;.00nan;0;0
2207;35536;60;56;17;2;15;.882;3600000;0
2208;3626;48;0;0;0;0;.00nan;0;0
2208;6572;62;63;37;4;33;.892;3573000;0
2208;26919;62;0;0;0;0;.00nan;0;0
2208;38547;48;66;21;2;19;.905;3600000;0
2209;3847;38;0;0;0;0;.00nan;0;0
2209;19640;41;0;0;0;0;.00nan;0;0
2209;23075;41;87;34;2;32;.941;3544000;0
2209;31021;38;80;20;1;19;.950;3600000;0
2210;751;64;0;0;0;0;.00nan;0;0
2210;1592;63;0;0;0;0;.00nan;0;0
2210;5146;64;80;23;1;22;.957;3900000;0
2210;34814;63;87;33;1;32;.970;3900000;0
2211;1098;42;88;30;1;29;.967;3861000;0
2211;4447;54;0;0;0;0;.00nan;0;0
2211;31643;54;94;45;2;43;.956;3861000;0
2211;37416;42;0;0;0;0;.00nan;0;0
2212;2796;59;0;0;0;0;.00nan;0;0
2212;8046;57;0;0;0;0;.00nan;0;0
2212;26865;57;74;40;4;36;.900;3900000;0
2212;31858;59;55;26;4;22;.846;3900000;0
2213;2016;61;57;30;3;27;.900;3575000;0
2213;2152;49;71;26;2;24;.923;3600000;0
2213;4435;49;0;0;0;0;.00nan;0;0
2213;30971;61;0;0;0;0;.00nan;0;0
2214;1486;43;0;0;0;0;.00nan;0;0
2214;3625;43;100;30;0;30;1.000;3600000;0
2214;5298;55;0;0;0;0;.00nan;0;0
2214;34770;55;57;25;3;22;.880;3600000;0
2215;3;50;74;30;2;28;.933;3600000;0
2215;2296;37;0;0;0;0;.00nan;0;0
2215;5048;50;0;0;0;0;.00nan;0;0
2215;5883;37;69;45;5;40;.889;3600000;0
2216;751;64;83;26;1;25;.962;3600000;0
2216;2198;45;61;40;4;36;.900;3600000;0
2216;5146;64;0;0;0;0;.00nan;0;0
2216;34786;45;0;0;0;0;.00nan;0;0
2217;37;46;69;38;4;34;.895;3600000;0
2217;2152;49;74;20;1;19;.950;3600000;0
2217;2553;46;0;0;0;0;.00nan;0;0
2217;4435;49;0;0;0;0;.00nan;0;0
2218;5137;58;0;0;0;0;.00nan;0;0
2218;6847;58;83;58;5;53;.914;3600000;0
2218;28772;53;96;38;2;36;.947;3600000;0
2218;31156;53;0;0;0;0;.00nan;0;0
2219;4338;65;89;32;2;30;.938;3900000;0
2219;4987;65;0;0;0;0;.00nan;0;0
2219;8046;57;0;0;0;0;.00nan;0;0
2219;26865;57;92;35;2;33;.943;3900000;0
2220;1486;43;0;0;0;0;.00nan;0;0
2220;2900;36;69;35;3;32;.914;3900000;0
2220;3625;43;81;38;3;35;.921;3900000;0
2220;14874;36;0;0;0;0;.00nan;0;0
2221;1592;63;91;40;3;37;.925;3600000;0
2221;2796;59;0;0;0;0;.00nan;0;0
2221;31858;59;33;22;5;17;.773;3514000;0
2221;34814;63;0;0;0;0;.00nan;0;0
2222;780;52;0;0;0;0;.00nan;0;0
2222;5298;55;0;0;0;0;.00nan;0;0
2222;32146;52;94;23;0;23;1.000;3600000;0
2222;34770;55;41;14;3;11;.786;3600000;0
2223;1098;42;0;0;0;0;.00nan;0;0
2223;2296;37;0;0;0;0;.00nan;0;0
2223;5883;37;76;44;3;41;.932;3897000;0
2223;37416;42;69;33;3;30;.909;3900000;0
2224;5182;4619;81;13;0;13;1.000;3600000;0
2224;17360;4619;0;0;0;0;.00nan;0;0
2224;25787;47;0;0;0;0;.00nan;0;0
2224;33654;47;86;46;3;43;.935;3600000;0
2225;1051;44;52;31;5;26;.839;3600000;0
2225;3281;44;0;0;0;0;.00nan;0;0
2225;6572;62;0;0;0;0;.00nan;0;0
2225;26919;62;85;25;1;24;.960;3600000;0
2226;2016;61;61;24;2;22;.917;3573000;0
2226;20717;60;0;0;0;0;.00nan;0;0
2226;30971;61;0;0;0;0;.00nan;0;0
2226;35536;60;99;32;1;31;.969;3600000;0
2227;5137;58;0;0;0;0;.00nan;0;0
2227;6847;58;83;55;5;50;.909;3600000;0
2227;28772;53;29;13;4;9;.692;2802000;0
2227;31156;53;64;6;0;6;1.000;798000;0
2228;1486;43;0;0;0;0;.00nan;0;0
2228;3625;43;85;41;2;39;.951;3900000;0
2228;19640;41;78;29;2;27;.931;3900000;0
2228;23075;41;0;0;0;0;.00nan;0;0
2229;2900;36;0;0;0;0;.00nan;0;0
2229;5298;55;0;0;0;0;.00nan;0;0
2229;14874;36;69;31;3;28;.903;3600000;0
2229;34770;55;84;33;2;31;.939;3600000;0
2230;2796;59;0;0;0;0;.00nan;0;0
2230;6081;56;0;0;0;0;.00nan;0;0
2230;14061;56;54;31;5;26;.839;3600000;0
2230;31858;59;68;22;1;21;.955;3600000;0
2231;1074;51;38;29;5;24;.828;3519000;0
2231;8046;57;0;0;0;0;.00nan;0;0
2231;23493;51;0;0;0;0;.00nan;0;0
2231;26865;57;59;33;3;30;.909;3600000;0
2232;3847;38;0;0;0;0;.00nan;0;0
2232;4338;65;0;0;0;0;.00nan;0;0
2232;4987;65;56;33;4;29;.879;3900000;0
2232;31021;38;65;37;4;33;.892;3900000;0
2233;1592;63;74;32;3;29;.906;3557000;0
2233;2163;39;0;0;0;0;.00nan;0;0
2233;9238;39;70;23;1;22;.957;3600000;0
2233;34814;63;0;0;0;0;.00nan;0;0
2234;751;64;0;0;0;0;.00nan;0;0
2234;2296;37;0;0;0;0;.00nan;0;0
2234;5146;64;51;22;3;19;.864;3600000;0
2234;5883;37;50;29;5;24;.828;3572000;0
2235;2198;45;100;35;1;34;.971;3600000;0
2235;4447;54;0;0;0;0;.00nan;0;0
2235;31643;54;63;30;4;26;.867;3600000;0
2235;34786;45;0;0;0;0;.00nan;0;0
2236;3;50;76;22;1;21;.955;3600000;0
2236;1098;42;36;36;6;30;.833;3167000;0
2236;5048;50;0;0;0;0;.00nan;0;0
2236;37416;42;54;3;0;3;1.000;433000;0
2237;37;46;99;26;0;26;1.000;3600000;0
2237;2553;46;0;0;0;0;.00nan;0;0
2237;7049;47;0;0;0;0;.00nan;0;0
2237;33654;47;49;28;4;24;.857;3600000;0
2238;2016;61;0;0;0;0;.00nan;0;0
2238;14351;40;76;34;2;32;.941;3580000;0
2238;26840;40;0;0;0;0;.00nan;0;0
2238;30971;61;76;21;1;20;.952;3600000;0
2239;1051;44;39;33;6;27;.818;3517000;0
2239;3281;44;0;0;0;0;.00nan;0;0
2239;25153;48;0;0;0;0;.00nan;0;0
2239;38547;48;62;24;4;20;.833;3600000;0
2240;1074;51;0;0;0;0;.00nan;0;0
2240;2796;59;0;0;0;0;.00nan;0;0
2240;23493;51;74;24;1;23;.958;3600000;0
2240;31858;59;58;26;3;23;.885;3600000;0
2241;780;52;0;0;0;0;.00nan;0;0
2241;1592;63;0;0;0;0;.00nan;0;0
2241;32146;52;74;40;4;36;.900;3756000;0
2241;34814;63;67;43;5;38;.884;3756000;0
2242;5182;4619;34;18;4;14;.778;3600000;0
2242;17360;4619;0;0;0;0;.00nan;0;0
2242;20717;60;96;43;1;42;.977;3600000;0
2242;35536;60;0;0;0;0;.00nan;0;0
2243;1051;44;0;0;0;0;.00nan;0;0
2243;3281;44;91;28;1;27;.964;3900000;0
2243;25153;48;82;27;1;26;.963;3900000;0
2243;38547;48;0;0;0;0;.00nan;0;0
2244;4338;65;59;31;3;28;.903;3600000;0
2244;4987;65;0;0;0;0;.00nan;0;0
2244;28772;53;75;21;1;20;.952;3600000;0
2244;31156;53;0;0;0;0;.00nan;0;0
2245;2163;39;48;26;4;22;.846;3563000;0
2245;2900;36;89;35;2;33;.943;3600000;0
2245;9238;39;0;0;0;0;.00nan;0;0
2245;14874;36;0;0;0;0;.00nan;0;0
2246;6081;56;90;39;3;36;.923;3562000;0
2246;8046;57;86;31;1;30;.968;3600000;0
2246;14061;56;0;0;0;0;.00nan;0;0
2246;26865;57;0;0;0;0;.00nan;0;0
2247;2296;37;100;28;0;28;1.000;3600000;0
2247;5883;37;0;0;0;0;.00nan;0;0
2247;34788;42;0;0;0;0;.00nan;0;0
2247;37416;42;55;26;4;22;.846;3600000;0
2248;3847;38;54;25;3;22;.880;3550000;0
2248;5137;58;0;0;0;0;.00nan;0;0
2248;6847;58;68;23;2;21;.913;3600000;0
2248;31021;38;0;0;0;0;.00nan;0;0
2249;2198;45;0;0;0;0;.00nan;0;0
2249;4447;54;84;31;2;29;.935;3600000;0
2249;31643;54;0;0;0;0;.00nan;0;0
2249;34786;45;71;33;3;30;.909;3568000;0
2250;37;46;79;25;1;24;.960;3600000;0
2250;2553;46;0;0;0;0;.00nan;0;0
2250;7049;47;64;35;3;32;.914;3600000;0
2250;33654;47;0;0;0;0;.00nan;0;0
2251;2152;49;61;35;4;31;.886;3600000;0
2251;4435;49;0;0;0;0;.00nan;0;0
2251;6572;62;0;0;0;0;.00nan;0;0
2251;26919;62;90;32;2;30;.938;3600000;0
2252;1486;43;0;0;0;0;.00nan;0;0
2252;3625;43;81;35;3;32;.914;3545000;0
2252;19640;41;74;32;2;30;.938;3600000;0
2252;23075;41;0;0;0;0;.00nan;0;0
2253;3847;38;0;0;0;0;.00nan;0;0
2253;5298;55;0;0;0;0;.00nan;0;0
2253;31021;38;83;51;4;47;.922;3600000;0
2253;34770;55;60;20;2;18;.900;3600000;0
2254;780;52;90;34;1;33;.971;3600000;0
2254;2163;39;0;0;0;0;.00nan;0;0
2254;9238;39;56;21;2;19;.905;3551000;0
2254;32146;52;0;0;0;0;.00nan;0;0
2255;3;50;65;29;3;26;.897;3600000;0
2255;751;64;0;0;0;0;.00nan;0;0
2255;5048;50;0;0;0;0;.00nan;0;0
2255;5146;64;38;34;6;28;.824;3600000;0
2256;37;46;0;0;0;0;.00nan;0;0
2256;2152;49;0;0;0;0;.00nan;0;0
2256;2553;46;40;31;4;27;.871;3600000;0
2256;4435;49;66;15;1;14;.933;3600000;0
2257;5182;4619;0;0;0;0;.00nan;0;0
2257;17360;4619;48;34;4;30;.882;3560000;0
2257;20717;60;0;0;0;0;.00nan;0;0
2257;35536;60;79;32;2;30;.938;3600000;0
2258;6572;62;78;39;3;36;.923;3551000;0
2258;14351;40;0;0;0;0;.00nan;0;0
2258;26840;40;68;26;2;24;.923;3600000;0
2258;26919;62;0;0;0;0;.00nan;0;0
2259;1074;51;63;33;3;30;.909;3562000;0
2259;2296;37;72;23;1;22;.957;3600000;0
2259;5883;37;0;0;0;0;.00nan;0;0
2259;23493;51;0;0;0;0;.00nan;0;0
2260;4447;54;0;0;0;0;.00nan;0;0
2260;31643;54;62;25;3;22;.880;3600000;0
2260;34788;42;45;27;5;22;.815;3577000;0
2260;37416;42;0;0;0;0;.00nan;0;0
2261;1592;63;41;38;6;32;.842;3600000;0
2261;2016;61;79;19;1;18;.947;3600000;0
2261;30971;61;0;0;0;0;.00nan;0;0
2261;34814;63;0;0;0;0;.00nan;0;0
2262;2152;49;0;0;0;0;.00nan;0;0
2262;4435;49;75;20;1;19;.950;3600000;0
2262;20717;60;56;29;4;25;.862;3600000;0
2262;35536;60;0;0;0;0;.00nan;0;0
2263;2796;59;0;0;0;0;.00nan;0;0
2263;28772;53;67;34;4;30;.882;3543000;0
2263;31156;53;0;0;0;0;.00nan;0;0
2263;31858;59;77;39;3;36;.923;3600000;0
2264;2163;39;0;0;0;0;.00nan;0;0
2264;5298;55;0;0;0;0;.00nan;0;0
2264;9238;39;68;23;2;21;.913;3566000;0
2264;34770;55;91;31;1;30;.968;3600000;0
2265;1074;51;0;0;0;0;.00nan;0;0
2265;2296;37;53;17;2;15;.882;2557000;0
2265;5883;37;22;11;4;7;.636;1043000;0
2265;23493;51;62;23;2;21;.913;3600000;0
2266;5182;4619;56;26;3;23;.885;3771000;0
2266;14351;40;0;0;0;0;.00nan;0;0
2266;17360;4619;0;0;0;0;.00nan;0;0
2266;26840;40;86;39;4;35;.897;3771000;0
2267;1592;63;0;0;0;0;.00nan;0;0
2267;2016;61;0;0;0;0;.00nan;0;0
2267;30971;61;77;31;2;29;.935;3600000;0
2267;34814;63;56;22;3;19;.864;3571000;0
2268;6081;56;67;46;5;41;.891;3550000;0
2268;14061;56;0;0;0;0;.00nan;0;0
2268;28772;53;83;39;3;36;.923;3600000;0
2268;31156;53;0;0;0;0;.00nan;0;0
2269;4338;65;0;0;0;0;.00nan;0;0
2269;4987;65;59;37;4;33;.892;3600000;0
2269;19640;41;100;28;0;28;1.000;3600000;0
2269;23075;41;0;0;0;0;.00nan;0;0
2270;1486;43;0;0;0;0;.00nan;0;0
2270;2163;39;0;0;0;0;.00nan;0;0
2270;3625;43;55;35;5;30;.857;3544000;0
2270;9238;39;64;27;3;24;.889;3600000;0
2271;2900;36;50;1;0;1;1.000;409000;0
2271;5298;55;0;0;0;0;.00nan;0;0
2271;14874;36;35;32;6;26;.813;3128000;0
2271;34770;55;29;21;5;16;.762;3600000;0
2272;37;46;96;34;1;33;.971;3600000;0
2272;2198;45;21;12;4;8;.667;1191000;0
2272;2553;46;0;0;0;0;.00nan;0;0
2272;34786;45;69;14;0;14;1.000;2409000;0
2273;3847;38;0;0;0;0;.00nan;0;0
2273;5137;58;0;0;0;0;.00nan;0;0
2273;6847;58;61;31;3;28;.903;3558000;0
2273;31021;38;83;25;1;24;.960;3600000;0
2274;2796;59;0;0;0;0;.00nan;0;0
2274;8046;57;0;0;0;0;.00nan;0;0
2274;26865;57;84;40;3;37;.925;3600000;0
2274;31858;59;50;27;4;23;.852;3600000;0
2275;2296;37;0;0;0;0;.00nan;0;0
2275;5883;37;60;28;3;25;.893;3600000;0
2275;26967;63;0;0;0;0;.00nan;0;0
2275;34814;63;100;29;0;29;1.000;3600000;0
2276;751;64;0;0;0;0;.00nan;0;0
2276;4447;54;0;0;0;0;.00nan;0;0
2276;5146;64;100;38;1;37;.974;3600000;0
2276;31643;54;64;30;3;27;.900;3525000;0
2277;7049;47;0;0;0;0;.00nan;0;0
2277;25153;48;0;0;0;0;.00nan;0;0
2277;33654;47;65;40;4;36;.900;3600000;0
2277;38547;48;70;23;1;22;.957;3600000;0
2278;2152;49;100;25;0;25;1.000;3600000;0
2278;4435;49;0;0;0;0;.00nan;0;0
2278;5182;4619;66;23;2;21;.913;3558000;0
2278;17360;4619;0;0;0;0;.00nan;0;0
2279;3;50;80;33;3;30;.909;3600000;0
2279;5048;50;0;0;0;0;.00nan;0;0
2279;6572;62;0;0;0;0;.00nan;0;0
2279;26919;62;76;46;4;42;.913;3552000;0
2280;1051;44;81;44;4;40;.909;3551000;0
2280;3281;44;0;0;0;0;.00nan;0;0
2280;34788;42;0;0;0;0;.00nan;0;0
2280;37416;42;78;34;3;31;.912;3600000;0
2281;4338;65;89;39;3;36;.923;3600000;0
2281;4987;65;0;0;0;0;.00nan;0;0
2281;19640;41;92;16;0;16;1.000;3600000;0
2281;23075;41;0;0;0;0;.00nan;0;0
2282;780;52;62;16;1;15;.938;2399000;0
2282;2796;59;67;37;4;33;.892;3600000;0
2282;31858;59;0;0;0;0;.00nan;0;0
2282;32146;52;18;9;4;5;.556;1168000;0
2283;5137;58;67;22;1;21;.955;3600000;0
2283;6081;56;0;0;0;0;.00nan;0;0
2283;6847;58;0;0;0;0;.00nan;0;0
2283;14061;56;60;32;4;28;.875;3600000;0
2284;2900;36;68;27;3;24;.889;3600000;0
2284;14874;36;0;0;0;0;.00nan;0;0
2284;28772;53;0;0;0;0;.00nan;0;0
2284;31156;53;77;29;2;27;.931;3600000;0
2285;1486;43;75;22;2;20;.909;3600000;0
2285;2163;39;0;0;0;0;.00nan;0;0
2285;3625;43;0;0;0;0;.00nan;0;0
2285;9238;39;40;26;5;21;.808;3600000;0
2286;37;46;81;37;2;35;.946;2710000;0
2286;2198;45;67;22;2;20;.909;3600000;0
2286;2553;46;20;9;4;5;.556;890000;0
2286;34786;45;0;0;0;0;.00nan;0;0
2287;5298;55;66;30;3;27;.900;3571000;0
2287;8046;57;0;0;0;0;.00nan;0;0
2287;26865;57;89;33;1;32;.970;3600000;0
2287;34770;55;0;0;0;0;.00nan;0;0
2288;751;64;100;52;2;50;.962;3600000;0
2288;4447;54;50;23;3;20;.870;3586000;0
2288;5146;64;0;0;0;0;.00nan;0;0
2288;31643;54;0;0;0;0;.00nan;0;0
2289;2152;49;62;15;1;14;.933;3600000;0
2289;4435;49;0;0;0;0;.00nan;0;0
2289;5182;4619;0;0;0;0;.00nan;0;0
2289;17360;4619;95;42;2;40;.952;3587000;0
2290;14351;40;0;0;0;0;.00nan;0;0
2290;20717;60;62;29;3;26;.897;3600000;0
2290;26840;40;63;22;2;20;.909;3600000;0
2290;35536;60;0;0;0;0;.00nan;0;0
2291;3;50;72;33;3;30;.909;3600000;0
2291;5048;50;0;0;0;0;.00nan;0;0
2291;6572;62;86;34;2;32;.941;3600000;0
2291;26919;62;0;0;0;0;.00nan;0;0
2292;1051;44;0;0;0;0;.00nan;0;0
2292;3281;44;79;28;2;26;.929;3600000;0
2292;34788;42;36;26;5;21;.808;3600000;0
2292;37416;42;0;0;0;0;.00nan;0;0
2293;3626;48;91;20;0;20;1.000;3600000;0
2293;7049;47;32;24;5;19;.792;3600000;0
2293;33654;47;0;0;0;0;.00nan;0;0
2293;38547;48;0;0;0;0;.00nan;0;0
2294;1074;51;0;0;0;0;.00nan;0;0
2294;2016;61;56;32;4;28;.875;3525000;0
2294;23493;51;76;30;2;28;.933;3600000;0
2294;30971;61;0;0;0;0;.00nan;0;0
2295;5137;58;0;0;0;0;.00nan;0;0
2295;6081;56;60;15;1;14;.933;3600000;0
2295;6847;58;72;34;3;31;.912;3600000;0
2295;14061;56;0;0;0;0;.00nan;0;0
2296;780;52;0;0;0;0;.00nan;0;0
2296;8046;57;81;39;4;35;.897;3600000;0
2296;26865;57;0;0;0;0;.00nan;0;0
2296;32146;52;34;27;5;22;.815;3546000;0
2297;2296;37;89;33;1;32;.970;3600000;0
2297;5883;37;0;0;0;0;.00nan;0;0
2297;26967;63;0;0;0;0;.00nan;0;0
2297;34814;63;81;32;2;30;.938;3570000;0
2298;751;64;0;0;0;0;.00nan;0;0
2298;2198;45;0;0;0;0;.00nan;0;0
2298;5146;64;56;35;5;30;.857;3600000;0
2298;34786;45;90;30;2;28;.933;3600000;0
2299;2900;36;0;0;0;0;.00nan;0;0
2299;3847;38;0;0;0;0;.00nan;0;0
2299;14874;36;51;33;5;28;.848;3600000;0
2299;31021;38;34;25;6;19;.760;3556000;0
2300;37;46;0;0;0;0;.00nan;0;0
2300;2553;46;75;38;3;35;.921;3600000;0
2300;4447;54;0;0;0;0;.00nan;0;0
2300;31643;54;90;19;0;19;1.000;3600000;0
2301;14351;40;84;43;3;40;.930;3600000;0
2301;20717;60;0;0;0;0;.00nan;0;0
2301;26840;40;0;0;0;0;.00nan;0;0
2301;35536;60;59;20;2;18;.900;3600000;0
2302;1074;51;19;19;6;13;.684;2902000;0
2302;2016;61;35;26;5;21;.808;3600000;0
2302;23493;51;53;2;0;2;1.000;650000;0
2302;30971;61;0;0;0;0;.00nan;0;0
2303;3626;48;96;33;1;32;.970;3600000;0
2303;34788;42;0;0;0;0;.00nan;0;0
2303;37416;42;78;34;2;32;.941;3585000;0
2303;38547;48;0;0;0;0;.00nan;0;0
2304;780;52;0;0;0;0;.00nan;0;0
2304;4338;65;81;25;1;24;.960;3600000;0
2304;4987;65;0;0;0;0;.00nan;0;0
2304;32146;52;67;30;4;26;.867;3600000;0
2305;3;50;73;26;3;23;.885;3900000;0
2305;1051;44;97;44;3;41;.932;3900000;0
2305;3281;44;0;0;0;0;.00nan;0;0
2305;5048;50;0;0;0;0;.00nan;0;0
2306;3626;48;0;0;0;0;.00nan;0;0
2306;34788;42;25;12;4;8;.667;1071000;0
2306;37416;42;60;13;1;12;.923;2529000;0
2306;38547;48;100;37;0;37;1.000;3600000;0
2307;1592;63;52;27;4;23;.852;3629000;0
2307;2900;36;61;31;5;26;.839;3629000;0
2307;14874;36;0;0;0;0;.00nan;0;0
2307;34814;63;0;0;0;0;.00nan;0;0
2308;2296;37;0;0;0;0;.00nan;0;0
2308;4447;54;0;0;0;0;.00nan;0;0
2308;5883;37;72;34;3;31;.912;3600000;0
2308;31643;54;54;27;4;23;.852;3561000;0
2309;751;64;0;0;0;0;.00nan;0;0
2309;2198;45;67;17;2;15;.882;3597000;0
2309;5146;64;90;32;1;31;.969;3600000;0
2309;34786;45;0;0;0;0;.00nan;0;0
2310;5298;55;0;0;0;0;.00nan;0;0
2310;6081;56;37;28;5;23;.821;3600000;0
2310;14061;56;0;0;0;0;.00nan;0;0
2310;34770;55;53;25;3;22;.880;3600000;0
2311;37;46;26;12;4;8;.667;674000;0
2311;1486;43;0;0;0;0;.00nan;0;0
2311;2553;46;63;23;2;21;.913;2926000;0
2311;3625;43;83;33;3;30;.909;3600000;0
2312;2796;59;0;0;0;0;.00nan;0;0
2312;8046;57;69;37;4;33;.892;3600000;0
2312;26865;57;0;0;0;0;.00nan;0;0
2312;31858;59;56;38;5;33;.868;3562000;0
2313;1074;51;0;0;0;0;.00nan;0;0
2313;2163;39;0;0;0;0;.00nan;0;0
2313;9238;39;75;33;3;30;.909;3514000;0
2313;23493;51;95;30;1;29;.967;3600000;0
2314;7049;47;0;0;0;0;.00nan;0;0
2314;20717;60;0;0;0;0;.00nan;0;0
2314;33654;47;69;37;4;33;.892;3600000;0
2314;35536;60;87;18;0;18;1.000;3600000;0
2315;3;50;60;29;3;26;.897;3600000;0
2315;1051;44;0;0;0;0;.00nan;0;0
2315;3281;44;58;33;5;28;.848;3567000;0
2315;5048;50;0;0;0;0;.00nan;0;0
2316;19640;41;55;27;4;23;.852;3833000;0
2316;23075;41;0;0;0;0;.00nan;0;0
2316;28772;53;84;43;3;40;.930;3833000;0
2316;31156;53;0;0;0;0;.00nan;0;0
2317;780;52;0;0;0;0;.00nan;0;0
2317;3847;38;0;0;0;0;.00nan;0;0
2317;31021;38;67;28;3;25;.893;3600000;0
2317;32146;52;100;27;0;27;1.000;3600000;0
2318;19640;41;0;0;0;0;.00nan;0;0
2318;23075;41;70;27;3;24;.889;3900000;0
2318;28772;53;0;0;0;0;.00nan;0;0
2318;31156;53;61;29;3;26;.897;3900000;0
2319;2900;36;0;0;0;0;.00nan;0;0
2319;5137;58;0;0;0;0;.00nan;0;0
2319;6847;58;83;38;2;36;.947;3600000;0
2319;14874;36;87;27;1;26;.963;3600000;0
2320;5298;55;0;0;0;0;.00nan;0;0
2320;6081;56;0;0;0;0;.00nan;0;0
2320;14061;56;63;25;3;22;.880;3600000;0
2320;34770;55;57;29;4;25;.862;3596000;0
2321;1074;51;0;0;0;0;.00nan;0;0
2321;2163;39;0;0;0;0;.00nan;0;0
2321;9238;39;42;17;4;13;.765;3600000;0
2321;23493;51;63;42;5;37;.881;3570000;0
2322;4338;65;85;40;2;38;.950;3900000;0
2322;4987;65;0;0;0;0;.00nan;0;0
2322;8046;57;0;0;0;0;.00nan;0;0
2322;26865;57;79;26;2;24;.923;3900000;0
2323;2296;37;0;0;0;0;.00nan;0;0
2323;4447;54;0;0;0;0;.00nan;0;0
2323;5883;37;75;21;1;20;.952;3600000;0
2323;31643;54;67;31;3;28;.903;3574000;0
2324;5182;4619;52;19;4;15;.789;3769000;0
2324;7049;47;0;0;0;0;.00nan;0;0
2324;17360;4619;0;0;0;0;.00nan;0;0
2324;33654;47;71;49;5;44;.898;3769000;0
2325;2152;49;59;29;4;25;.862;3795000;0
2325;4435;49;0;0;0;0;.00nan;0;0
2325;14351;40;0;0;0;0;.00nan;0;0
2325;26840;40;49;22;3;19;.864;3795000;0
2326;2016;61;50;29;5;24;.828;3600000;0
2326;6572;62;0;0;0;0;.00nan;0;0
2326;26919;62;100;28;0;28;1.000;3600000;0
2326;30971;61;0;0;0;0;.00nan;0;0
2327;37;46;91;28;1;27;.964;3600000;0
2327;1592;63;54;31;4;27;.871;3600000;0
2327;2553;46;0;0;0;0;.00nan;0;0
2327;34814;63;0;0;0;0;.00nan;0;0
2328;1074;51;91;38;1;37;.974;3600000;0
2328;5298;55;66;28;3;25;.893;3600000;0
2328;23493;51;0;0;0;0;.00nan;0;0
2328;34770;55;0;0;0;0;.00nan;0;0
2329;4338;65;0;0;0;0;.00nan;0;0
2329;4987;65;94;46;3;43;.935;3600000;0
2329;5137;58;42;24;4;20;.833;3577000;0
2329;6847;58;0;0;0;0;.00nan;0;0
2330;2796;59;0;0;0;0;.00nan;0;0
2330;2900;36;100;33;0;33;1.000;3600000;0
2330;14874;36;0;0;0;0;.00nan;0;0
2330;31858;59;73;32;2;30;.938;3535000;0
2331;2163;39;62;26;3;23;.885;3569000;0
2331;6081;56;86;28;1;27;.964;3600000;0
2331;9238;39;0;0;0;0;.00nan;0;0
2331;14061;56;0;0;0;0;.00nan;0;0
2332;1486;43;0;0;0;0;.00nan;0;0
2332;3625;43;98;41;1;40;.976;3557000;0
2332;4447;54;100;30;0;30;1.000;3600000;0
2332;31643;54;0;0;0;0;.00nan;0;0
2333;1051;44;69;32;3;29;.906;3577000;0
2333;3281;44;0;0;0;0;.00nan;0;0
2333;34788;42;0;0;0;0;.00nan;0;0
2333;37416;42;70;26;2;24;.923;3600000;0
2334;780;52;0;0;0;0;.00nan;0;0
2334;3847;38;68;32;3;29;.906;3600000;0
2334;31021;38;0;0;0;0;.00nan;0;0
2334;32146;52;72;39;4;35;.897;3567000;0
2335;751;64;0;0;0;0;.00nan;0;0
2335;2296;37;56;30;4;26;.867;3600000;0
2335;5146;64;96;39;1;38;.974;3600000;0
2335;5883;37;0;0;0;0;.00nan;0;0
2336;3;50;58;25;3;22;.880;3600000;0
2336;2198;45;0;0;0;0;.00nan;0;0
2336;5048;50;0;0;0;0;.00nan;0;0
2336;34786;45;100;32;0;32;1.000;3600000;0
2337;5182;4619;0;0;0;0;.00nan;0;0
2337;7049;47;44;34;5;29;.853;3600000;0
2337;17360;4619;72;27;2;25;.926;3600000;0
2337;33654;47;0;0;0;0;.00nan;0;0
2338;3626;48;0;0;0;0;.00nan;0;0
2338;20717;60;0;0;0;0;.00nan;0;0
2338;35536;60;62;27;3;24;.889;3577000;0
2338;38547;48;73;29;2;27;.931;3600000;0
2339;2016;61;86;30;1;29;.967;3600000;0
2339;6572;62;0;0;0;0;.00nan;0;0
2339;26919;62;72;31;3;28;.903;3591000;0
2339;30971;61;0;0;0;0;.00nan;0;0
2340;19640;41;84;26;2;24;.923;3600000;0
2340;23075;41;0;0;0;0;.00nan;0;0
2340;28772;53;70;37;4;33;.892;3521000;0
2340;31156;53;0;0;0;0;.00nan;0;0
2341;780;52;54;48;6;42;.875;3600000;0
2341;8046;57;0;0;0;0;.00nan;0;0
2341;26865;57;68;26;3;23;.885;3600000;0
2341;32146;52;0;0;0;0;.00nan;0;0
2342;37;46;0;0;0;0;.00nan;0;0
2342;1592;63;0;0;0;0;.00nan;0;0
2342;2553;46;20;38;8;30;.789;3600000;0
2342;34814;63;64;32;4;28;.875;3600000;0
2343;751;64;61;35;4;31;.886;3599000;0
2343;1486;43;0;0;0;0;.00nan;0;0
2343;3625;43;75;27;2;25;.926;3600000;0
2343;5146;64;0;0;0;0;.00nan;0;0
2344;4338;65;80;37;3;34;.919;3542000;0
2344;4987;65;0;0;0;0;.00nan;0;0
2344;5137;58;0;0;0;0;.00nan;0;0
2344;6847;58;97;37;2;35;.946;3600000;0
2345;1051;44;0;0;0;0;.00nan;0;0
2345;3281;44;76;33;2;31;.939;3600000;0
2345;34788;42;85;46;4;42;.913;3530000;0
2345;37416;42;0;0;0;0;.00nan;0;0
2346;3;50;0;0;0;0;.00nan;0;0
2346;2198;45;0;0;0;0;.00nan;0;0
2346;5048;50;43;32;5;27;.844;3600000;0
2346;34786;45;75;28;2;26;.929;3600000;0
2347;2152;49;65;25;2;23;.920;3600000;0
2347;4435;49;0;0;0;0;.00nan;0;0
2347;14351;40;48;32;4;28;.875;3600000;0
2347;26840;40;0;0;0;0;.00nan;0;0
2348;3626;48;60;25;3;22;.880;3543000;0
2348;20717;60;67;23;2;21;.913;3600000;0
2348;35536;60;0;0;0;0;.00nan;0;0
2348;38547;48;0;0;0;0;.00nan;0;0
2349;6081;56;48;25;3;22;.880;3557000;0
2349;14061;56;0;0;0;0;.00nan;0;0
2349;28772;53;75;28;2;26;.929;3600000;0
2349;31156;53;0;0;0;0;.00nan;0;0
2350;37;46;89;40;3;37;.925;3594000;0
2350;1486;43;0;0;0;0;.00nan;0;0
2350;2553;46;0;0;0;0;.00nan;0;0
2350;3625;43;78;29;2;27;.931;3600000;0
2351;4338;65;35;32;6;26;.813;2838000;0
2351;4987;65;56;6;0;6;1.000;762000;0
2351;8046;57;0;0;0;0;.00nan;0;0
2351;26865;57;76;28;2;26;.929;3600000;0
2352;2900;36;84;31;2;29;.935;3600000;0
2352;5137;58;0;0;0;0;.00nan;0;0
2352;6847;58;87;40;3;37;.925;3594000;0
2352;14874;36;0;0;0;0;.00nan;0;0
2353;1074;51;0;0;0;0;.00nan;0;0
2353;2163;39;0;0;0;0;.00nan;0;0
2353;9238;39;77;35;3;32;.914;3600000;0
2353;23493;51;41;24;4;20;.833;3563000;0
2354;751;64;0;0;0;0;.00nan;0;0
2354;2198;45;0;0;0;0;.00nan;0;0
2354;5146;64;50;39;6;33;.846;3600000;0
2354;34786;45;71;40;5;35;.875;3600000;0
2355;3;50;81;24;1;23;.958;3600000;0
2355;4447;54;54;30;4;26;.867;3600000;0
2355;5048;50;0;0;0;0;.00nan;0;0
2355;31643;54;0;0;0;0;.00nan;0;0
2356;7049;47;0;0;0;0;.00nan;0;0
2356;20717;60;0;0;0;0;.00nan;0;0
2356;33654;47;69;28;2;26;.929;3600000;0
2356;35536;60;75;31;3;28;.903;3600000;0
2357;3626;48;85;43;3;40;.930;3600000;0
2357;14351;40;0;0;0;0;.00nan;0;0
2357;26840;40;58;40;5;35;.875;3573000;0
2357;38547;48;0;0;0;0;.00nan;0;0
2358;2296;37;0;0;0;0;.00nan;0;0
2358;5883;37;79;33;3;30;.909;3600000;0
2358;34788;42;42;23;4;19;.826;3544000;0
2358;37416;42;0;0;0;0;.00nan;0;0
2359;1592;63;100;44;2;42;.955;3600000;0
2359;28772;53;36;25;5;20;.800;3600000;0
2359;31156;53;0;0;0;0;.00nan;0;0
2359;34814;63;0;0;0;0;.00nan;0;0
2360;1074;51;0;0;0;0;.00nan;0;0
2360;1486;43;0;0;0;0;.00nan;0;0
2360;3625;43;68;34;4;30;.882;3895000;0
2360;23493;51;87;57;4;53;.930;3900000;0
2361;2900;36;99;42;1;41;.976;3600000;0
2361;5298;55;0;0;0;0;.00nan;0;0
2361;14874;36;0;0;0;0;.00nan;0;0
2361;34770;55;39;18;3;15;.833;3525000;0
2362;3;50;72;24;2;22;.917;3600000;0
2362;37;46;67;44;4;40;.909;3600000;0
2362;2553;46;0;0;0;0;.00nan;0;0
2362;5048;50;0;0;0;0;.00nan;0;0
2363;780;52;0;0;0;0;.00nan;0;0
2363;8046;57;0;0;0;0;.00nan;0;0
2363;26865;57;91;30;1;29;.967;3600000;0
2363;32146;52;100;30;0;30;1.000;3600000;0
2364;2796;59;0;0;0;0;.00nan;0;0
2364;4338;65;32;28;6;22;.786;2125000;0
2364;4987;65;46;20;3;17;.850;1475000;0
2364;31858;59;94;19;0;19;1.000;3600000;0
2365;5137;58;0;0;0;0;.00nan;0;0
2365;6847;58;81;39;3;36;.923;3557000;0
2365;19640;41;76;29;2;27;.931;3600000;0
2365;23075;41;0;0;0;0;.00nan;0;0
2366;751;64;0;0;0;0;.00nan;0;0
2366;2198;45;48;27;4;23;.852;3600000;0
2366;5146;64;66;25;3;22;.880;3600000;0
2366;34786;45;0;0;0;0;.00nan;0;0
2367;2152;49;73;27;2;25;.926;3900000;0
2367;4435;49;0;0;0;0;.00nan;0;0
2367;6572;62;0;0;0;0;.00nan;0;0
2367;26919;62;100;37;2;35;.946;3900000;0
2368;2016;61;49;35;5;30;.857;3600000;0
2368;20717;60;63;19;2;17;.895;3600000;0
2368;30971;61;0;0;0;0;.00nan;0;0
2368;35536;60;0;0;0;0;.00nan;0;0
2369;1051;44;0;0;0;0;.00nan;0;0
2369;3281;44;82;23;1;22;.957;3600000;0
2369;5182;4619;65;44;5;39;.886;3600000;0
2369;17360;4619;0;0;0;0;.00nan;0;0
2370;3626;48;0;0;0;0;.00nan;0;0
2370;14351;40;0;0;0;0;.00nan;0;0
2370;26840;40;64;24;2;22;.917;3582000;0
2370;38547;48;85;30;1;29;.967;3600000;0
2371;2296;37;49;23;3;20;.870;3669000;0
2371;5883;37;0;0;0;0;.00nan;0;0
2371;34788;42;0;0;0;0;.00nan;0;0
2371;37416;42;58;30;4;26;.867;3669000;0
2372;780;52;0;0;0;0;.00nan;0;0
2372;2796;59;0;0;0;0;.00nan;0;0
2372;31858;59;73;22;2;20;.909;3600000;0
2372;32146;52;43;48;8;40;.833;3600000;0
2373;5137;58;77;34;3;31;.912;3900000;0
2373;6847;58;0;0;0;0;.00nan;0;0
2373;19640;41;0;0;0;0;.00nan;0;0
2373;23075;41;74;29;3;26;.897;3900000;0
2374;1592;63;0;0;0;0;.00nan;0;0
2374;2900;36;0;0;0;0;.00nan;0;0
2374;14874;36;79;35;2;33;.943;3600000;0
2374;34814;63;46;30;4;26;.867;3573000;0
2375;1074;51;0;0;0;0;.00nan;0;0
2375;1486;43;40;36;6;30;.833;3600000;0
2375;3625;43;0;0;0;0;.00nan;0;0
2375;23493;51;58;26;3;23;.885;3600000;0
2376;5298;55;51;37;5;32;.865;3839000;0
2376;6081;56;25;5;3;2;.400;508000;0
2376;14061;56;73;20;1;19;.950;3331000;0
2376;34770;55;0;0;0;0;.00nan;0;0
2377;3;50;69;17;1;16;.941;3600000;0
2377;4447;54;69;26;2;24;.923;3580000;0
2377;5048;50;0;0;0;0;.00nan;0;0
2377;31643;54;0;0;0;0;.00nan;0;0
2378;3847;38;0;0;0;0;.00nan;0;0
2378;8046;57;71;24;1;23;.958;3600000;0
2378;26865;57;0;0;0;0;.00nan;0;0
2378;31021;38;67;31;3;28;.903;3573000;0
2379;2163;39;0;0;0;0;.00nan;0;0
2379;9238;39;43;18;3;15;.833;3549000;0
2379;28772;53;0;0;0;0;.00nan;0;0
2379;31156;53;97;46;2;44;.957;3600000;0
2380;751;64;71;35;4;31;.886;3864000;0
2380;2198;45;0;0;0;0;.00nan;0;0
2380;5146;64;0;0;0;0;.00nan;0;0
2380;34786;45;40;26;5;21;.808;3864000;0
2381;2016;61;0;0;0;0;.00nan;0;0
2381;7049;47;0;0;0;0;.00nan;0;0
2381;30971;61;62;21;2;19;.905;3600000;0
2381;33654;47;72;40;4;36;.900;3594000;0
2382;2152;49;0;0;0;0;.00nan;0;0
2382;4435;49;70;27;2;25;.926;3543000;0
2382;6572;62;80;25;1;24;.960;3600000;0
2382;26919;62;0;0;0;0;.00nan;0;0
2383;1051;44;85;41;3;38;.927;3600000;0
2383;3281;44;0;0;0;0;.00nan;0;0
2383;5182;4619;58;23;2;21;.913;3600000;0
2383;17360;4619;0;0;0;0;.00nan;0;0
2384;3626;48;68;22;2;20;.909;3557000;0
2384;14351;40;100;22;0;22;1.000;3600000;0
2384;26840;40;0;0;0;0;.00nan;0;0
2384;38547;48;0;0;0;0;.00nan;0;0
2385;3847;38;77;25;1;24;.960;3600000;0
2385;4338;65;62;22;2;20;.909;2449000;0
2385;4987;65;44;24;4;20;.833;1151000;0
2385;31021;38;0;0;0;0;.00nan;0;0
2386;1486;43;0;0;0;0;.00nan;0;0
2386;3625;43;34;28;6;22;.786;3556000;0
2386;5298;55;0;0;0;0;.00nan;0;0
2386;34770;55;40;22;4;18;.818;3600000;0
2387;3;50;46;23;4;19;.826;3600000;0
2387;37;46;28;30;6;24;.800;2565000;0
2387;2553;46;51;8;1;7;.875;1035000;0
2387;5048;50;0;0;0;0;.00nan;0;0
2388;1486;43;70;26;3;23;.885;3624000;0
2388;3625;43;27;6;3;3;.500;276000;0
2388;5298;55;0;0;0;0;.00nan;0;0
2388;34770;55;51;34;6;28;.824;3900000;0
2389;1592;63;83;51;5;46;.902;3600000;0
2389;6081;56;0;0;0;0;.00nan;0;0
2389;14061;56;77;27;2;25;.926;3600000;0
2389;34814;63;0;0;0;0;.00nan;0;0
2390;2198;45;0;0;0;0;.00nan;0;0
2390;4447;54;0;0;0;0;.00nan;0;0
2390;31643;54;72;30;2;28;.933;3543000;0
2390;34786;45;93;34;1;33;.971;3600000;0
2391;37;46;0;0;0;0;.00nan;0;0
2391;2553;46;84;38;3;35;.921;3900000;0
2391;34788;42;62;32;3;29;.906;3900000;0
2391;37416;42;0;0;0;0;.00nan;0;0
2392;2152;49;49;29;5;24;.828;3900000;0
2392;4435;49;0;0;0;0;.00nan;0;0
2392;5182;4619;44;28;5;23;.821;3900000;0
2392;17360;4619;0;0;0;0;.00nan;0;0
2393;7049;47;0;0;0;0;.00nan;0;0
2393;20717;60;47;27;4;23;.852;3600000;0
2393;33654;47;91;28;1;27;.964;3600000;0
2393;35536;60;0;0;0;0;.00nan;0;0
2394;1051;44;84;43;3;40;.930;3600000;0
2394;3281;44;0;0;0;0;.00nan;0;0
2394;14351;40;69;25;2;23;.920;3600000;0
2394;26840;40;0;0;0;0;.00nan;0;0
2395;2016;61;79;33;2;31;.939;3873000;0
2395;6572;62;0;0;0;0;.00nan;0;0
2395;26919;62;68;33;3;30;.909;3873000;0
2395;30971;61;0;0;0;0;.00nan;0;0
2396;19640;41;60;49;6;43;.878;3600000;0
2396;23075;41;0;0;0;0;.00nan;0;0
2396;28772;53;92;28;1;27;.964;3600000;0
2396;31156;53;0;0;0;0;.00nan;0;0
2397;780;52;0;0;0;0;.00nan;0;0
2397;5137;58;0;0;0;0;.00nan;0;0
2397;6847;58;55;24;3;21;.875;3865000;0
2397;32146;52;72;37;4;33;.892;3865000;0
2398;2900;36;63;23;3;20;.870;3900000;0
2398;6081;56;55;26;3;23;.885;3900000;0
2398;14061;56;0;0;0;0;.00nan;0;0
2398;14874;36;0;0;0;0;.00nan;0;0
2399;2163;39;0;0;0;0;.00nan;0;0
2399;5298;55;72;38;3;35;.921;3583000;0
2399;9238;39;93;36;2;34;.944;3600000;0
2399;34770;55;0;0;0;0;.00nan;0;0
2400;1074;51;0;0;0;0;.00nan;0;0
2400;1592;63;52;21;3;18;.857;3544000;0
2400;23493;51;82;25;1;24;.960;3600000;0
2400;34814;63;0;0;0;0;.00nan;0;0
2401;37;46;0;0;0;0;.00nan;0;0
2401;751;64;0;0;0;0;.00nan;0;0
2401;2553;46;55;41;5;36;.878;3600000;0
2401;5146;64;87;40;2;38;.950;3600000;0
2402;2796;59;0;0;0;0;.00nan;0;0
2402;3847;38;0;0;0;0;.00nan;0;0
2402;31021;38;58;32;4;28;.875;3568000;0
2402;31858;59;73;34;3;31;.912;3600000;0
2403;4338;65;0;0;0;0;.00nan;0;0
2403;4987;65;59;29;3;26;.897;3600000;0
2403;8046;57;0;0;0;0;.00nan;0;0
2403;26865;57;84;15;0;15;1.000;3600000;0
2404;3;50;0;0;0;0;.00nan;0;0
2404;2198;45;0;0;0;0;.00nan;0;0
2404;5048;50;81;25;1;24;.960;3600000;0
2404;34786;45;69;39;4;35;.897;3600000;0
2405;2152;49;54;27;4;23;.852;3600000;0
2405;4435;49;0;0;0;0;.00nan;0;0
2405;5182;4619;44;31;5;26;.839;3543000;0
2405;17360;4619;0;0;0;0;.00nan;0;0
2406;1051;44;0;0;0;0;.00nan;0;0
2406;3281;44;59;37;4;33;.892;3514000;0
2406;7049;47;0;0;0;0;.00nan;0;0
2406;33654;47;87;33;2;31;.939;3600000;0
2407;2016;61;0;0;0;0;.00nan;0;0
2407;14351;40;0;0;0;0;.00nan;0;0
2407;26840;40;95;35;2;33;.943;3616000;0
2407;30971;61;58;24;3;21;.875;3616000;0
2408;2796;59;50;1;0;1;1.000;891000;0
2408;5137;58;73;34;4;30;.882;3600000;0
2408;6847;58;0;0;0;0;.00nan;0;0
2408;31858;59;17;20;6;14;.700;2624000;0
2409;780;52;0;0;0;0;.00nan;0;0
2409;28772;53;0;0;0;0;.00nan;0;0
2409;31156;53;72;21;1;20;.952;3600000;0
2409;32146;52;98;43;2;41;.953;3600000;0
2410;4338;65;74;48;5;43;.896;3600000;0
2410;4987;65;0;0;0;0;.00nan;0;0
2410;8046;57;0;0;0;0;.00nan;0;0
2410;26865;57;54;20;3;17;.850;3600000;0
2411;1074;51;41;28;5;23;.821;3574000;0
2411;2900;36;0;0;0;0;.00nan;0;0
2411;14874;36;56;24;3;21;.875;3600000;0
2411;23493;51;0;0;0;0;.00nan;0;0
2412;2296;37;0;0;0;0;.00nan;0;0
2412;5883;37;56;30;3;27;.900;3600000;0
2412;34788;42;43;34;6;28;.824;3600000;0
2412;37416;42;0;0;0;0;.00nan;0;0
2413;3;50;85;27;1;26;.963;3600000;0
2413;2198;45;64;28;4;24;.857;3600000;0
2413;5048;50;0;0;0;0;.00nan;0;0
2413;34786;45;0;0;0;0;.00nan;0;0
2414;3847;38;48;19;3;16;.842;3600000;0
2414;19640;41;0;0;0;0;.00nan;0;0
2414;23075;41;70;39;4;35;.897;3600000;0
2414;31021;38;0;0;0;0;.00nan;0;0
2415;1486;43;0;0;0;0;.00nan;0;0
2415;2163;39;88;36;2;34;.944;3842000;0
2415;3625;43;86;27;1;26;.963;3842000;0
2415;9238;39;0;0;0;0;.00nan;0;0
2416;751;64;100;46;0;46;1.000;3600000;0
2416;4447;54;56;21;2;19;.905;3582000;0
2416;5146;64;0;0;0;0;.00nan;0;0
2416;31643;54;0;0;0;0;.00nan;0;0
2417;2152;49;0;0;0;0;.00nan;0;0
2417;4435;49;53;29;5;24;.828;3600000;0
2417;5182;4619;0;0;0;0;.00nan;0;0
2417;17360;4619;20;37;8;29;.784;3600000;0
2418;7049;47;55;38;5;33;.868;3600000;0
2418;14351;40;80;26;1;25;.962;3600000;0
2418;26840;40;0;0;0;0;.00nan;0;0
2418;33654;47;0;0;0;0;.00nan;0;0
2419;1051;44;69;26;2;24;.923;3600000;0
2419;3281;44;0;0;0;0;.00nan;0;0
2419;6572;62;85;50;5;45;.900;3600000;0
2419;26919;62;0;0;0;0;.00nan;0;0
2420;3626;48;0;0;0;0;.00nan;0;0
2420;20717;60;0;0;0;0;.00nan;0;0
2420;35536;60;78;36;3;33;.917;3877000;0
2420;38547;48;66;41;4;37;.902;3877000;0
2421;3847;38;0;0;0;0;.00nan;0;0
2421;5137;58;0;0;0;0;.00nan;0;0
2421;6847;58;100;23;0;23;1.000;3600000;0
2421;31021;38;63;34;4;30;.882;3600000;0
2422;2796;59;0;0;0;0;.00nan;0;0
2422;28772;53;41;29;6;23;.793;3600000;0
2422;31156;53;0;0;0;0;.00nan;0;0
2422;31858;59;84;40;3;37;.925;3600000;0
2423;1486;43;56;30;4;26;.867;3575000;0
2423;2163;39;0;0;0;0;.00nan;0;0
2423;3625;43;0;0;0;0;.00nan;0;0
2423;9238;39;95;41;3;38;.927;3600000;0
2424;1592;63;75;30;2;28;.933;3600000;0
2424;6081;56;0;0;0;0;.00nan;0;0
2424;14061;56;90;41;3;38;.927;3600000;0
2424;34814;63;0;0;0;0;.00nan;0;0
2425;2296;37;0;0;0;0;.00nan;0;0
2425;4447;54;0;0;0;0;.00nan;0;0
2425;5883;37;67;47;5;42;.894;3600000;0
2425;31643;54;65;23;2;21;.913;3600000;0
2426;37;46;68;34;4;30;.882;3900000;0
2426;751;64;68;35;4;31;.886;3900000;0
2426;2553;46;0;0;0;0;.00nan;0;0
2426;5146;64;0;0;0;0;.00nan;0;0
2427;2900;36;65;15;1;14;.933;3600000;0
2427;4338;65;0;0;0;0;.00nan;0;0
2427;4987;65;60;31;4;27;.871;3600000;0
2427;14874;36;0;0;0;0;.00nan;0;0
2428;3;50;0;0;0;0;.00nan;0;0
2428;5048;50;83;22;0;22;1.000;3600000;0
2428;34788;42;0;0;0;0;.00nan;0;0
2428;37416;42;98;50;1;49;.980;3582000;0
2429;3626;48;72;26;2;24;.923;3600000;0
2429;20717;60;56;34;4;30;.882;3566000;0
2429;35536;60;0;0;0;0;.00nan;0;0
2429;38547;48;0;0;0;0;.00nan;0;0
2925;2152;49;35;24;5;19;.792;2146000;0
2925;4435;49;63;11;0;11;1.000;1454000;0
2925;23493;51;0;0;0;0;.00nan;0;0
2925;31822;51;100;51;1;50;.980;3600000;0
2927;2796;59;0;0;0;0;.00nan;0;0
2927;5298;55;0;0;0;0;.00nan;0;0
2927;31858;59;98;36;1;35;.972;3568000;0
2927;34770;55;100;23;0;23;1.000;3600000;0
2929;20717;60;12;4;4;0;.000;483000;0
2929;34788;42;0;0;0;0;.00nan;0;0
2929;35536;60;76;26;1;25;.962;3038000;0
2929;37416;42;53;28;3;25;.893;3600000;0
2931;3;50;0;0;0;0;.00nan;0;0
2931;2900;36;0;0;0;0;.00nan;0;0
2931;5048;50;61;28;3;25;.893;3719000;0
2931;14874;36;69;26;2;24;.923;3719000;0
2933;1592;63;88;32;1;31;.969;3600000;0
2933;2296;37;0;0;0;0;.00nan;0;0
2933;5883;37;72;31;2;29;.935;3600000;0
2933;26967;63;0;0;0;0;.00nan;0;0
2935;37;46;0;0;0;0;.00nan;0;0
2935;2553;46;65;28;3;25;.893;3900000;0
2935;8046;57;84;42;3;39;.929;3900000;0
2935;26865;57;0;0;0;0;.00nan;0;0
2937;2163;39;0;0;0;0;.00nan;0;0
2937;9238;39;67;30;4;26;.867;3900000;0
2937;14351;40;79;40;4;36;.900;3900000;0
2937;26840;40;0;0;0;0;.00nan;0;0
2939;780;52;0;0;0;0;.00nan;0;0
2939;4338;65;0;0;0;0;.00nan;0;0
2939;4987;65;77;31;3;28;.903;3900000;0
2939;23255;52;77;38;3;35;.921;3900000;0
2941;1051;44;0;0;0;0;.00nan;0;0
2941;3281;44;53;33;5;28;.848;3600000;0
2941;6572;62;64;19;2;17;.895;3600000;0
2941;26919;62;0;0;0;0;.00nan;0;0
2943;4447;54;0;0;0;0;.00nan;0;0
2943;28772;53;95;34;2;32;.941;3900000;0
2943;31156;53;0;0;0;0;.00nan;0;0
2943;31643;54;93;38;2;36;.947;3900000;0
2945;3847;38;0;0;0;0;.00nan;0;0
2945;5137;58;0;0;0;0;.00nan;0;0
2945;14321;58;94;31;1;30;.968;3600000;0
2945;31021;38;91;39;2;37;.949;3598000;0
2947;376;45;0;0;0;0;.00nan;0;0
2947;2016;61;87;37;3;34;.919;3557000;0
2947;2198;45;76;23;1;22;.957;3600000;0
2947;30971;61;0;0;0;0;.00nan;0;0
2949;5146;64;45;25;4;21;.840;3600000;0
2949;19640;41;65;37;3;34;.919;3600000;0
2949;23075;41;0;0;0;0;.00nan;0;0
2949;28845;64;0;0;0;0;.00nan;0;0
2951;3626;48;58;23;3;20;.870;3600000;0
2951;4716;4619;50;28;4;24;.857;3570000;0
2951;35210;4619;0;0;0;0;.00nan;0;0
2951;38547;48;0;0;0;0;.00nan;0;0
2953;6081;56;90;28;1;27;.964;3600000;0
2953;7049;47;64;29;4;25;.862;3600000;0
2953;26824;56;0;0;0;0;.00nan;0;0
2953;33654;47;0;0;0;0;.00nan;0;0
2955;2163;39;75;27;2;25;.926;3600000;0
2955;9238;39;0;0;0;0;.00nan;0;0
2955;20717;60;63;35;4;31;.886;3562000;0
2955;35536;60;0;0;0;0;.00nan;0;0
2957;3847;38;0;0;0;0;.00nan;0;0
2957;5298;55;0;0;0;0;.00nan;0;0
2957;31021;38;59;28;3;25;.893;3543000;0
2957;34770;55;85;31;1;30;.968;3600000;0
2959;1486;43;76;28;2;26;.929;3515000;0
2959;1592;63;100;37;0;37;1.000;3600000;0
2959;3625;43;0;0;0;0;.00nan;0;0
2959;26967;63;0;0;0;0;.00nan;0;0
2961;3;50;85;38;3;35;.921;3900000;0
2961;2152;49;79;37;3;34;.919;3900000;0
2961;4435;49;0;0;0;0;.00nan;0;0
2961;5048;50;0;0;0;0;.00nan;0;0
2963;2016;61;0;0;0;0;.00nan;0;0
2963;4447;54;98;25;0;25;1.000;3600000;0
2963;30971;61;54;36;4;32;.889;3600000;0
2963;31643;54;0;0;0;0;.00nan;0;0
2965;1051;44;60;18;2;16;.889;3600000;0
2965;3281;44;0;0;0;0;.00nan;0;0
2965;34788;42;64;30;3;27;.900;3566000;0
2965;37416;42;0;0;0;0;.00nan;0;0
2967;2796;59;0;0;0;0;.00nan;0;0
2967;19640;41;48;31;5;26;.839;2314000;0
2967;23075;41;53;17;2;15;.882;1286000;0
2967;31858;59;70;24;3;21;.875;3600000;0
2969;2296;37;0;0;0;0;.00nan;0;0
2969;5883;37;55;31;3;28;.903;3600000;0
2969;7049;47;0;0;0;0;.00nan;0;0
2969;33654;47;63;20;2;18;.900;3600000;0
2971;37;46;48;29;4;25;.862;3638000;0
2971;2553;46;0;0;0;0;.00nan;0;0
2971;28772;53;0;0;0;0;.00nan;0;0
2971;31156;53;58;24;3;21;.875;3638000;0
2973;2900;36;77;26;1;25;.962;3600000;0
2973;3626;48;63;7;0;7;1.000;1169000;0
2973;14874;36;0;0;0;0;.00nan;0;0
2973;38547;48;24;26;6;20;.769;2431000;0
2975;4338;65;0;0;0;0;.00nan;0;0
2975;4987;65;78;31;2;29;.935;3600000;0
2975;6572;62;0;0;0;0;.00nan;0;0
2975;26919;62;36;25;5;20;.800;3600000;0
2977;8046;57;0;0;0;0;.00nan;0;0
2977;14351;40;0;0;0;0;.00nan;0;0
2977;26840;40;72;34;4;30;.882;3600000;0
2977;26865;57;59;38;5;33;.868;3600000;0
2979;376;45;74;29;2;27;.931;3715000;0
2979;2198;45;0;0;0;0;.00nan;0;0
2979;23493;51;98;39;1;38;.974;3715000;0
2979;31822;51;0;0;0;0;.00nan;0;0
2981;4716;4619;0;0;0;0;.00nan;0;0
2981;5146;64;0;0;0;0;.00nan;0;0
2981;28845;64;91;45;2;43;.956;3900000;0
2981;35210;4619;74;29;2;27;.931;3900000;0
2983;5137;58;0;0;0;0;.00nan;0;0
2983;6081;56;0;0;0;0;.00nan;0;0
2983;14321;58;76;25;2;23;.920;3644000;0
2983;26824;56;91;32;1;31;.969;3644000;0
2985;1486;43;0;0;0;0;.00nan;0;0
2985;3625;43;38;15;3;12;.800;3600000;0
2985;20717;60;55;3;0;3;1.000;1083000;0
2985;35536;60;32;30;6;24;.800;2517000;0
2987;1592;63;0;0;0;0;.00nan;0;0
2987;2796;59;48;43;7;36;.837;3600000;0
2987;26967;63;49;14;2;12;.857;3600000;0
2987;31858;59;0;0;0;0;.00nan;0;0
2989;4447;54;40;20;4;16;.800;3573000;0
2989;5146;64;75;37;3;34;.919;3600000;0
2989;28845;64;0;0;0;0;.00nan;0;0
2989;31643;54;0;0;0;0;.00nan;0;0
2991;3;50;0;0;0;0;.00nan;0;0
2991;4338;65;62;32;4;28;.875;3900000;0
2991;4987;65;0;0;0;0;.00nan;0;0
2991;5048;50;54;32;4;28;.875;3900000;0
2993;780;52;0;0;0;0;.00nan;0;0
2993;3626;48;25;7;3;4;.571;146000;0
2993;23255;52;58;27;3;24;.889;3600000;0
2993;38547;48;74;34;3;31;.912;3454000;0
2995;376;45;0;0;0;0;.00nan;0;0
2995;2198;45;52;27;4;23;.852;3747000;0
2995;28772;53;75;46;5;41;.891;3747000;0
2995;31156;53;0;0;0;0;.00nan;0;0
2997;1051;44;0;0;0;0;.00nan;0;0
2997;3281;44;53;24;3;21;.875;3600000;0
2997;14351;40;56;30;4;26;.867;3599000;0
2997;26840;40;0;0;0;0;.00nan;0;0
2999;2016;61;53;34;5;29;.853;3600000;0
2999;4716;4619;68;26;2;24;.923;3600000;0
2999;30971;61;0;0;0;0;.00nan;0;0
2999;35210;4619;0;0;0;0;.00nan;0;0
3001;37;46;0;0;0;0;.00nan;0;0
3001;2553;46;60;28;3;25;.893;3600000;0
3001;23493;51;62;20;2;18;.900;2453000;0
3001;31822;51;26;12;4;8;.667;1147000;0
3003;2163;39;0;0;0;0;.00nan;0;0
3003;2900;36;0;0;0;0;.00nan;0;0
3003;9238;39;52;34;5;29;.853;3600000;0
3003;14874;36;100;32;0;32;1.000;3600000;0
3005;6572;62;50;30;5;25;.833;3900000;0
3005;19640;41;0;0;0;0;.00nan;0;0
3005;23075;41;63;40;5;35;.875;3900000;0
3005;26919;62;0;0;0;0;.00nan;0;0
3007;3847;38;54;24;3;21;.875;3600000;0
3007;5137;58;50;31;4;27;.871;3555000;0
3007;14321;58;0;0;0;0;.00nan;0;0
3007;31021;38;0;0;0;0;.00nan;0;0
3009;5298;55;79;22;1;21;.955;3545000;0
3009;7049;47;100;35;0;35;1.000;3600000;0
3009;33654;47;0;0;0;0;.00nan;0;0
3009;34770;55;0;0;0;0;.00nan;0;0
3011;6081;56;82;26;1;25;.962;3600000;0
3011;26824;56;0;0;0;0;.00nan;0;0
3011;34788;42;0;0;0;0;.00nan;0;0
3011;37416;42;65;32;3;29;.906;3535000;0
3013;2152;49;0;0;0;0;.00nan;0;0
3013;4435;49;68;25;2;23;.920;3553000;0
3013;8046;57;99;35;1;34;.971;3600000;0
3013;26865;57;0;0;0;0;.00nan;0;0
3015;780;52;0;0;0;0;.00nan;0;0
3015;5146;64;76;42;4;38;.905;3600000;0
3015;23255;52;100;32;0;32;1.000;3600000;0
3015;28845;64;0;0;0;0;.00nan;0;0
3017;1051;44;99;33;1;32;.970;3600000;0
3017;3281;44;0;0;0;0;.00nan;0;0
3017;8046;57;59;21;2;19;.905;3548000;0
3017;26865;57;0;0;0;0;.00nan;0;0
3019;4716;4619;0;0;0;0;.00nan;0;0
3019;28772;53;0;0;0;0;.00nan;0;0
3019;31156;53;70;44;5;39;.886;3600000;0
3019;35210;4619;56;20;2;18;.900;3600000;0
3021;3847;38;0;0;0;0;.00nan;0;0
3021;6572;62;0;0;0;0;.00nan;0;0
3021;26919;62;76;34;3;31;.912;3561000;0
3021;31021;38;89;23;1;22;.957;3600000;0
3023;2152;49;75;32;2;30;.938;3600000;0
3023;4338;65;0;0;0;0;.00nan;0;0
3023;4435;49;0;0;0;0;.00nan;0;0
3023;4987;65;96;19;0;19;1.000;3600000;0
3025;2796;59;0;0;0;0;.00nan;0;0
3025;7049;47;45;40;6;34;.850;3600000;0
3025;31858;59;80;27;2;25;.926;3600000;0
3025;33654;47;0;0;0;0;.00nan;0;0
3027;37;46;46;25;4;21;.840;3548000;0
3027;2553;46;0;0;0;0;.00nan;0;0
3027;6081;56;0;0;0;0;.00nan;0;0
3027;26824;56;68;34;3;31;.912;3600000;0
3029;1486;43;48;21;3;18;.857;3600000;0
3029;3625;43;0;0;0;0;.00nan;0;0
3029;4447;54;0;0;0;0;.00nan;0;0
3029;31643;54;65;39;4;35;.897;3558000;0
3031;20717;60;85;24;1;23;.958;3600000;0
3031;34788;42;0;0;0;0;.00nan;0;0
3031;35536;60;0;0;0;0;.00nan;0;0
3031;37416;42;79;33;2;31;.939;3600000;0
3033;3;50;66;31;3;28;.903;3900000;0
3033;2900;36;0;0;0;0;.00nan;0;0
3033;5048;50;0;0;0;0;.00nan;0;0
3033;14874;36;86;48;3;45;.938;3900000;0
3035;2163;39;75;30;4;26;.867;3600000;0
3035;5298;55;0;0;0;0;.00nan;0;0
3035;9238;39;0;0;0;0;.00nan;0;0
3035;34770;55;47;30;6;24;.800;3546000;0
3037;5137;58;0;0;0;0;.00nan;0;0
3037;14321;58;37;27;5;22;.815;3600000;0
3037;14351;40;0;0;0;0;.00nan;0;0
3037;26840;40;68;26;2;24;.923;3600000;0
3039;376;45;0;0;0;0;.00nan;0;0
3039;2016;61;0;0;0;0;.00nan;0;0
3039;2198;45;100;34;1;33;.971;3600000;0
3039;30971;61;55;21;2;19;.905;3557000;0
3041;1592;63;67;24;2;22;.917;3600000;0
3041;2296;37;34;37;6;31;.838;3600000;0
3041;5883;37;0;0;0;0;.00nan;0;0
3041;26967;63;0;0;0;0;.00nan;0;0
3043;19640;41;0;0;0;0;.00nan;0;0
3043;23075;41;60;18;2;16;.889;3600000;0
3043;23493;51;75;44;4;40;.909;3559000;0
3043;31822;51;0;0;0;0;.00nan;0;0
3045;3847;38;72;44;5;39;.886;3600000;0
3045;6081;56;100;35;1;34;.971;3600000;0
3045;26824;56;0;0;0;0;.00nan;0;0
3045;31021;38;0;0;0;0;.00nan;0;0
3047;5137;58;69;20;1;19;.950;3600000;0
3047;14321;58;0;0;0;0;.00nan;0;0
3047;14351;40;36;23;4;19;.826;3600000;0
3047;26840;40;0;0;0;0;.00nan;0;0
3049;5298;55;79;23;1;22;.957;3900000;0
3049;6572;62;74;24;1;23;.958;3900000;0
3049;26919;62;0;0;0;0;.00nan;0;0
3049;34770;55;0;0;0;0;.00nan;0;0
3051;1051;44;0;0;0;0;.00nan;0;0
3051;2152;49;0;0;0;0;.00nan;0;0
3051;3281;44;76;25;1;24;.960;3600000;0
3051;4435;49;30;29;6;23;.793;3600000;0
3053;3626;48;0;0;0;0;.00nan;0;0
3053;4447;54;73;24;1;23;.958;3600000;0
3053;31643;54;0;0;0;0;.00nan;0;0
3053;38547;48;73;28;2;26;.929;3573000;0
3055;780;52;0;0;0;0;.00nan;0;0
3055;23255;52;91;33;1;32;.970;3600000;0
3055;34788;42;51;29;4;25;.862;3600000;0
3055;37416;42;0;0;0;0;.00nan;0;0
3057;8046;57;0;0;0;0;.00nan;0;0
3057;26865;57;82;35;3;32;.914;3900000;0
3057;28772;53;62;31;3;28;.903;3900000;0
3057;31156;53;0;0;0;0;.00nan;0;0
3059;2016;61;73;33;3;30;.909;3722000;0
3059;2296;37;0;0;0;0;.00nan;0;0
3059;5883;37;87;36;2;34;.944;3722000;0
3059;30971;61;0;0;0;0;.00nan;0;0
3061;4716;4619;60;24;2;22;.917;3600000;0
3061;5146;64;45;8;1;7;.875;484000;0
3061;28845;64;41;29;5;24;.828;3116000;0
3061;35210;4619;0;0;0;0;.00nan;0;0
3063;2900;36;70;28;2;26;.929;3600000;0
3063;14874;36;0;0;0;0;.00nan;0;0
3063;20717;60;0;0;0;0;.00nan;0;0
3063;35536;60;28;42;8;34;.810;3600000;0
3065;1592;63;0;0;0;0;.00nan;0;0
3065;4338;65;68;26;2;24;.923;3600000;0
3065;4987;65;0;0;0;0;.00nan;0;0
3065;26967;63;64;30;3;27;.900;3547000;0
3067;37;46;0;0;0;0;.00nan;0;0
3067;2553;46;77;32;3;29;.906;3600000;0
3067;23493;51;0;0;0;0;.00nan;0;0
3067;31822;51;42;34;5;29;.853;3518000;0
3069;3;50;0;0;0;0;.00nan;0;0
3069;5048;50;71;16;1;15;.938;3600000;0
3069;7049;47;0;0;0;0;.00nan;0;0
3069;33654;47;44;31;5;26;.839;3600000;0
3071;2796;59;65;33;4;29;.879;3830000;0
3071;19640;41;57;36;5;31;.861;3830000;0
3071;23075;41;0;0;0;0;.00nan;0;0
3071;31858;59;0;0;0;0;.00nan;0;0
3073;376;45;72;24;1;23;.958;3600000;0
3073;2163;39;0;0;0;0;.00nan;0;0
3073;2198;45;0;0;0;0;.00nan;0;0
3073;9238;39;69;30;3;27;.900;3563000;0
3075;1051;44;93;39;3;36;.923;3900000;0
3075;3281;44;0;0;0;0;.00nan;0;0
3075;5298;55;0;0;0;0;.00nan;0;0
3075;34770;55;56;20;3;17;.850;3900000;0
3077;37;46;75;28;2;26;.929;3524000;0
3077;2163;39;100;29;0;29;1.000;3600000;0
3077;2553;46;0;0;0;0;.00nan;0;0
3077;9238;39;0;0;0;0;.00nan;0;0
3079;780;52;0;0;0;0;.00nan;0;0
3079;6081;56;0;0;0;0;.00nan;0;0
3079;23255;52;34;34;6;28;.824;3600000;0
3079;26824;56;49;36;5;31;.861;3600000;0
3081;3626;48;69;46;5;41;.891;3600000;0
3081;6572;62;0;0;0;0;.00nan;0;0
3081;26919;62;73;27;2;25;.926;3600000;0
3081;38547;48;0;0;0;0;.00nan;0;0
3083;2900;36;0;0;0;0;.00nan;0;0
3083;14874;36;35;18;4;14;.778;3562000;0
3083;19640;41;82;41;3;38;.927;3600000;0
3083;23075;41;0;0;0;0;.00nan;0;0
3085;4447;54;0;0;0;0;.00nan;0;0
3085;7049;47;46;19;3;16;.842;3900000;0
3085;31643;54;59;21;3;18;.857;3900000;0
3085;33654;47;0;0;0;0;.00nan;0;0
3087;2296;37;0;0;0;0;.00nan;0;0
3087;2796;59;0;0;0;0;.00nan;0;0
3087;5883;37;77;26;2;24;.923;3600000;0
3087;31858;59;78;30;1;29;.967;3600000;0
3089;1486;43;0;0;0;0;.00nan;0;0
3089;3625;43;72;25;2;23;.920;3600000;0
3089;5146;64;50;37;6;31;.838;3600000;0
3089;28845;64;0;0;0;0;.00nan;0;0
3091;1592;63;0;0;0;0;.00nan;0;0
3091;3847;38;0;0;0;0;.00nan;0;0
3091;26967;63;63;28;3;25;.893;3600000;0
3091;31021;38;100;49;2;47;.959;3600000;0
3093;2016;61;27;33;7;26;.788;3600000;0
3093;4716;4619;0;0;0;0;.00nan;0;0
3093;30971;61;0;0;0;0;.00nan;0;0
3093;35210;4619;66;16;1;15;.938;3600000;0
3095;376;45;66;27;3;24;.889;3900000;0
3095;2198;45;0;0;0;0;.00nan;0;0
3095;4338;65;67;24;3;21;.875;3900000;0
3095;4987;65;0;0;0;0;.00nan;0;0
3097;3;50;78;29;2;27;.931;3900000;0
3097;5048;50;0;0;0;0;.00nan;0;0
3097;5137;58;0;0;0;0;.00nan;0;0
3097;14321;58;73;29;2;27;.931;3900000;0
3099;23493;51;0;0;0;0;.00nan;0;0
3099;28772;53;0;0;0;0;.00nan;0;0
3099;31156;53;66;36;4;32;.889;3900000;0
3099;31822;51;60;29;4;25;.862;3900000;0
3101;2152;49;66;38;4;34;.895;3600000;0
3101;4435;49;0;0;0;0;.00nan;0;0
3101;8046;57;35;29;6;23;.793;2586000;0
3101;26865;57;51;13;2;11;.846;1014000;0
3103;20717;60;0;0;0;0;.00nan;0;0
3103;34788;42;0;0;0;0;.00nan;0;0
3103;35536;60;100;28;0;28;1.000;3600000;0
3103;37416;42;80;46;4;42;.913;3600000;0
3105;14874;36;90;43;3;40;.930;3600000;0
3105;22970;38;44;30;5;25;.833;3567000;0
3105;31021;38;0;0;0;0;.00nan;0;0
3105;42825;36;0;0;0;0;.00nan;0;0
3107;4716;4619;50;31;4;27;.871;3600000;0
3107;8046;57;0;0;0;0;.00nan;0;0
3107;26865;57;100;26;0;26;1.000;3600000;0
3107;35210;4619;0;0;0;0;.00nan;0;0
3109;714;51;0;0;0;0;.00nan;0;0
3109;30971;61;82;24;1;23;.958;3727000;0
3109;31822;51;94;40;2;38;.950;3727000;0
3109;35538;61;0;0;0;0;.00nan;0;0
3111;6572;62;21;3;3;0;.000;139000;0
3111;26919;62;86;39;3;36;.923;3461000;0
3111;31858;59;0;0;0;0;.00nan;0;0
3111;34819;59;71;23;2;21;.913;3600000;0
3113;3;50;0;0;0;0;.00nan;0;0
3113;3625;43;0;0;0;0;.00nan;0;0
3113;5571;50;85;28;1;27;.964;3600000;0
3113;36324;43;67;34;3;31;.912;3563000;0
3115;4447;54;41;24;5;19;.792;3900000;0
3115;7523;40;75;49;5;44;.898;3900000;0
3115;14351;40;0;0;0;0;.00nan;0;0
3115;35595;54;0;0;0;0;.00nan;0;0
3117;20717;60;0;0;0;0;.00nan;0;0
3117;28845;64;69;35;4;31;.886;3900000;0
3117;32826;64;0;0;0;0;.00nan;0;0
3117;35536;60;69;33;4;29;.879;3857000;0
3119;3626;48;0;0;0;0;.00nan;0;0
3119;5883;37;0;0;0;0;.00nan;0;0
3119;23043;37;67;26;3;23;.885;3600000;0
3119;38547;48;80;16;0;16;1.000;3600000;0
3121;14321;58;0;0;0;0;.00nan;0;0
3121;23075;41;58;13;1;12;.923;3600000;0
3121;26622;58;63;36;4;32;.889;3600000;0
3121;51213;41;0;0;0;0;.00nan;0;0
3123;3281;44;97;37;1;36;.973;3600000;0
3123;6081;56;56;20;2;18;.900;3544000;0
3123;26824;56;0;0;0;0;.00nan;0;0
3123;31545;44;0;0;0;0;.00nan;0;0
3125;7049;47;0;0;0;0;.00nan;0;0
3125;9238;39;47;33;5;28;.848;3560000;0
3125;31408;39;0;0;0;0;.00nan;0;0
3125;33654;47;69;39;4;35;.897;3600000;0
3127;5298;55;63;27;3;24;.889;3900000;0
3127;28772;53;74;35;3;32;.914;3900000;0
3127;31156;53;0;0;0;0;.00nan;0;0
3127;34770;55;0;0;0;0;.00nan;0;0
3129;37;46;49;46;7;39;.848;3600000;0
3129;26929;46;0;0;0;0;.00nan;0;0
3129;26967;63;0;0;0;0;.00nan;0;0
3129;31433;63;100;27;0;27;1.000;3600000;0
3131;23255;52;0;0;0;0;.00nan;0;0
3131;31126;52;62;24;2;22;.917;3600000;0
3131;34788;42;68;37;4;33;.892;3557000;0
3131;37416;42;0;0;0;0;.00nan;0;0
3133;4435;49;68;38;4;34;.895;3900000;0
3133;21469;65;0;0;0;0;.00nan;0;0
3133;38817;49;0;0;0;0;.00nan;0;0
3133;40296;65;88;35;4;31;.886;3900000;0
