Game Id;PlayerId;TeamId;Game Rating;SA;GA;SV;SV%;TOI;PIM
0;233;29;0;0;0;0;.00nan;0;0
0;2423;15;0;0;0;0;.00nan;0;0
0;4106;15;47;31;4;27;.871;3600000;0
0;18351;29;43;35;6;29;.829;3548000;0
1;500;4182;70;20;1;19;.950;3600000;0
1;1572;4838;73;35;4;31;.886;3600000;0
1;2328;4838;0;0;0;0;.00nan;0;0
1;25521;4182;0;0;0;0;.00nan;0;0
2;1074;0;0;0;0;0;.00nan;0;0
2;1821;3;79;29;1;28;.966;3600000;0
2;2054;3;0;0;0;0;.00nan;0;0
2;31035;0;89;43;4;39;.907;3600000;0
3;18104;10;0;0;0;0;.00nan;0;0
3;27488;10;71;37;3;34;.919;3900000;0
3;27739;22;0;0;0;0;.00nan;0;0
3;28026;22;76;33;3;30;.909;3900000;0
4;1614;25;66;22;2;20;.909;3600000;0
4;5182;25;0;0;0;0;.00nan;0;0
4;15505;8;0;0;0;0;.00nan;0;0
4;25076;8;42;44;7;37;.841;3600000;0
5;335;18;67;20;2;18;.900;3600000;0
5;823;23;42;33;6;27;.818;3600000;0
5;5001;18;0;0;0;0;.00nan;0;0
5;10274;23;0;0;0;0;.00nan;0;0
6;1074;0;98;25;0;25;1.000;3600000;0
6;2163;17;0;0;0;0;.00nan;0;0
6;31035;0;0;0;0;0;.00nan;0;0
6;34006;17;70;24;1;23;.958;3600000;0
7;1821;3;0;0;0;0;.00nan;0;0
7;2054;3;41;25;5;20;.800;3600000;0
7;2058;28;23;23;6;17;.739;2806000;0
7;14061;28;57;8;0;8;1.000;762000;0
8;233;29;72;21;1;20;.952;3600000;0
8;323;9;46;31;5;26;.839;3600000;0
8;376;9;0;0;0;0;.00nan;0;0
8;18351;29;0;0;0;0;.00nan;0;0
9;61;31;0;0;0;0;.00nan;0;0
9;2423;15;0;0;0;0;.00nan;0;0
9;4106;15;94;41;2;39;.951;3569000;0
9;34797;31;97;35;1;34;.971;3600000;0
10;445;12;0;0;0;0;.00nan;0;0
10;18104;10;100;33;1;32;.970;3600000;0
10;27488;10;0;0;0;0;.00nan;0;0
10;34786;12;48;30;4;26;.867;3600000;0
11;10103;24;0;0;0;0;.00nan;0;0
11;13979;24;55;30;4;26;.867;3576000;0
11;18078;20;65;32;3;29;.906;3600000;0
11;32146;20;0;0;0;0;.00nan;0;0
12;13842;34;0;0;0;0;.00nan;0;0
12;15502;34;56;36;4;32;.889;3599000;0
12;22601;26;0;0;0;0;.00nan;0;0
12;32754;26;53;19;2;17;.895;3600000;0
13;1572;4838;84;41;3;38;.927;3580000;0
13;2328;4838;0;0;0;0;.00nan;0;0
13;15464;32;0;0;0;0;.00nan;0;0
13;16006;32;60;16;2;14;.875;3600000;0
14;1913;30;91;36;2;34;.944;3600000;0
14;4506;33;0;0;0;0;.00nan;0;0
14;4826;30;0;0;0;0;.00nan;0;0
14;34740;33;68;28;3;25;.893;3564000;0
15;500;4182;59;27;3;24;.889;3600000;0
15;724;11;98;30;0;30;1.000;2846000;0
15;21522;11;17;9;4;5;.556;709000;0
15;25521;4182;0;0;0;0;.00nan;0;0
16;51;21;65;28;3;25;.893;3600000;0
16;15505;8;26;14;4;10;.714;978000;0
16;25076;8;17;30;7;23;.767;2622000;0
16;25843;21;0;0;0;0;.00nan;0;0
17;335;18;66;34;4;30;.882;3600000;0
17;1251;14;44;32;5;27;.844;3551000;0
17;5001;18;0;0;0;0;.00nan;0;0
17;8046;14;0;0;0;0;.00nan;0;0
18;262;35;0;0;0;0;.00nan;0;0
18;1430;35;87;36;2;34;.944;3600000;0
18;1913;30;0;0;0;0;.00nan;0;0
18;4826;30;33;23;5;18;.783;3600000;0
19;445;12;0;0;0;0;.00nan;0;0
19;4450;5;0;0;0;0;.00nan;0;0
19;19823;5;88;18;0;18;1.000;3600000;0
19;34786;12;77;41;4;37;.902;3600000;0
20;2163;17;0;0;0;0;.00nan;0;0
20;22601;26;74;26;2;24;.923;3600000;0
20;32754;26;0;0;0;0;.00nan;0;0
20;34006;17;65;33;3;30;.909;3561000;0
21;1821;3;0;0;0;0;.00nan;0;0
21;2054;3;91;29;1;28;.966;3600000;0
21;2058;28;0;0;0;0;.00nan;0;0
21;14061;28;72;48;5;43;.896;3600000;0
22;1074;0;90;40;1;39;.975;3600000;0
22;18104;10;65;23;2;21;.913;3581000;0
22;27488;10;0;0;0;0;.00nan;0;0
22;31035;0;0;0;0;0;.00nan;0;0
23;323;9;62;19;2;17;.895;3600000;0
23;335;18;0;0;0;0;.00nan;0;0
23;376;9;0;0;0;0;.00nan;0;0
23;5001;18;70;41;4;37;.902;3562000;0
24;61;31;0;0;0;0;.00nan;0;0
24;18078;20;0;0;0;0;.00nan;0;0
24;32146;20;73;33;3;30;.909;3600000;0
24;34797;31;42;30;5;25;.833;3522000;0
25;2423;15;0;0;0;0;.00nan;0;0
25;4106;15;69;21;1;20;.952;3600000;0
25;15505;8;23;21;5;16;.762;1346000;0
25;25076;8;58;19;2;17;.895;2254000;0
26;233;29;57;31;4;27;.871;3572000;0
26;18351;29;0;0;0;0;.00nan;0;0
26;27739;22;84;42;2;40;.952;3600000;0
26;28026;22;0;0;0;0;.00nan;0;0
27;1572;4838;0;0;0;0;.00nan;0;0
27;2328;4838;83;27;1;26;.963;3600000;0
27;13842;34;0;0;0;0;.00nan;0;0
27;15502;34;89;37;3;34;.919;3535000;0
28;10103;24;0;0;0;0;.00nan;0;0
28;13979;24;48;23;4;19;.826;3682000;0
28;15464;32;0;0;0;0;.00nan;0;0
28;16006;32;73;32;3;29;.906;3682000;0
29;1614;25;86;29;1;28;.966;3600000;0
29;1796;16;75;29;2;27;.931;3600000;0
29;5182;25;0;0;0;0;.00nan;0;0
29;15437;16;0;0;0;0;.00nan;0;0
30;544;19;99;23;0;23;1.000;3600000;0
30;823;23;0;0;0;0;.00nan;0;0
30;10274;23;96;42;2;40;.952;3586000;0
30;31124;19;0;0;0;0;.00nan;0;0
31;262;35;67;31;3;28;.903;3575000;0
31;724;11;0;0;0;0;.00nan;0;0
31;1430;35;0;0;0;0;.00nan;0;0
31;21522;11;100;48;2;46;.958;3600000;0
32;738;27;70;25;2;23;.920;3563000;0
32;4506;33;82;26;1;25;.962;3600000;0
32;26623;27;0;0;0;0;.00nan;0;0
32;34740;33;0;0;0;0;.00nan;0;0
33;445;12;70;21;1;20;.952;3600000;0
33;2058;28;62;33;3;30;.909;3552000;0
33;14061;28;0;0;0;0;.00nan;0;0
33;34786;12;0;0;0;0;.00nan;0;0
34;1821;3;0;0;0;0;.00nan;0;0
34;2054;3;76;32;3;29;.906;3638000;0
34;18104;10;0;0;0;0;.00nan;0;0
34;27488;10;66;40;4;36;.900;3638000;0
35;1251;14;0;0;0;0;.00nan;0;0
35;1572;4838;0;0;0;0;.00nan;0;0
35;2328;4838;61;25;3;22;.880;3600000;0
35;25584;14;75;30;2;28;.933;3600000;0
36;544;19;58;17;2;15;.882;3600000;0
36;1913;30;64;50;6;44;.880;3600000;0
36;4826;30;0;0;0;0;.00nan;0;0
36;31124;19;0;0;0;0;.00nan;0;0
37;1796;16;37;21;4;17;.810;3600000;0
37;15437;16;0;0;0;0;.00nan;0;0
37;22601;26;0;0;0;0;.00nan;0;0
37;32754;26;55;37;5;32;.865;3600000;0
38;335;18;0;0;0;0;.00nan;0;0
38;2163;17;80;24;1;23;.958;3600000;0
38;5001;18;68;27;2;25;.926;3568000;0
38;34006;17;0;0;0;0;.00nan;0;0
39;738;27;0;0;0;0;.00nan;0;0
39;1074;0;72;37;3;34;.919;3600000;0
39;26623;27;41;28;5;23;.821;3535000;0
39;31035;0;0;0;0;0;.00nan;0;0
40;323;9;28;25;6;19;.760;2730000;0
40;376;9;54;11;1;10;.909;870000;0
40;13842;34;67;30;3;27;.900;3600000;0
40;15502;34;0;0;0;0;.00nan;0;0
41;61;31;75;42;3;39;.929;3520000;0
41;233;29;0;0;0;0;.00nan;0;0
41;18351;29;82;28;1;27;.964;3600000;0
41;34797;31;0;0;0;0;.00nan;0;0
42;51;21;74;29;2;27;.931;3600000;0
42;1572;4838;57;25;3;22;.880;3600000;0
42;2328;4838;0;0;0;0;.00nan;0;0
42;25843;21;0;0;0;0;.00nan;0;0
43;445;12;0;0;0;0;.00nan;0;0
43;2423;15;46;28;5;23;.821;3528000;0
43;4106;15;0;0;0;0;.00nan;0;0
43;34786;12;79;39;3;36;.923;3600000;0
44;1614;25;100;28;0;28;1.000;3600000;0
44;5182;25;0;0;0;0;.00nan;0;0
44;27739;22;0;0;0;0;.00nan;0;0
44;28026;22;86;53;4;49;.925;3600000;0
45;15505;8;61;33;4;29;.879;3600000;0
45;18078;20;100;23;0;23;1.000;3600000;0
45;25076;8;0;0;0;0;.00nan;0;0
45;32146;20;0;0;0;0;.00nan;0;0
46;724;11;0;0;0;0;.00nan;0;0
46;15464;32;95;48;3;45;.938;3600000;0
46;16006;32;0;0;0;0;.00nan;0;0
46;21522;11;90;37;2;35;.946;3600000;0
47;262;35;0;0;0;0;.00nan;0;0
47;1430;35;92;39;1;38;.974;3879000;0
47;4506;33;0;0;0;0;.00nan;0;0
47;34740;33;75;27;2;25;.926;3879000;0
48;823;23;0;0;0;0;.00nan;0;0
48;1913;30;0;0;0;0;.00nan;0;0
48;4826;30;95;47;3;44;.936;3792000;0
48;10274;23;58;31;4;27;.871;3792000;0
49;1251;14;0;0;0;0;.00nan;0;0
49;4450;5;0;0;0;0;.00nan;0;0
49;19823;5;43;20;3;17;.850;3600000;0
49;25584;14;80;25;1;24;.960;3600000;0
50;500;4182;58;30;4;26;.867;3600000;0
50;1796;16;61;41;5;36;.878;3547000;0
50;15437;16;0;0;0;0;.00nan;0;0
50;25521;4182;0;0;0;0;.00nan;0;0
51;1074;0;98;46;3;43;.935;3548000;0
51;10103;24;0;0;0;0;.00nan;0;0
51;13979;24;57;16;2;14;.875;3600000;0
51;31035;0;0;0;0;0;.00nan;0;0
52;738;27;100;34;0;34;1.000;3600000;0
52;2058;28;71;24;1;23;.958;3598000;0
52;14061;28;0;0;0;0;.00nan;0;0
52;26623;27;0;0;0;0;.00nan;0;0
53;323;9;95;34;1;33;.971;3600000;0
53;376;9;0;0;0;0;.00nan;0;0
53;544;19;57;24;3;21;.875;3521000;0
53;31124;19;0;0;0;0;.00nan;0;0
54;61;31;87;36;3;33;.917;3574000;0
54;1614;25;80;31;2;29;.935;3600000;0
54;5182;25;0;0;0;0;.00nan;0;0
54;34797;31;0;0;0;0;.00nan;0;0
55;51;21;83;46;3;43;.935;3578000;0
55;25843;21;0;0;0;0;.00nan;0;0
55;27739;22;0;0;0;0;.00nan;0;0
55;28026;22;94;34;1;33;.971;3600000;0
56;13842;34;0;0;0;0;.00nan;0;0
56;15502;34;76;29;2;27;.931;3600000;0
56;18078;20;55;25;3;22;.880;3588000;0
56;32146;20;0;0;0;0;.00nan;0;0
57;335;18;58;26;3;23;.885;3600000;0
57;5001;18;0;0;0;0;.00nan;0;0
57;15505;8;0;0;0;0;.00nan;0;0
57;25076;8;55;33;4;29;.879;3553000;0
58;15464;32;45;38;6;32;.842;3600000;0
58;16006;32;0;0;0;0;.00nan;0;0
58;18104;10;0;0;0;0;.00nan;0;0
58;27488;10;88;27;1;26;.963;3600000;0
59;1913;30;100;49;3;46;.939;3900000;0
59;4506;33;57;19;3;16;.842;3900000;0
59;4826;30;0;0;0;0;.00nan;0;0
59;34740;33;0;0;0;0;.00nan;0;0
60;823;23;0;0;0;0;.00nan;0;0
60;10274;23;87;32;2;30;.938;3600000;0
60;22601;26;64;42;5;37;.881;3592000;0
60;32754;26;0;0;0;0;.00nan;0;0
61;4450;5;0;0;0;0;.00nan;0;0
61;5385;17;0;0;0;0;.00nan;0;0
61;19823;5;65;14;1;13;.929;3600000;0
61;34006;17;80;31;2;29;.935;3560000;0
62;738;27;64;30;3;27;.900;3600000;0
62;1821;3;0;0;0;0;.00nan;0;0
62;2054;3;100;29;0;29;1.000;3600000;0
62;26623;27;0;0;0;0;.00nan;0;0
63;445;12;84;41;3;38;.927;3900000;0
63;724;11;0;0;0;0;.00nan;0;0
63;21522;11;75;36;3;33;.917;3900000;0
63;34786;12;0;0;0;0;.00nan;0;0
64;500;4182;0;0;0;0;.00nan;0;0
64;823;23;95;34;2;32;.941;3600000;0
64;10274;23;0;0;0;0;.00nan;0;0
64;25521;4182;47;27;4;23;.852;3555000;0
65;376;9;0;0;0;0;.00nan;0;0
65;1074;0;96;33;1;32;.970;3600000;0
65;20853;9;69;27;2;25;.926;3576000;0
65;31035;0;0;0;0;0;.00nan;0;0
66;2058;28;0;0;0;0;.00nan;0;0
66;14061;28;53;31;4;27;.871;3546000;0
66;18104;10;56;24;3;21;.875;3600000;0
66;27488;10;0;0;0;0;.00nan;0;0
67;233;29;60;37;4;33;.892;3567000;0
67;1614;25;83;27;2;25;.926;3600000;0
67;5182;25;0;0;0;0;.00nan;0;0
67;18351;29;0;0;0;0;.00nan;0;0
68;51;21;62;41;5;36;.878;3585000;0
68;5385;17;61;42;4;38;.905;3600000;0
68;25843;21;0;0;0;0;.00nan;0;0
68;34006;17;0;0;0;0;.00nan;0;0
69;61;31;71;41;4;37;.902;3569000;0
69;1251;14;0;0;0;0;.00nan;0;0
69;25584;14;86;38;2;36;.947;3600000;0
69;34797;31;0;0;0;0;.00nan;0;0
70;1821;3;0;0;0;0;.00nan;0;0
70;2054;3;93;29;1;28;.966;3600000;0
70;2423;15;85;33;2;31;.939;3572000;0
70;4106;15;0;0;0;0;.00nan;0;0
71;544;19;0;0;0;0;.00nan;0;0
71;27739;22;0;0;0;0;.00nan;0;0
71;28026;22;91;35;1;34;.971;3600000;0
71;31124;19;24;26;6;20;.769;3600000;0
72;10103;24;61;31;4;27;.871;3600000;0
72;13842;34;0;0;0;0;.00nan;0;0
72;13979;24;0;0;0;0;.00nan;0;0
72;15502;34;49;36;5;31;.861;3590000;0
73;724;11;83;39;3;36;.923;3549000;0
73;1796;16;82;25;1;24;.960;3600000;0
73;15437;16;0;0;0;0;.00nan;0;0
73;21522;11;0;0;0;0;.00nan;0;0
74;262;35;51;24;3;21;.875;3554000;0
74;1430;35;0;0;0;0;.00nan;0;0
74;1913;30;0;0;0;0;.00nan;0;0
74;4826;30;95;41;2;39;.951;3600000;0
75;4506;33;0;0;0;0;.00nan;0;0
75;15464;32;78;28;1;27;.964;3600000;0
75;16006;32;0;0;0;0;.00nan;0;0
75;34740;33;82;41;2;39;.951;3595000;0
76;18078;20;32;33;7;26;.788;3600000;0
76;22601;26;0;0;0;0;.00nan;0;0
76;32146;20;0;0;0;0;.00nan;0;0
76;32754;26;64;32;3;29;.906;3600000;0
77;335;18;0;0;0;0;.00nan;0;0
77;1572;4838;0;0;0;0;.00nan;0;0
77;2328;4838;79;37;3;34;.919;3600000;0
77;5001;18;74;21;1;20;.952;3600000;0
78;738;27;0;0;0;0;.00nan;0;0
78;4450;5;61;19;2;17;.895;3600000;0
78;19823;5;0;0;0;0;.00nan;0;0
78;26623;27;39;36;6;30;.833;3600000;0
79;376;9;67;36;4;32;.889;3556000;0
79;15505;8;88;32;2;30;.938;3600000;0
79;20853;9;0;0;0;0;.00nan;0;0
79;25076;8;0;0;0;0;.00nan;0;0
80;262;35;0;0;0;0;.00nan;0;0
80;1430;35;82;23;1;22;.957;3600000;0
80;15464;32;0;0;0;0;.00nan;0;0
80;16006;32;55;33;4;29;.879;3600000;0
81;500;4182;85;31;1;30;.968;3600000;0
81;18078;20;0;0;0;0;.00nan;0;0
81;25521;4182;0;0;0;0;.00nan;0;0
81;32146;20;71;30;2;28;.933;3592000;0
82;233;29;0;0;0;0;.00nan;0;0
82;5385;17;0;0;0;0;.00nan;0;0
82;18351;29;100;25;0;25;1.000;3600000;0
82;34006;17;82;39;3;36;.923;3600000;0
83;2058;28;79;34;2;32;.941;3600000;0
83;14061;28;0;0;0;0;.00nan;0;0
83;27739;22;0;0;0;0;.00nan;0;0
83;28026;22;54;25;3;22;.880;3557000;0
84;61;31;0;0;0;0;.00nan;0;0
84;22601;26;0;0;0;0;.00nan;0;0
84;32754;26;77;33;3;30;.909;3648000;0
84;34797;31;70;37;4;33;.892;3648000;0
85;544;19;58;40;5;35;.875;3600000;0
85;18104;10;71;17;1;16;.941;3600000;0
85;27488;10;0;0;0;0;.00nan;0;0
85;31124;19;0;0;0;0;.00nan;0;0
86;1821;3;76;38;3;35;.921;3600000;0
86;2054;3;0;0;0;0;.00nan;0;0
86;10103;24;0;0;0;0;.00nan;0;0
86;13979;24;34;21;5;16;.762;3523000;0
87;445;12;0;0;0;0;.00nan;0;0
87;13842;34;0;0;0;0;.00nan;0;0
87;15502;34;69;31;2;29;.935;3900000;0
87;34786;12;86;33;2;31;.939;3900000;0
88;724;11;0;0;0;0;.00nan;0;0
88;1796;16;36;35;6;29;.829;3328000;0
88;15437;16;53;2;0;2;1.000;272000;0
88;21522;11;65;20;2;18;.900;3600000;0
89;51;21;0;0;0;0;.00nan;0;0
89;544;19;0;0;0;0;.00nan;0;0
89;25843;21;73;31;3;28;.903;3513000;0
89;31124;19;60;13;1;12;.923;3600000;0
90;233;29;0;0;0;0;.00nan;0;0
90;2423;15;64;36;4;32;.889;3600000;0
90;4106;15;0;0;0;0;.00nan;0;0
90;18351;29;100;44;0;44;1.000;3600000;0
91;738;27;0;0;0;0;.00nan;0;0
91;15464;32;0;0;0;0;.00nan;0;0
91;16006;32;75;23;2;21;.913;3600000;0
91;26623;27;36;27;5;22;.815;3600000;0
92;500;4182;46;40;6;34;.850;3600000;0
92;1614;25;0;0;0;0;.00nan;0;0
92;5182;25;56;28;4;24;.857;3600000;0
92;25521;4182;0;0;0;0;.00nan;0;0
93;262;35;0;0;0;0;.00nan;0;0
93;335;18;0;0;0;0;.00nan;0;0
93;1430;35;89;36;3;33;.917;3600000;0
93;5001;18;61;40;5;35;.875;3514000;0
94;1913;30;0;0;0;0;.00nan;0;0
94;4506;33;0;0;0;0;.00nan;0;0
94;4826;30;98;52;3;49;.942;3544000;0
94;34740;33;61;17;2;15;.882;3600000;0
95;1074;0;61;33;4;29;.879;3774000;0
95;1572;4838;0;0;0;0;.00nan;0;0
95;2328;4838;53;21;3;18;.857;3751000;0
95;31035;0;0;0;0;0;.00nan;0;0
96;61;31;73;36;4;32;.889;3600000;0
96;4450;5;18;23;6;17;.739;2055000;0
96;19823;5;18;11;4;7;.636;1545000;0
96;34797;31;0;0;0;0;.00nan;0;0
97;376;9;77;46;4;42;.913;3543000;0
97;20853;9;0;0;0;0;.00nan;0;0
97;27739;22;0;0;0;0;.00nan;0;0
97;28026;22;66;29;3;26;.897;3600000;0
98;1821;3;50;17;2;15;.882;3600000;0
98;2054;3;0;0;0;0;.00nan;0;0
98;15505;8;68;40;4;36;.900;3600000;0
98;25076;8;0;0;0;0;.00nan;0;0
99;445;12;0;0;0;0;.00nan;0;0
99;500;4182;0;0;0;0;.00nan;0;0
99;25521;4182;52;41;6;35;.854;3600000;0
99;34786;12;93;29;1;28;.966;3600000;0
100;823;23;19;10;4;6;.600;759000;0
100;1251;14;0;0;0;0;.00nan;0;0
100;10274;23;82;20;0;20;1.000;2841000;0
100;25584;14;71;20;1;19;.950;3600000;0
101;233;29;0;0;0;0;.00nan;0;0
101;18351;29;82;24;1;23;.958;3600000;0
101;22601;26;0;0;0;0;.00nan;0;0
101;32754;26;49;31;5;26;.839;3600000;0
102;544;19;57;22;2;20;.909;3547000;0
102;2423;15;0;0;0;0;.00nan;0;0
102;4106;15;90;40;1;39;.975;3600000;0
102;31124;19;0;0;0;0;.00nan;0;0
103;4450;5;0;0;0;0;.00nan;0;0
103;10103;24;58;37;5;32;.865;3600000;0
103;13979;24;0;0;0;0;.00nan;0;0
103;19823;5;69;16;1;15;.938;3600000;0
104;1614;25;0;0;0;0;.00nan;0;0
104;1796;16;0;0;0;0;.00nan;0;0
104;5182;25;66;28;3;25;.893;3600000;0
104;15437;16;58;39;5;34;.872;3514000;0
105;335;18;100;28;0;28;1.000;3600000;0
105;1251;14;72;38;4;34;.895;3600000;0
105;5001;18;0;0;0;0;.00nan;0;0
105;25584;14;0;0;0;0;.00nan;0;0
106;1913;30;0;0;0;0;.00nan;0;0
106;4826;30;76;35;3;32;.914;3900000;0
106;5385;17;0;0;0;0;.00nan;0;0
106;34006;17;83;36;3;33;.917;3900000;0
107;724;11;0;0;0;0;.00nan;0;0
107;4506;33;87;15;0;15;1.000;3600000;0
107;21522;11;83;41;4;37;.902;3600000;0
107;34740;33;0;0;0;0;.00nan;0;0
108;738;27;63;15;1;14;.933;3600000;0
108;1074;0;74;44;4;40;.909;3600000;0
108;26623;27;0;0;0;0;.00nan;0;0
108;31035;0;0;0;0;0;.00nan;0;0
109;262;35;0;0;0;0;.00nan;0;0
109;1430;35;100;25;0;25;1.000;3600000;0
109;1572;4838;98;42;1;41;.976;3600000;0
109;2328;4838;0;0;0;0;.00nan;0;0
110;61;31;71;20;2;18;.900;3819000;0
110;376;9;89;43;3;40;.930;3819000;0
110;20853;9;0;0;0;0;.00nan;0;0
110;34797;31;0;0;0;0;.00nan;0;0
111;13842;34;79;36;2;34;.944;3900000;0
111;15502;34;0;0;0;0;.00nan;0;0
111;18104;10;92;31;2;29;.935;3900000;0
111;27488;10;0;0;0;0;.00nan;0;0
112;22601;26;25;6;3;3;.500;575000;0
112;27739;22;0;0;0;0;.00nan;0;0
112;28026;22;98;17;0;17;1.000;3600000;0
112;32754;26;71;36;4;32;.889;3025000;0
113;10103;24;0;0;0;0;.00nan;0;0
113;13979;24;88;43;4;39;.907;3900000;0
113;15505;8;61;35;4;31;.886;3900000;0
113;25076;8;0;0;0;0;.00nan;0;0
114;445;12;51;30;4;26;.867;3583000;0
114;2058;28;70;22;2;20;.909;3600000;0
114;14061;28;0;0;0;0;.00nan;0;0
114;34786;12;0;0;0;0;.00nan;0;0
115;500;4182;60;15;1;14;.933;3600000;0
115;1913;30;98;52;2;50;.962;3546000;0
115;4826;30;0;0;0;0;.00nan;0;0
115;25521;4182;0;0;0;0;.00nan;0;0
116;61;31;0;0;0;0;.00nan;0;0
116;4450;5;93;29;1;28;.966;3600000;0
116;19823;5;0;0;0;0;.00nan;0;0
116;34797;31;97;44;3;41;.932;3584000;0
117;376;9;53;10;1;9;.900;466000;0
117;1821;3;0;0;0;0;.00nan;0;0
117;2054;3;72;29;2;27;.931;3600000;0
117;20853;9;41;26;5;21;.808;3134000;0
118;51;21;0;0;0;0;.00nan;0;0
118;2423;15;78;23;1;22;.957;3749000;0
118;4106;15;0;0;0;0;.00nan;0;0
118;25843;21;88;41;2;39;.951;3749000;0
119;1796;16;57;13;1;12;.923;3600000;0
119;15437;16;0;0;0;0;.00nan;0;0
119;15505;8;0;0;0;0;.00nan;0;0
119;25076;8;78;37;3;34;.919;3600000;0
120;928;20;84;40;3;37;.925;3600000;0
120;15464;32;67;27;2;25;.926;3600000;0
120;16006;32;0;0;0;0;.00nan;0;0
120;18078;20;0;0;0;0;.00nan;0;0
121;262;35;0;0;0;0;.00nan;0;0
121;1430;35;100;27;0;27;1.000;3600000;0
121;1614;25;40;39;6;33;.846;3347000;0
121;5182;25;50;1;0;1;1.000;253000;0
122;544;19;63;16;2;14;.875;3600000;0
122;1251;14;54;6;0;6;1.000;585000;0
122;25584;14;49;39;6;33;.846;3015000;0
122;31124;19;0;0;0;0;.00nan;0;0
123;335;18;74;39;4;35;.897;3560000;0
123;823;23;73;25;2;23;.920;3600000;0
123;5001;18;0;0;0;0;.00nan;0;0
123;10274;23;0;0;0;0;.00nan;0;0
124;724;11;0;0;0;0;.00nan;0;0
124;1074;0;83;28;2;26;.929;3566000;0
124;21522;11;86;17;0;17;1.000;3600000;0
124;31035;0;0;0;0;0;.00nan;0;0
125;738;27;75;40;3;37;.925;3569000;0
125;4506;33;85;27;1;26;.963;3600000;0
125;26623;27;0;0;0;0;.00nan;0;0
125;34740;33;0;0;0;0;.00nan;0;0
126;51;21;81;37;3;34;.919;3600000;0
126;13842;34;64;26;2;24;.923;3600000;0
126;15502;34;0;0;0;0;.00nan;0;0
126;25843;21;0;0;0;0;.00nan;0;0
127;10103;24;0;0;0;0;.00nan;0;0
127;13979;24;79;32;2;30;.938;3600000;0
127;22601;26;91;51;3;48;.941;3600000;0
127;32754;26;0;0;0;0;.00nan;0;0
128;1074;0;0;0;0;0;.00nan;0;0
128;1913;30;0;0;0;0;.00nan;0;0
128;4826;30;58;21;2;19;.905;3581000;0
128;31035;0;74;23;1;22;.957;3600000;0
129;724;11;0;0;0;0;.00nan;0;0
129;5385;17;0;0;0;0;.00nan;0;0
129;21522;11;49;20;3;17;.850;3600000;0
129;34006;17;42;33;5;28;.848;3600000;0
130;1572;4838;0;0;0;0;.00nan;0;0
130;2328;4838;65;32;3;29;.906;3553000;0
130;18104;10;79;28;1;27;.964;3600000;0
130;27488;10;0;0;0;0;.00nan;0;0
131;233;29;0;0;0;0;.00nan;0;0
131;18351;29;100;42;3;39;.929;3600000;0
131;27739;22;0;0;0;0;.00nan;0;0
131;28026;22;83;40;4;36;.900;3566000;0
132;2058;28;42;19;4;15;.789;3600000;0
132;14061;28;0;0;0;0;.00nan;0;0
132;15505;8;56;39;5;34;.872;3582000;0
132;25076;8;0;0;0;0;.00nan;0;0
133;823;23;0;0;0;0;.00nan;0;0
133;1572;4838;60;21;2;19;.905;3600000;0
133;2328;4838;0;0;0;0;.00nan;0;0
133;10274;23;77;22;1;21;.955;3600000;0
134;500;4182;77;38;3;35;.921;3600000;0
134;1821;3;0;0;0;0;.00nan;0;0
134;2054;3;100;36;0;36;1.000;3600000;0
134;25521;4182;0;0;0;0;.00nan;0;0
135;376;9;0;0;0;0;.00nan;0;0
135;1074;0;39;19;4;15;.789;866000;0
135;20853;9;100;36;1;35;.972;3600000;0
135;31035;0;41;25;4;21;.840;2734000;0
136;1251;14;78;34;2;32;.941;3600000;0
136;22601;26;51;34;4;30;.882;3557000;0
136;25584;14;0;0;0;0;.00nan;0;0
136;32754;26;0;0;0;0;.00nan;0;0
137;262;35;0;0;0;0;.00nan;0;0
137;1430;35;100;31;0;31;1.000;3600000;0
137;2058;28;0;0;0;0;.00nan;0;0
137;14061;28;62;28;3;25;.893;3600000;0
138;445;12;0;0;0;0;.00nan;0;0
138;4506;33;57;24;3;21;.875;3654000;0
138;34740;33;0;0;0;0;.00nan;0;0
138;34786;12;72;28;2;26;.929;3654000;0
139;544;19;62;34;4;30;.882;3532000;0
139;15464;32;69;30;3;27;.900;3600000;0
139;16006;32;0;0;0;0;.00nan;0;0
139;31124;19;0;0;0;0;.00nan;0;0
140;335;18;0;0;0;0;.00nan;0;0
140;5001;18;71;36;4;32;.889;3583000;0
140;18104;10;0;0;0;0;.00nan;0;0
140;27488;10;51;23;3;20;.870;3600000;0
141;51;21;0;0;0;0;.00nan;0;0
141;1913;30;0;0;0;0;.00nan;0;0
141;4826;30;95;30;1;29;.967;3727000;0
141;25843;21;82;32;2;30;.938;3727000;0
142;738;27;0;0;0;0;.00nan;0;0
142;5385;17;79;38;2;36;.947;3900000;0
142;26623;27;56;19;2;17;.895;3900000;0
142;34006;17;0;0;0;0;.00nan;0;0
143;10103;24;62;34;3;31;.912;3560000;0
143;13979;24;0;0;0;0;.00nan;0;0
143;15505;8;100;36;1;35;.972;3600000;0
143;25076;8;0;0;0;0;.00nan;0;0
144;1614;25;50;22;3;19;.864;3540000;0
144;5182;25;0;0;0;0;.00nan;0;0
144;13842;34;0;0;0;0;.00nan;0;0
144;15502;34;94;46;2;44;.957;3600000;0
145;823;23;0;0;0;0;.00nan;0;0
145;10274;23;81;28;1;27;.964;3600000;0
145;15464;32;0;0;0;0;.00nan;0;0
145;16006;32;59;39;4;35;.897;3600000;0
146;724;11;0;0;0;0;.00nan;0;0
146;1796;16;58;32;4;28;.875;3549000;0
146;15437;16;0;0;0;0;.00nan;0;0
146;21522;11;65;28;3;25;.893;3600000;0
147;376;9;0;0;0;0;.00nan;0;0
147;4450;5;0;0;0;0;.00nan;0;0
147;19823;5;36;14;3;11;.786;3600000;0
147;20853;9;91;48;2;46;.958;3600000;0
148;233;29;0;0;0;0;.00nan;0;0
148;1821;3;47;21;4;17;.810;2863000;0
148;2054;3;24;10;4;6;.600;737000;0
148;18351;29;77;35;3;32;.914;3600000;0
149;928;20;0;0;0;0;.00nan;0;0
149;1074;0;67;46;5;41;.891;3600000;0
149;18078;20;69;21;1;20;.952;3600000;0
149;31035;0;0;0;0;0;.00nan;0;0
150;500;4182;60;28;3;25;.893;3778000;0
150;2058;28;59;23;2;21;.913;3778000;0
150;14061;28;0;0;0;0;.00nan;0;0
150;25521;4182;0;0;0;0;.00nan;0;0
151;61;31;0;0;0;0;.00nan;0;0
151;27739;22;0;0;0;0;.00nan;0;0
151;28026;22;41;22;4;18;.818;3600000;0
151;34797;31;30;24;5;19;.792;3557000;0
152;1251;14;40;33;6;27;.818;3600000;0
152;2423;15;80;27;1;26;.963;3600000;0
152;4106;15;0;0;0;0;.00nan;0;0
152;25584;14;0;0;0;0;.00nan;0;0
153;445;12;97;32;2;30;.938;3600000;0
153;544;19;41;23;4;19;.826;3536000;0
153;31124;19;0;0;0;0;.00nan;0;0
153;34786;12;0;0;0;0;.00nan;0;0
154;738;27;0;0;0;0;.00nan;0;0
154;1796;16;76;12;0;12;1.000;3600000;0
154;15437;16;0;0;0;0;.00nan;0;0
154;26623;27;70;30;3;27;.900;3600000;0
155;1572;4838;0;0;0;0;.00nan;0;0
155;2328;4838;36;21;4;17;.810;3570000;0
155;5385;17;0;0;0;0;.00nan;0;0
155;34006;17;77;34;3;31;.912;3600000;0
156;4506;33;66;21;1;20;.952;3600000;0
156;15505;8;98;59;3;56;.949;3554000;0
156;25076;8;0;0;0;0;.00nan;0;0
156;34740;33;0;0;0;0;.00nan;0;0
157;823;23;49;36;5;31;.861;3600000;0
157;10274;23;0;0;0;0;.00nan;0;0
157;18104;10;89;27;1;26;.963;3600000;0
157;27488;10;0;0;0;0;.00nan;0;0
158;335;18;38;28;5;23;.821;2219000;0
158;5001;18;63;15;1;14;.933;1381000;0
158;15464;32;0;0;0;0;.00nan;0;0
158;16006;32;68;27;2;25;.926;3600000;0
159;1913;30;0;0;0;0;.00nan;0;0
159;4826;30;64;35;4;31;.886;3564000;0
159;22601;26;64;32;3;29;.906;3600000;0
159;32754;26;0;0;0;0;.00nan;0;0
160;51;21;0;0;0;0;.00nan;0;0
160;724;11;0;0;0;0;.00nan;0;0
160;21522;11;73;24;1;23;.958;3880000;0
160;25843;21;91;39;2;37;.949;3880000;0
161;376;9;69;11;0;11;1.000;1565000;0
161;5385;17;0;0;0;0;.00nan;0;0
161;20853;9;29;17;4;13;.765;1992000;0
161;34006;17;63;22;2;20;.909;3600000;0
162;1821;3;0;0;0;0;.00nan;0;0
162;2054;3;85;31;2;29;.935;3543000;0
162;4450;5;0;0;0;0;.00nan;0;0
162;19823;5;99;39;1;38;.974;3600000;0
163;500;4182;83;33;2;31;.939;3743000;0
163;1074;0;99;47;1;46;.979;3743000;0
163;25521;4182;0;0;0;0;.00nan;0;0
163;31035;0;0;0;0;0;.00nan;0;0
164;233;29;0;0;0;0;.00nan;0;0
164;2058;28;16;20;6;14;.700;3600000;0
164;14061;28;0;0;0;0;.00nan;0;0
164;18351;29;98;43;3;40;.930;3600000;0
165;61;31;0;0;0;0;.00nan;0;0
165;10103;24;0;0;0;0;.00nan;0;0
165;13979;24;55;27;4;23;.852;3540000;0
165;34797;31;73;28;2;26;.929;3600000;0
166;262;35;0;0;0;0;.00nan;0;0
166;1430;35;97;31;1;30;.968;3600000;0
166;2423;15;39;29;5;24;.828;3600000;0
166;4106;15;0;0;0;0;.00nan;0;0
167;1251;14;0;0;0;0;.00nan;0;0
167;25584;14;58;34;4;30;.882;3600000;0
167;27739;22;90;26;1;25;.962;3600000;0
167;28026;22;0;0;0;0;.00nan;0;0
168;1614;25;89;36;2;34;.944;3600000;0
168;5182;25;0;0;0;0;.00nan;0;0
168;13842;34;0;0;0;0;.00nan;0;0
168;15502;34;57;29;4;25;.862;3556000;0
169;928;20;82;26;1;25;.962;3600000;0
169;4506;33;0;0;0;0;.00nan;0;0
169;18078;20;0;0;0;0;.00nan;0;0
169;34740;33;62;30;3;27;.900;3541000;0
170;544;19;82;41;3;38;.927;3514000;0
170;18104;10;0;0;0;0;.00nan;0;0
170;27488;10;70;20;1;19;.950;3600000;0
170;31124;19;0;0;0;0;.00nan;0;0
171;1572;4838;80;27;1;26;.963;3600000;0
171;2328;4838;0;0;0;0;.00nan;0;0
171;22601;26;0;0;0;0;.00nan;0;0
171;32754;26;44;27;4;23;.852;3600000;0
172;51;21;0;0;0;0;.00nan;0;0
172;738;27;62;31;3;28;.903;3544000;0
172;25843;21;88;33;1;32;.970;3600000;0
172;26623;27;0;0;0;0;.00nan;0;0
173;376;9;61;42;5;37;.881;3600000;0
173;500;4182;0;0;0;0;.00nan;0;0
173;20853;9;0;0;0;0;.00nan;0;0
173;25521;4182;63;23;2;21;.913;3600000;0
174;15464;32;0;0;0;0;.00nan;0;0
174;15505;8;87;30;1;29;.967;3600000;0
174;16006;32;51;23;3;20;.870;3565000;0
174;25076;8;0;0;0;0;.00nan;0;0
175;262;35;86;35;2;33;.943;3567000;0
175;928;20;0;0;0;0;.00nan;0;0
175;1430;35;0;0;0;0;.00nan;0;0
175;18078;20;86;28;1;27;.964;3600000;0
176;335;18;0;0;0;0;.00nan;0;0
176;445;12;0;0;0;0;.00nan;0;0
176;5001;18;65;18;1;17;.944;3600000;0
176;34786;12;77;39;3;36;.923;3527000;0
177;1796;16;68;34;3;31;.912;3618000;0
177;1913;30;0;0;0;0;.00nan;0;0
177;4826;30;66;37;4;33;.892;3618000;0
177;15437;16;0;0;0;0;.00nan;0;0
178;724;11;0;0;0;0;.00nan;0;0
178;1821;3;0;0;0;0;.00nan;0;0
178;2054;3;45;27;4;23;.852;3553000;0
178;21522;11;100;58;2;56;.966;3600000;0
179;61;31;0;0;0;0;.00nan;0;0
179;18104;10;0;0;0;0;.00nan;0;0
179;27488;10;100;27;0;27;1.000;3600000;0
179;34797;31;85;33;1;32;.970;3567000;0
180;5385;17;54;32;4;28;.875;3530000;0
180;27739;22;0;0;0;0;.00nan;0;0
180;28026;22;76;32;2;30;.938;3600000;0
180;34006;17;0;0;0;0;.00nan;0;0
181;2058;28;91;45;3;42;.933;3600000;0
181;4450;5;100;19;0;19;1.000;3600000;0
181;14061;28;0;0;0;0;.00nan;0;0
181;19823;5;0;0;0;0;.00nan;0;0
182;724;11;88;31;1;30;.968;3600000;0
182;1074;0;50;28;4;24;.857;3600000;0
182;21522;11;0;0;0;0;.00nan;0;0
182;31035;0;0;0;0;0;.00nan;0;0
183;376;9;100;24;0;24;1.000;3600000;0
183;823;23;0;0;0;0;.00nan;0;0
183;10274;23;59;26;3;23;.885;3600000;0
183;20853;9;0;0;0;0;.00nan;0;0
184;233;29;0;0;0;0;.00nan;0;0
184;10103;24;0;0;0;0;.00nan;0;0
184;13979;24;100;38;0;38;1.000;3600000;0
184;18351;29;98;37;1;36;.973;3572000;0
185;51;21;91;37;1;36;.973;3600000;0
185;61;31;67;38;4;34;.895;3600000;0
185;25843;21;0;0;0;0;.00nan;0;0
185;34797;31;0;0;0;0;.00nan;0;0
186;2423;15;66;29;3;26;.897;3600000;0
186;4106;15;0;0;0;0;.00nan;0;0
186;15505;8;47;33;5;28;.848;3582000;0
186;25076;8;0;0;0;0;.00nan;0;0
187;1796;16;0;0;0;0;.00nan;0;0
187;4506;33;76;47;4;43;.915;3900000;0
187;15437;16;72;38;4;34;.895;3900000;0
187;34740;33;0;0;0;0;.00nan;0;0
188;544;19;84;34;3;31;.912;3600000;0
188;738;27;0;0;0;0;.00nan;0;0
188;26623;27;53;29;4;25;.862;3576000;0
188;31124;19;0;0;0;0;.00nan;0;0
189;335;18;81;27;2;25;.926;3900000;0
189;1913;30;0;0;0;0;.00nan;0;0
189;4826;30;81;31;2;29;.935;3900000;0
189;5001;18;0;0;0;0;.00nan;0;0
190;500;4182;59;36;3;33;.917;3788000;0
190;1572;4838;42;24;4;20;.833;3788000;0
190;2328;4838;0;0;0;0;.00nan;0;0
190;25521;4182;0;0;0;0;.00nan;0;0
191;1251;14;66;35;3;32;.914;3600000;0
191;1821;3;46;6;1;5;.833;939000;0
191;2054;3;31;28;6;22;.786;2661000;0
191;25584;14;0;0;0;0;.00nan;0;0
192;445;12;0;0;0;0;.00nan;0;0
192;15464;32;0;0;0;0;.00nan;0;0
192;16006;32;60;30;3;27;.900;3545000;0
192;34786;12;75;28;2;26;.929;3600000;0
193;262;35;0;0;0;0;.00nan;0;0
193;1430;35;97;52;3;49;.942;3562000;0
193;22601;26;91;28;1;27;.964;3600000;0
193;32754;26;0;0;0;0;.00nan;0;0
194;823;23;0;0;0;0;.00nan;0;0
194;4450;5;28;24;6;18;.750;3515000;0
194;10274;23;81;41;4;37;.902;3600000;0
194;19823;5;0;0;0;0;.00nan;0;0
195;544;19;47;16;3;13;.813;3600000;0
195;1074;0;91;46;2;44;.957;3600000;0
195;31035;0;0;0;0;0;.00nan;0;0
195;31124;19;0;0;0;0;.00nan;0;0
196;724;11;0;0;0;0;.00nan;0;0
196;2058;28;0;0;0;0;.00nan;0;0
196;14061;28;52;37;5;32;.865;3580000;0
196;21522;11;63;28;3;25;.893;3600000;0
197;376;9;83;51;5;46;.902;3900000;0
197;20853;9;0;0;0;0;.00nan;0;0
197;27739;22;0;0;0;0;.00nan;0;0
197;28026;22;43;26;5;21;.808;3900000;0
198;51;21;87;27;1;26;.963;3600000;0
198;928;20;77;30;2;28;.933;3589000;0
198;18078;20;0;0;0;0;.00nan;0;0
198;25843;21;0;0;0;0;.00nan;0;0
199;61;31;0;0;0;0;.00nan;0;0
199;2423;15;0;0;0;0;.00nan;0;0
199;4106;15;70;32;3;29;.906;3900000;0
199;34797;31;59;28;3;25;.893;3900000;0
200;1796;16;50;22;3;19;.864;3570000;0
200;15437;16;0;0;0;0;.00nan;0;0
200;15464;32;67;26;2;24;.923;3600000;0
200;16006;32;0;0;0;0;.00nan;0;0
201;738;27;0;0;0;0;.00nan;0;0
201;4506;33;60;39;5;34;.872;3595000;0
201;26623;27;79;37;3;34;.919;3600000;0
201;34740;33;0;0;0;0;.00nan;0;0
202;335;18;0;0;0;0;.00nan;0;0
202;1614;25;72;37;4;33;.892;3600000;0
202;5001;18;73;30;3;27;.900;3600000;0
202;5182;25;0;0;0;0;.00nan;0;0
203;262;35;0;0;0;0;.00nan;0;0
203;500;4182;45;18;3;15;.833;3564000;0
203;1430;35;100;35;1;34;.971;3600000;0
203;25521;4182;0;0;0;0;.00nan;0;0
204;1572;4838;0;0;0;0;.00nan;0;0
204;1913;30;0;0;0;0;.00nan;0;0
204;2328;4838;94;30;1;29;.967;3600000;0
204;4826;30;53;35;5;30;.857;3600000;0
205;823;23;73;27;3;24;.889;3900000;0
205;5385;17;0;0;0;0;.00nan;0;0
205;10274;23;0;0;0;0;.00nan;0;0
205;34006;17;74;43;3;40;.930;3900000;0
206;544;19;0;0;0;0;.00nan;0;0
206;1821;3;0;0;0;0;.00nan;0;0
206;2054;3;95;42;2;40;.952;3600000;0
206;31124;19;57;33;4;29;.879;3522000;0
207;1251;14;94;44;3;41;.932;3600000;0
207;10103;24;0;0;0;0;.00nan;0;0
207;13979;24;56;28;4;24;.857;3574000;0
207;25584;14;0;0;0;0;.00nan;0;0
208;13842;34;0;0;0;0;.00nan;0;0
208;15502;34;78;40;4;36;.900;3600000;0
208;27739;22;57;6;0;6;1.000;795000;0
208;28026;22;24;29;7;22;.759;2805000;0
209;15505;8;84;28;1;27;.964;3600000;0
209;22601;26;0;0;0;0;.00nan;0;0
209;25076;8;0;0;0;0;.00nan;0;0
209;32754;26;65;31;3;28;.903;3544000;0
210;1821;3;80;24;1;23;.958;3600000;0
210;2054;3;0;0;0;0;.00nan;0;0
210;5385;17;67;41;4;37;.902;3600000;0
210;34006;17;0;0;0;0;.00nan;0;0
211;2058;28;0;0;0;0;.00nan;0;0
211;2423;15;91;22;0;22;1.000;3600000;0
211;4106;15;0;0;0;0;.00nan;0;0
211;14061;28;70;54;6;48;.889;3600000;0
212;376;9;0;0;0;0;.00nan;0;0
212;1074;0;55;22;3;19;.864;3600000;0
212;20853;9;49;32;5;27;.844;3528000;0
212;31035;0;0;0;0;0;.00nan;0;0
213;61;31;81;28;2;26;.929;3900000;0
213;233;29;0;0;0;0;.00nan;0;0
213;18351;29;83;37;2;35;.946;3900000;0
213;34797;31;0;0;0;0;.00nan;0;0
214;51;21;74;32;3;29;.906;3591000;0
214;4450;5;80;30;2;28;.933;3600000;0
214;19823;5;0;0;0;0;.00nan;0;0
214;25843;21;0;0;0;0;.00nan;0;0
215;1796;16;52;31;5;26;.839;3546000;0
215;10103;24;62;39;4;35;.897;3600000;0
215;13979;24;0;0;0;0;.00nan;0;0
215;15437;16;0;0;0;0;.00nan;0;0
216;13842;34;73;30;2;28;.933;3600000;0
216;15502;34;0;0;0;0;.00nan;0;0
216;18104;10;0;0;0;0;.00nan;0;0
216;27488;10;79;29;1;28;.966;3600000;0
217;15464;32;75;18;1;17;.944;3600000;0
217;16006;32;0;0;0;0;.00nan;0;0
217;22601;26;96;43;2;41;.953;3600000;0
217;32754;26;0;0;0;0;.00nan;0;0
218;445;12;0;0;0;0;.00nan;0;0
218;1251;14;0;0;0;0;.00nan;0;0
218;25584;14;54;17;2;15;.882;3596000;0
218;34786;12;79;24;1;23;.958;3600000;0
219;724;11;0;0;0;0;.00nan;0;0
219;4506;33;35;32;6;26;.813;3358000;0
219;21522;11;81;32;3;29;.906;3600000;0
219;34740;33;50;1;0;1;1.000;242000;0
220;738;27;0;0;0;0;.00nan;0;0
220;1614;25;49;37;5;32;.865;3559000;0
220;5182;25;0;0;0;0;.00nan;0;0
220;26623;27;62;30;3;27;.900;3600000;0
221;335;18;0;0;0;0;.00nan;0;0
221;500;4182;62;21;2;19;.905;3600000;0
221;5001;18;65;35;4;31;.886;3537000;0
221;25521;4182;0;0;0;0;.00nan;0;0
222;262;35;0;0;0;0;.00nan;0;0
222;1430;35;35;25;5;20;.800;3570000;0
222;1572;4838;75;42;4;38;.905;3600000;0
222;2328;4838;0;0;0;0;.00nan;0;0
223;1074;0;0;0;0;0;.00nan;0;0
223;4450;5;0;0;0;0;.00nan;0;0
223;19823;5;59;16;2;14;.875;3600000;0
223;31035;0;94;62;5;57;.919;3600000;0
224;544;19;78;25;1;24;.960;3600000;0
224;2058;28;79;41;3;38;.927;3600000;0
224;14061;28;0;0;0;0;.00nan;0;0
224;31124;19;0;0;0;0;.00nan;0;0
225;51;21;0;0;0;0;.00nan;0;0
225;18104;10;53;29;4;25;.862;3582000;0
225;25843;21;70;29;2;27;.931;3600000;0
225;27488;10;0;0;0;0;.00nan;0;0
226;2423;15;59;34;4;30;.882;3565000;0
226;4106;15;0;0;0;0;.00nan;0;0
226;27739;22;0;0;0;0;.00nan;0;0
226;28026;22;69;35;3;32;.914;3600000;0
227;823;23;0;0;0;0;.00nan;0;0
227;1796;16;67;19;1;18;.947;3600000;0
227;10274;23;96;37;2;35;.946;3600000;0
227;15437;16;0;0;0;0;.00nan;0;0
228;335;18;77;27;2;25;.926;3600000;0
228;1913;30;0;0;0;0;.00nan;0;0
228;4826;30;46;31;5;26;.839;3600000;0
228;5001;18;0;0;0;0;.00nan;0;0
229;233;29;0;0;0;0;.00nan;0;0
229;928;20;0;0;0;0;.00nan;0;0
229;18078;20;89;47;1;46;.979;3600000;0
229;18351;29;100;28;0;28;1.000;3600000;0
230;376;9;70;34;4;30;.882;3600000;0
230;13842;34;0;0;0;0;.00nan;0;0
230;15502;34;87;32;1;31;.969;3600000;0
230;20853;9;0;0;0;0;.00nan;0;0
231;1821;3;0;0;0;0;.00nan;0;0
231;2054;3;78;33;2;31;.939;3600000;0
231;15464;32;51;25;3;22;.880;3600000;0
231;16006;32;0;0;0;0;.00nan;0;0
232;61;31;0;0;0;0;.00nan;0;0
232;928;20;100;27;0;27;1.000;3600000;0
232;18078;20;0;0;0;0;.00nan;0;0
232;34797;31;92;40;2;38;.950;3583000;0
233;51;21;99;38;1;37;.974;3885000;0
233;2058;28;0;0;0;0;.00nan;0;0
233;14061;28;74;24;2;22;.917;3885000;0
233;25843;21;0;0;0;0;.00nan;0;0
234;1074;0;67;39;4;35;.897;3600000;0
234;18104;10;0;0;0;0;.00nan;0;0
234;27488;10;68;20;1;19;.950;3600000;0
234;31035;0;0;0;0;0;.00nan;0;0
235;544;19;82;44;4;40;.909;3848000;0
235;1251;14;78;38;3;35;.921;3848000;0
235;25584;14;0;0;0;0;.00nan;0;0
235;31124;19;0;0;0;0;.00nan;0;0
236;2423;15;61;27;3;24;.889;3600000;0
236;4106;15;0;0;0;0;.00nan;0;0
236;5385;17;0;0;0;0;.00nan;0;0
236;34006;17;64;34;4;30;.882;3544000;0
237;1796;16;0;0;0;0;.00nan;0;0
237;15437;16;95;21;0;21;1.000;3600000;0
237;22601;26;84;34;2;32;.941;3548000;0
237;32754;26;0;0;0;0;.00nan;0;0
238;376;9;0;0;0;0;.00nan;0;0
238;445;12;0;0;0;0;.00nan;0;0
238;20853;9;58;33;4;29;.879;3600000;0
238;34786;12;70;18;1;17;.944;3600000;0
239;262;35;0;0;0;0;.00nan;0;0
239;738;27;0;0;0;0;.00nan;0;0
239;1430;35;100;39;1;38;.974;3900000;0
239;26623;27;96;42;1;41;.976;3900000;0
240;823;23;40;34;6;28;.824;3600000;0
240;4506;33;0;0;0;0;.00nan;0;0
240;10274;23;0;0;0;0;.00nan;0;0
240;34740;33;90;35;2;33;.943;3600000;0
241;500;4182;73;38;3;35;.921;3600000;0
241;10103;24;0;0;0;0;.00nan;0;0
241;13979;24;65;18;2;16;.889;3600000;0
241;25521;4182;0;0;0;0;.00nan;0;0
242;1913;30;0;0;0;0;.00nan;0;0
242;4826;30;81;48;4;44;.917;3600000;0
242;27739;22;0;0;0;0;.00nan;0;0
242;28026;22;63;27;3;24;.889;3600000;0
243;335;18;48;8;1;7;.875;1067000;0
243;1614;25;99;23;0;23;1.000;3600000;0
243;5001;18;28;25;6;19;.760;2533000;0
243;5182;25;0;0;0;0;.00nan;0;0
244;724;11;0;0;0;0;.00nan;0;0
244;21522;11;80;35;3;32;.914;3600000;0
244;27739;22;0;0;0;0;.00nan;0;0
244;28026;22;66;40;4;36;.900;3600000;0
245;1572;4838;75;20;1;19;.950;3600000;0
245;2328;4838;0;0;0;0;.00nan;0;0
245;15505;8;46;31;5;26;.839;3600000;0
245;25076;8;0;0;0;0;.00nan;0;0
246;544;19;78;28;2;26;.929;3600000;0
246;5385;17;28;22;5;17;.773;3600000;0
246;31124;19;0;0;0;0;.00nan;0;0
246;34006;17;0;0;0;0;.00nan;0;0
247;1821;3;0;0;0;0;.00nan;0;0
247;2054;3;84;28;1;27;.964;3600000;0
247;18104;10;0;0;0;0;.00nan;0;0
247;27488;10;67;36;3;33;.917;3568000;0
248;1074;0;85;29;2;27;.931;3600000;0
248;2423;15;25;30;6;24;.800;3149000;0
248;4106;15;41;2;1;1;.500;451000;0
248;31035;0;0;0;0;0;.00nan;0;0
249;2058;28;99;35;1;34;.971;3600000;0
249;14061;28;0;0;0;0;.00nan;0;0
249;15464;32;89;41;2;39;.951;3587000;0
249;16006;32;0;0;0;0;.00nan;0;0
250;51;21;0;0;0;0;.00nan;0;0
250;61;31;100;26;0;26;1.000;3600000;0
250;25843;21;78;43;4;39;.907;3600000;0
250;34797;31;0;0;0;0;.00nan;0;0
251;233;29;0;0;0;0;.00nan;0;0
251;1251;14;49;26;4;22;.846;3600000;0
251;18351;29;84;34;3;31;.912;3600000;0
251;25584;14;0;0;0;0;.00nan;0;0
252;738;27;0;0;0;0;.00nan;0;0
252;1796;16;0;0;0;0;.00nan;0;0
252;15437;16;75;39;4;35;.897;3600000;0
252;26623;27;36;39;7;32;.821;3600000;0
253;262;35;0;0;0;0;.00nan;0;0
253;445;12;0;0;0;0;.00nan;0;0
253;1430;35;100;40;1;39;.975;3600000;0
253;34786;12;75;29;2;27;.931;3575000;0
254;823;23;0;0;0;0;.00nan;0;0
254;4506;33;75;34;3;31;.912;3900000;0
254;10274;23;100;49;3;46;.939;3900000;0
254;34740;33;0;0;0;0;.00nan;0;0
255;13842;34;64;44;5;39;.886;3600000;0
255;15502;34;0;0;0;0;.00nan;0;0
255;22601;26;0;0;0;0;.00nan;0;0
255;32754;26;91;27;1;26;.963;3600000;0
256;376;9;0;0;0;0;.00nan;0;0
256;500;4182;64;27;2;25;.926;3600000;0
256;20853;9;62;32;3;29;.906;3600000;0
256;25521;4182;0;0;0;0;.00nan;0;0
257;1913;30;0;0;0;0;.00nan;0;0
257;4826;30;100;42;0;42;1.000;3600000;0
257;10103;24;0;0;0;0;.00nan;0;0
257;13979;24;59;14;1;13;.929;3562000;0
258;335;18;0;0;0;0;.00nan;0;0
258;4506;33;0;0;0;0;.00nan;0;0
258;5001;18;71;28;2;26;.929;3811000;0
258;34740;33;67;32;3;29;.906;3811000;0
259;1572;4838;78;27;1;26;.963;3600000;0
259;1614;25;61;28;3;25;.893;3573000;0
259;2328;4838;0;0;0;0;.00nan;0;0
259;5182;25;0;0;0;0;.00nan;0;0
260;1821;3;0;0;0;0;.00nan;0;0
260;2054;3;54;23;3;20;.870;3600000;0
260;2423;15;67;38;4;34;.895;3600000;0
260;4106;15;0;0;0;0;.00nan;0;0
261;1074;0;100;43;2;41;.953;3900000;0
261;15464;32;71;27;2;25;.926;3900000;0
261;16006;32;0;0;0;0;.00nan;0;0
261;31035;0;0;0;0;0;.00nan;0;0
262;2058;28;72;34;4;30;.882;3575000;0
262;14061;28;0;0;0;0;.00nan;0;0
262;18104;10;0;0;0;0;.00nan;0;0
262;27488;10;54;17;2;15;.882;3600000;0
263;51;21;52;4;0;4;1.000;474000;0
263;233;29;0;0;0;0;.00nan;0;0
263;18351;29;59;26;3;23;.885;3600000;0
263;25843;21;38;35;6;29;.829;3126000;0
264;61;31;74;29;2;27;.931;3600000;0
264;262;35;0;0;0;0;.00nan;0;0
264;1430;35;80;29;3;26;.897;3571000;0
264;34797;31;0;0;0;0;.00nan;0;0
265;544;19;44;22;4;18;.818;3587000;0
265;928;20;79;27;2;25;.926;3600000;0
265;18078;20;0;0;0;0;.00nan;0;0
265;31124;19;0;0;0;0;.00nan;0;0
266;1251;14;95;38;2;36;.947;3600000;0
266;4450;5;82;35;3;32;.914;3558000;0
266;19823;5;0;0;0;0;.00nan;0;0
266;25584;14;0;0;0;0;.00nan;0;0
267;445;12;0;0;0;0;.00nan;0;0
267;1796;16;0;0;0;0;.00nan;0;0
267;15437;16;100;33;1;32;.970;3600000;0
267;34786;12;58;43;6;37;.860;3600000;0
268;823;23;0;0;0;0;.00nan;0;0
268;10274;23;100;34;0;34;1.000;3600000;0
268;15505;8;96;31;1;30;.968;3592000;0
268;25076;8;0;0;0;0;.00nan;0;0
269;376;9;0;0;0;0;.00nan;0;0
269;20853;9;44;34;5;29;.853;3549000;0
269;22601;26;53;28;4;24;.857;3600000;0
269;32754;26;0;0;0;0;.00nan;0;0
270;500;4182;63;19;2;17;.895;3896000;0
270;13842;34;92;42;3;39;.929;3896000;0
270;15502;34;0;0;0;0;.00nan;0;0
270;25521;4182;0;0;0;0;.00nan;0;0
271;724;11;0;0;0;0;.00nan;0;0
271;10103;24;79;19;1;18;.947;3600000;0
271;13979;24;0;0;0;0;.00nan;0;0
271;21522;11;82;37;3;34;.919;3577000;0
272;738;27;0;0;0;0;.00nan;0;0
272;26623;27;75;24;1;23;.958;3600000;0
272;27739;22;49;26;5;21;.808;2477000;0
272;28026;22;34;16;4;12;.750;1123000;0
273;544;19;0;0;0;0;.00nan;0;0
273;4450;5;0;0;0;0;.00nan;0;0
273;19823;5;74;28;2;26;.929;3827000;0
273;31124;19;81;35;3;32;.914;3827000;0
274;233;29;0;0;0;0;.00nan;0;0
274;262;35;0;0;0;0;.00nan;0;0
274;1430;35;85;33;2;31;.939;3900000;0
274;18351;29;76;25;2;23;.920;3900000;0
275;928;20;0;0;0;0;.00nan;0;0
275;1821;3;67;30;3;27;.900;3590000;0
275;2054;3;0;0;0;0;.00nan;0;0
275;18078;20;59;20;2;18;.900;3600000;0
276;5385;17;22;12;4;8;.667;1087000;0
276;18104;10;12;25;7;18;.720;3600000;0
276;27488;10;0;0;0;0;.00nan;0;0
276;34006;17;58;35;4;31;.886;2513000;0
277;335;18;0;0;0;0;.00nan;0;0
277;5001;18;72;30;2;28;.933;3600000;0
277;15505;8;66;12;0;12;1.000;1095000;0
277;25076;8;17;22;6;16;.727;2505000;0
278;724;11;77;30;2;28;.933;3600000;0
278;21522;11;0;0;0;0;.00nan;0;0
278;22601;26;0;0;0;0;.00nan;0;0
278;32754;26;57;26;3;23;.885;3600000;0
279;1572;4838;75;33;3;30;.909;3651000;0
279;2328;4838;0;0;0;0;.00nan;0;0
279;27739;22;63;14;1;13;.929;3248000;0
279;28026;22;25;8;3;5;.625;403000;0
280;5385;17;11;13;5;8;.615;799000;0
280;13842;34;55;32;4;28;.875;3600000;0
280;15502;34;0;0;0;0;.00nan;0;0
280;34006;17;97;28;0;28;1.000;2801000;0
281;500;4182;100;35;1;34;.971;3900000;0
281;1796;16;0;0;0;0;.00nan;0;0
281;15437;16;88;25;1;24;.960;3900000;0
281;25521;4182;0;0;0;0;.00nan;0;0
282;1913;30;68;13;0;13;1.000;1281000;0
282;4826;30;52;36;5;31;.861;2316000;0
282;15464;32;0;0;0;0;.00nan;0;0
282;16006;32;50;19;3;16;.842;3600000;0
283;2423;15;84;41;3;38;.927;3900000;0
283;4106;15;0;0;0;0;.00nan;0;0
283;4506;33;63;32;3;29;.906;3900000;0
283;34740;33;0;0;0;0;.00nan;0;0
284;1614;25;81;29;2;27;.931;3600000;0
284;2058;28;0;0;0;0;.00nan;0;0
284;5182;25;0;0;0;0;.00nan;0;0
284;14061;28;62;31;3;28;.903;3549000;0
285;738;27;0;0;0;0;.00nan;0;0
285;10103;24;0;0;0;0;.00nan;0;0
285;13979;24;80;34;2;32;.941;3600000;0
285;26623;27;78;37;3;34;.919;3566000;0
286;233;29;0;0;0;0;.00nan;0;0
286;1251;14;92;39;2;37;.949;3600000;0
286;18351;29;71;38;5;33;.868;3600000;0
286;25584;14;0;0;0;0;.00nan;0;0
287;445;12;93;32;3;29;.906;3621000;0
287;823;23;0;0;0;0;.00nan;0;0
287;10274;23;96;41;2;39;.951;3621000;0
287;34786;12;0;0;0;0;.00nan;0;0
288;544;19;66;21;2;19;.905;3600000;0
288;15505;8;72;33;3;30;.909;3541000;0
288;25076;8;0;0;0;0;.00nan;0;0
288;31124;19;0;0;0;0;.00nan;0;0
289;4450;5;57;19;2;17;.895;3535000;0
289;5385;17;100;44;0;44;1.000;3600000;0
289;19823;5;0;0;0;0;.00nan;0;0
289;34006;17;0;0;0;0;.00nan;0;0
290;376;9;74;41;4;37;.902;3600000;0
290;1796;16;0;0;0;0;.00nan;0;0
290;15437;16;32;25;5;20;.800;3543000;0
290;20853;9;0;0;0;0;.00nan;0;0
291;61;31;0;0;0;0;.00nan;0;0
291;1251;14;0;0;0;0;.00nan;0;0
291;25584;14;58;28;3;25;.893;3600000;0
291;34797;31;100;26;0;26;1.000;3600000;0
292;51;21;87;27;1;26;.963;3600000;0
292;262;35;0;0;0;0;.00nan;0;0
292;1430;35;69;33;4;29;.879;3600000;0
292;25843;21;0;0;0;0;.00nan;0;0
293;928;20;68;34;3;31;.912;3835000;0
293;18078;20;0;0;0;0;.00nan;0;0
293;18104;10;0;0;0;0;.00nan;0;0
293;27488;10;87;36;2;34;.944;3835000;0
294;335;18;0;0;0;0;.00nan;0;0
294;2423;15;56;44;5;39;.886;3597000;0
294;4106;15;0;0;0;0;.00nan;0;0
294;5001;18;56;26;4;22;.846;3600000;0
295;1074;0;87;34;2;32;.941;3555000;0
295;27739;22;0;0;0;0;.00nan;0;0
295;28026;22;91;33;1;32;.970;3600000;0
295;31035;0;0;0;0;0;.00nan;0;0
296;4506;33;55;26;3;23;.885;3600000;0
296;13842;34;0;0;0;0;.00nan;0;0
296;15502;34;95;53;4;49;.925;3556000;0
296;34740;33;0;0;0;0;.00nan;0;0
297;500;4182;22;4;3;1;.250;540000;0
297;15464;32;76;28;2;26;.929;3600000;0
297;16006;32;0;0;0;0;.00nan;0;0
297;25521;4182;51;34;5;29;.853;3060000;0
298;1614;25;84;33;2;31;.939;3600000;0
298;1913;30;0;0;0;0;.00nan;0;0
298;4826;30;42;37;6;31;.838;3600000;0
298;5182;25;0;0;0;0;.00nan;0;0
299;823;23;0;0;0;0;.00nan;0;0
299;10274;23;74;37;4;33;.892;3561000;0
299;22601;26;0;0;0;0;.00nan;0;0
299;32754;26;99;46;2;44;.957;3600000;0
300;724;11;0;0;0;0;.00nan;0;0
300;1821;3;0;0;0;0;.00nan;0;0
300;2054;3;79;29;2;27;.931;3600000;0
300;21522;11;85;48;4;44;.917;3567000;0
301;738;27;0;0;0;0;.00nan;0;0
301;2058;28;100;26;0;26;1.000;3600000;0
301;14061;28;0;0;0;0;.00nan;0;0
301;26623;27;86;25;1;24;.960;3574000;0
302;1572;4838;73;31;3;28;.903;3735000;0
302;2328;4838;0;0;0;0;.00nan;0;0
302;10103;24;71;35;4;31;.886;3735000;0
302;13979;24;0;0;0;0;.00nan;0;0
303;4450;5;0;0;0;0;.00nan;0;0
303;18104;10;0;0;0;0;.00nan;0;0
303;19823;5;84;29;1;28;.966;3600000;0
303;27488;10;64;23;3;20;.870;3575000;0
304;1074;0;71;23;2;21;.913;3600000;0
304;5385;17;62;26;3;23;.885;3551000;0
304;31035;0;0;0;0;0;.00nan;0;0
304;34006;17;0;0;0;0;.00nan;0;0
305;233;29;0;0;0;0;.00nan;0;0
305;1572;4838;83;26;1;25;.962;3600000;0
305;2328;4838;0;0;0;0;.00nan;0;0
305;18351;29;80;28;2;26;.929;3574000;0
306;928;20;0;0;0;0;.00nan;0;0
306;2423;15;78;24;1;23;.958;3600000;0
306;4106;15;0;0;0;0;.00nan;0;0
306;18078;20;79;28;2;26;.929;3600000;0
307;1251;14;90;29;1;28;.966;3600000;0
307;10103;24;0;0;0;0;.00nan;0;0
307;13979;24;62;33;4;29;.879;3600000;0
307;25584;14;0;0;0;0;.00nan;0;0
308;61;31;0;0;0;0;.00nan;0;0
308;27739;22;0;0;0;0;.00nan;0;0
308;28026;22;68;26;3;23;.885;3660000;0
308;34797;31;76;42;4;38;.905;3660000;0
309;335;18;0;0;0;0;.00nan;0;0
309;5001;18;79;36;3;33;.917;3900000;0
309;13842;34;0;0;0;0;.00nan;0;0
309;15502;34;100;46;3;43;.935;3900000;0
310;1796;16;0;0;0;0;.00nan;0;0
310;15437;16;55;23;4;19;.826;3600000;0
310;15505;8;83;27;1;26;.963;3600000;0
310;25076;8;0;0;0;0;.00nan;0;0
311;51;21;0;0;0;0;.00nan;0;0
311;15464;32;98;51;3;48;.941;3600000;0
311;16006;32;0;0;0;0;.00nan;0;0
311;25843;21;81;30;1;29;.967;3600000;0
312;445;12;75;40;3;37;.925;3577000;0
312;1614;25;73;19;1;18;.947;3600000;0
312;5182;25;0;0;0;0;.00nan;0;0
312;34786;12;0;0;0;0;.00nan;0;0
313;262;35;0;0;0;0;.00nan;0;0
313;1430;35;45;24;4;20;.833;3600000;0
313;4506;33;83;21;1;20;.952;3600000;0
313;34740;33;0;0;0;0;.00nan;0;0
314;1913;30;0;0;0;0;.00nan;0;0
314;2058;28;59;32;4;28;.875;3543000;0
314;4826;30;66;27;3;24;.889;3600000;0
314;14061;28;0;0;0;0;.00nan;0;0
315;738;27;0;0;0;0;.00nan;0;0
315;1821;3;0;0;0;0;.00nan;0;0
315;2054;3;64;28;3;25;.893;3600000;0
315;26623;27;28;22;5;17;.773;3572000;0
316;376;9;0;0;0;0;.00nan;0;0
316;5385;17;0;0;0;0;.00nan;0;0
316;20853;9;62;32;3;29;.906;3600000;0
316;34006;17;100;26;0;26;1.000;3600000;0
317;61;31;68;23;2;21;.913;3600000;0
317;1572;4838;0;0;0;0;.00nan;0;0
317;2328;4838;76;33;3;30;.909;3552000;0
317;34797;31;0;0;0;0;.00nan;0;0
318;1074;0;0;0;0;0;.00nan;0;0
318;2423;15;0;0;0;0;.00nan;0;0
318;4106;15;64;23;2;21;.913;3900000;0
318;31035;0;96;45;2;43;.956;3900000;0
319;1796;16;65;28;3;25;.893;3745000;0
319;13842;34;74;48;4;44;.917;3745000;0
319;15437;16;0;0;0;0;.00nan;0;0
319;15502;34;0;0;0;0;.00nan;0;0
320;1614;25;0;0;0;0;.00nan;0;0
320;5182;25;86;22;1;21;.955;3600000;0
320;15464;32;0;0;0;0;.00nan;0;0
320;16006;32;40;30;5;25;.833;3600000;0
321;544;19;0;0;0;0;.00nan;0;0
321;4506;33;42;3;1;2;.667;565000;0
321;31124;19;87;33;2;31;.939;3600000;0
321;34740;33;23;26;6;20;.769;3035000;0
322;445;12;0;0;0;0;.00nan;0;0
322;22601;26;71;32;2;30;.938;3600000;0
322;32754;26;0;0;0;0;.00nan;0;0
322;34786;12;56;39;5;34;.872;3600000;0
323;500;4182;66;23;2;21;.913;3600000;0
323;823;23;47;13;2;11;.846;923000;0
323;10274;23;31;28;6;22;.786;2677000;0
323;25521;4182;0;0;0;0;.00nan;0;0
324;724;11;0;0;0;0;.00nan;0;0
324;2058;28;0;0;0;0;.00nan;0;0
324;14061;28;78;45;4;41;.911;3600000;0
324;21522;11;81;39;2;37;.949;3600000;0
325;335;18;52;3;0;3;1.000;681000;0
325;4450;5;0;0;0;0;.00nan;0;0
325;5001;18;62;44;6;38;.864;2919000;0
325;19823;5;79;22;1;21;.955;3600000;0
326;51;21;75;27;3;24;.889;3555000;0
326;1251;14;60;20;2;18;.900;3600000;0
326;25584;14;0;0;0;0;.00nan;0;0
326;25843;21;0;0;0;0;.00nan;0;0
327;928;20;94;32;1;31;.969;3600000;0
327;18078;20;0;0;0;0;.00nan;0;0
327;18104;10;0;0;0;0;.00nan;0;0
327;27488;10;82;33;3;30;.909;3523000;0
328;10103;24;0;0;0;0;.00nan;0;0
328;13979;24;82;23;1;22;.957;3632000;0
328;27739;22;0;0;0;0;.00nan;0;0
328;28026;22;92;43;2;41;.953;3632000;0
329;738;27;0;0;0;0;.00nan;0;0
329;15505;8;29;33;7;26;.788;2914000;0
329;25076;8;49;7;1;6;.857;686000;0
329;26623;27;66;24;2;22;.917;3600000;0
330;233;29;0;0;0;0;.00nan;0;0
330;262;35;0;0;0;0;.00nan;0;0
330;1430;35;92;35;2;33;.943;3600000;0
330;18351;29;60;28;3;25;.893;3572000;0
331;1821;3;80;19;1;18;.947;3600000;0
331;1913;30;52;17;2;15;.882;1049000;0
331;2054;3;0;0;0;0;.00nan;0;0
331;4826;30;35;37;7;30;.811;2551000;0
332;1572;4838;63;27;3;24;.889;3576000;0
332;2328;4838;0;0;0;0;.00nan;0;0
332;5385;17;0;0;0;0;.00nan;0;0
332;34006;17;86;23;1;22;.957;3600000;0
333;335;18;0;0;0;0;.00nan;0;0
333;1074;0;100;36;1;35;.972;3600000;0
333;5001;18;43;28;5;23;.821;3600000;0
333;31035;0;0;0;0;0;.00nan;0;0
334;4506;33;95;30;1;29;.967;3600000;0
334;22601;26;82;43;4;39;.907;3600000;0
334;32754;26;0;0;0;0;.00nan;0;0
334;34740;33;0;0;0;0;.00nan;0;0
335;544;19;0;0;0;0;.00nan;0;0
335;2423;15;67;37;5;32;.865;3900000;0
335;4106;15;0;0;0;0;.00nan;0;0
335;31124;19;45;33;5;28;.848;3900000;0
336;376;9;0;0;0;0;.00nan;0;0
336;4450;5;73;18;1;17;.944;3600000;0
336;19823;5;0;0;0;0;.00nan;0;0
336;20853;9;83;48;4;44;.917;3600000;0
337;61;31;62;25;3;22;.880;3169000;0
337;27739;22;0;0;0;0;.00nan;0;0
337;28026;22;49;26;4;22;.846;3600000;0
337;34797;31;26;6;3;3;.500;387000;0
338;51;21;56;41;5;36;.878;3600000;0
338;738;27;0;0;0;0;.00nan;0;0
338;25843;21;0;0;0;0;.00nan;0;0
338;26623;27;97;35;1;34;.971;3600000;0
339;928;20;74;24;2;22;.917;3600000;0
339;1251;14;57;27;3;24;.889;3595000;0
339;18078;20;0;0;0;0;.00nan;0;0
339;25584;14;0;0;0;0;.00nan;0;0
340;233;29;0;0;0;0;.00nan;0;0
340;1796;16;0;0;0;0;.00nan;0;0
340;15437;16;73;24;2;22;.917;3672000;0
340;18351;29;67;28;3;25;.893;3672000;0
341;13842;34;100;52;2;50;.962;3600000;0
341;15464;32;43;3;1;2;.667;636000;0
341;15502;34;0;0;0;0;.00nan;0;0
341;16006;32;37;29;6;23;.793;2964000;0
342;445;12;80;33;2;31;.939;3644000;0
342;10103;24;0;0;0;0;.00nan;0;0
342;13979;24;93;30;1;29;.967;3644000;0
342;34786;12;0;0;0;0;.00nan;0;0
343;262;35;0;0;0;0;.00nan;0;0
343;1430;35;64;23;2;21;.913;3600000;0
343;22601;26;0;0;0;0;.00nan;0;0
343;32754;26;94;51;3;48;.941;3549000;0
344;724;11;0;0;0;0;.00nan;0;0
344;1913;30;0;0;0;0;.00nan;0;0
344;4826;30;82;53;4;49;.925;3900000;0
344;21522;11;64;31;4;27;.871;3900000;0
345;1614;25;59;26;4;22;.846;3546000;0
345;1821;3;69;27;2;25;.926;3600000;0
345;2054;3;0;0;0;0;.00nan;0;0
345;5182;25;0;0;0;0;.00nan;0;0
346;335;18;0;0;0;0;.00nan;0;0
346;2058;28;59;26;3;23;.885;3600000;0
346;5001;18;50;29;5;24;.828;3600000;0
346;14061;28;0;0;0;0;.00nan;0;0
347;376;9;60;33;4;29;.879;3552000;0
347;1572;4838;74;32;3;29;.906;3600000;0
347;2328;4838;0;0;0;0;.00nan;0;0
347;20853;9;0;0;0;0;.00nan;0;0
348;1251;14;0;0;0;0;.00nan;0;0
348;18104;10;0;0;0;0;.00nan;0;0
348;25584;14;86;35;2;33;.943;3900000;0
348;27488;10;58;22;2;20;.909;3900000;0
349;823;23;53;36;5;31;.861;3546000;0
349;2423;15;83;44;4;40;.909;3600000;0
349;4106;15;0;0;0;0;.00nan;0;0
349;10274;23;0;0;0;0;.00nan;0;0
350;500;4182;65;22;2;20;.909;3600000;0
350;1913;30;60;51;6;45;.882;3101000;0
350;4826;30;42;3;1;2;.667;499000;0
350;25521;4182;0;0;0;0;.00nan;0;0
351;1074;0;84;37;3;34;.919;3600000;0
351;1614;25;0;0;0;0;.00nan;0;0
351;5182;25;77;19;1;18;.947;3600000;0
351;31035;0;0;0;0;0;.00nan;0;0
352;233;29;70;32;4;28;.875;3567000;0
352;1796;16;0;0;0;0;.00nan;0;0
352;15437;16;69;19;2;17;.895;3600000;0
352;18351;29;0;0;0;0;.00nan;0;0
353;61;31;0;0;0;0;.00nan;0;0
353;5385;17;67;49;6;43;.878;3568000;0
353;34006;17;0;0;0;0;.00nan;0;0
353;34797;31;55;31;4;27;.871;3600000;0
354;738;27;0;0;0;0;.00nan;0;0
354;928;20;46;26;4;22;.846;3600000;0
354;18078;20;0;0;0;0;.00nan;0;0
354;26623;27;100;37;1;36;.973;3600000;0
355;15505;8;91;43;3;40;.930;3600000;0
355;25076;8;0;0;0;0;.00nan;0;0
355;27739;22;0;0;0;0;.00nan;0;0
355;28026;22;52;38;5;33;.868;3564000;0
356;2058;28;0;0;0;0;.00nan;0;0
356;10103;24;0;0;0;0;.00nan;0;0
356;13979;24;100;25;0;25;1.000;3600000;0
356;14061;28;78;36;3;33;.917;3600000;0
357;4450;5;80;36;2;34;.944;3600000;0
357;15464;32;74;36;3;33;.917;3547000;0
357;16006;32;0;0;0;0;.00nan;0;0
357;19823;5;0;0;0;0;.00nan;0;0
358;445;12;100;29;0;29;1.000;3600000;0
358;13842;34;98;44;2;42;.955;3600000;0
358;15502;34;0;0;0;0;.00nan;0;0
358;34786;12;0;0;0;0;.00nan;0;0
359;51;21;0;0;0;0;.00nan;0;0
359;262;35;0;0;0;0;.00nan;0;0
359;1430;35;94;44;3;41;.932;3600000;0
359;25843;21;91;35;2;33;.943;3600000;0
360;544;19;74;32;3;29;.906;3900000;0
360;724;11;79;38;3;35;.921;3900000;0
360;21522;11;0;0;0;0;.00nan;0;0
360;31124;19;0;0;0;0;.00nan;0;0
361;738;27;58;45;5;40;.889;3600000;0
361;18104;10;0;0;0;0;.00nan;0;0
361;26623;27;0;0;0;0;.00nan;0;0
361;27488;10;78;37;2;35;.946;3600000;0
362;51;21;56;32;4;28;.875;3591000;0
362;4506;33;99;49;3;46;.939;3600000;0
362;25843;21;0;0;0;0;.00nan;0;0
362;34740;33;0;0;0;0;.00nan;0;0
363;500;4182;83;30;1;29;.967;3600000;0
363;22601;26;0;0;0;0;.00nan;0;0
363;25521;4182;0;0;0;0;.00nan;0;0
363;32754;26;96;45;3;42;.933;3555000;0
364;544;19;0;0;0;0;.00nan;0;0
364;1913;30;0;0;0;0;.00nan;0;0
364;4826;30;44;28;5;23;.821;3583000;0
364;31124;19;56;32;4;28;.875;3600000;0
365;823;23;0;0;0;0;.00nan;0;0
365;1572;4838;0;0;0;0;.00nan;0;0
365;2328;4838;80;52;5;47;.904;3600000;0
365;10274;23;85;36;2;34;.944;3600000;0
366;233;29;63;16;1;15;.938;1183000;0
366;4450;5;77;26;2;24;.923;3600000;0
366;18351;29;36;40;8;32;.800;2417000;0
366;19823;5;0;0;0;0;.00nan;0;0
367;1614;25;82;26;2;24;.923;3625000;0
367;2058;28;77;34;3;31;.912;3625000;0
367;5182;25;0;0;0;0;.00nan;0;0
367;14061;28;0;0;0;0;.00nan;0;0
368;376;9;0;0;0;0;.00nan;0;0
368;928;20;0;0;0;0;.00nan;0;0
368;18078;20;94;31;1;30;.968;3870000;0
368;20853;9;84;33;2;31;.939;3870000;0
369;61;31;0;0;0;0;.00nan;0;0
369;1796;16;0;0;0;0;.00nan;0;0
369;15437;16;70;30;3;27;.900;3560000;0
369;34797;31;74;26;2;24;.923;3600000;0
370;15505;8;95;44;2;42;.955;3566000;0
370;18104;10;70;20;1;19;.950;3600000;0
370;25076;8;0;0;0;0;.00nan;0;0
370;27488;10;0;0;0;0;.00nan;0;0
371;13842;34;49;29;4;25;.862;3575000;0
371;15502;34;0;0;0;0;.00nan;0;0
371;27739;22;0;0;0;0;.00nan;0;0
371;28026;22;91;39;2;37;.949;3600000;0
372;5385;17;0;0;0;0;.00nan;0;0
372;10103;24;0;0;0;0;.00nan;0;0
372;13979;24;44;31;5;26;.839;3548000;0
372;34006;17;100;51;4;47;.922;3600000;0
373;1074;0;81;37;3;34;.919;3565000;0
373;15464;32;0;0;0;0;.00nan;0;0
373;16006;32;80;28;1;27;.964;3600000;0
373;31035;0;0;0;0;0;.00nan;0;0
374;262;35;0;0;0;0;.00nan;0;0
374;1430;35;94;30;1;29;.967;3600000;0
374;1821;3;75;54;5;49;.907;3600000;0
374;2054;3;0;0;0;0;.00nan;0;0
375;335;18;0;0;0;0;.00nan;0;0
375;2423;15;73;18;1;17;.944;3600000;0
375;4106;15;0;0;0;0;.00nan;0;0
375;5001;18;69;41;4;37;.902;3600000;0
376;233;29;0;0;0;0;.00nan;0;0
376;1251;14;64;34;4;30;.882;3555000;0
376;18351;29;86;42;3;39;.929;3600000;0
376;25584;14;0;0;0;0;.00nan;0;0
377;738;27;36;26;6;20;.769;2720000;0
377;13842;34;0;0;0;0;.00nan;0;0
377;15502;34;90;39;3;36;.923;3600000;0
377;26623;27;42;3;1;2;.667;880000;0
378;928;20;55;21;2;19;.905;3574000;0
378;15505;8;0;0;0;0;.00nan;0;0
378;18078;20;0;0;0;0;.00nan;0;0
378;25076;8;94;30;1;29;.967;3600000;0
379;1821;3;0;0;0;0;.00nan;0;0
379;2054;3;83;32;2;30;.938;3600000;0
379;4506;33;40;31;5;26;.839;3600000;0
379;34740;33;0;0;0;0;.00nan;0;0
380;724;11;79;27;1;26;.963;3600000;0
380;823;23;0;0;0;0;.00nan;0;0
380;10274;23;62;41;5;36;.878;3600000;0
380;21522;11;0;0;0;0;.00nan;0;0
381;500;4182;0;0;0;0;.00nan;0;0
381;544;19;0;0;0;0;.00nan;0;0
381;25521;4182;55;28;4;24;.857;3600000;0
381;31124;19;99;45;2;43;.956;3600000;0
382;1251;14;0;0;0;0;.00nan;0;0
382;1614;25;85;20;0;20;1.000;3600000;0
382;5182;25;0;0;0;0;.00nan;0;0
382;25584;14;69;33;3;30;.909;3600000;0
383;1913;30;0;0;0;0;.00nan;0;0
383;4826;30;58;45;5;40;.889;3600000;0
383;27739;22;0;0;0;0;.00nan;0;0
383;28026;22;84;24;1;23;.958;3600000;0
384;445;12;72;19;1;18;.947;3600000;0
384;22601;26;74;32;2;30;.938;3560000;0
384;32754;26;0;0;0;0;.00nan;0;0
384;34786;12;0;0;0;0;.00nan;0;0
385;335;18;46;19;3;16;.842;1744000;0
385;724;11;0;0;0;0;.00nan;0;0
385;5001;18;22;20;6;14;.700;1856000;0
385;21522;11;71;42;4;38;.905;3600000;0
386;1572;4838;0;0;0;0;.00nan;0;0
386;2328;4838;82;46;4;42;.913;3900000;0
386;2423;15;58;29;4;25;.862;3900000;0
386;4106;15;0;0;0;0;.00nan;0;0
387;1913;30;60;22;2;20;.909;3580000;0
387;4826;30;0;0;0;0;.00nan;0;0
387;5385;17;0;0;0;0;.00nan;0;0
387;34006;17;100;22;0;22;1.000;3600000;0
388;1821;3;74;19;1;18;.947;3600000;0
388;2054;3;0;0;0;0;.00nan;0;0
388;13842;34;0;0;0;0;.00nan;0;0
388;15502;34;89;52;2;50;.962;3563000;0
389;233;29;0;0;0;0;.00nan;0;0
389;1074;0;75;37;4;33;.892;3600000;0
389;18351;29;82;26;1;25;.962;3600000;0
389;31035;0;0;0;0;0;.00nan;0;0
390;928;20;0;0;0;0;.00nan;0;0
390;2058;28;97;20;0;20;1.000;3600000;0
390;14061;28;0;0;0;0;.00nan;0;0
390;18078;20;43;24;5;19;.792;3600000;0
391;376;9;0;0;0;0;.00nan;0;0
391;15464;32;82;27;1;26;.963;3600000;0
391;16006;32;0;0;0;0;.00nan;0;0
391;20853;9;81;32;2;30;.938;3584000;0
392;15505;8;56;41;5;36;.878;3600000;0
392;18104;10;0;0;0;0;.00nan;0;0
392;25076;8;0;0;0;0;.00nan;0;0
392;27488;10;57;25;2;23;.920;3600000;0
393;61;31;0;0;0;0;.00nan;0;0
393;1796;16;59;7;0;7;1.000;1212000;0
393;15437;16;33;21;5;16;.762;2388000;0
393;34797;31;52;26;4;22;.846;3600000;0
394;4506;33;44;17;3;14;.824;3802000;0
394;10103;24;83;53;4;49;.925;3802000;0
394;13979;24;0;0;0;0;.00nan;0;0
394;34740;33;0;0;0;0;.00nan;0;0
395;262;35;0;0;0;0;.00nan;0;0
395;823;23;0;0;0;0;.00nan;0;0
395;1430;35;72;27;2;25;.926;3600000;0
395;10274;23;100;40;1;39;.975;3600000;0
396;544;19;81;33;3;30;.909;3600000;0
396;738;27;0;0;0;0;.00nan;0;0
396;26623;27;44;24;4;20;.833;3573000;0
396;31124;19;0;0;0;0;.00nan;0;0
397;51;21;0;0;0;0;.00nan;0;0
397;1251;14;51;29;4;25;.862;3537000;0
397;25584;14;0;0;0;0;.00nan;0;0
397;25843;21;88;37;2;35;.946;3600000;0
398;1614;25;77;32;2;30;.938;3600000;0
398;5182;25;0;0;0;0;.00nan;0;0
398;18104;10;57;41;5;36;.878;3600000;0
398;27488;10;0;0;0;0;.00nan;0;0
399;335;18;38;33;6;27;.818;2504000;0
399;4450;5;77;27;2;25;.926;3600000;0
399;5001;18;56;13;1;12;.923;1096000;0
399;19823;5;0;0;0;0;.00nan;0;0
400;445;12;67;15;1;14;.933;3600000;0
400;500;4182;69;43;4;39;.907;3600000;0
400;25521;4182;0;0;0;0;.00nan;0;0
400;34786;12;0;0;0;0;.00nan;0;0
401;233;29;0;0;0;0;.00nan;0;0
401;1821;3;94;39;2;37;.949;3600000;0
401;2054;3;0;0;0;0;.00nan;0;0
401;18351;29;49;34;5;29;.853;3600000;0
402;1074;0;62;21;2;19;.905;3600000;0
402;15505;8;64;41;5;36;.878;3600000;0
402;25076;8;0;0;0;0;.00nan;0;0
402;31035;0;0;0;0;0;.00nan;0;0
403;928;20;17;16;6;10;.625;2968000;0
403;15464;32;0;0;0;0;.00nan;0;0
403;16006;32;77;47;4;43;.915;3600000;0
403;18078;20;52;5;0;5;1.000;561000;0
404;1913;30;0;0;0;0;.00nan;0;0
404;4826;30;68;47;6;41;.872;3600000;0
404;13842;34;94;25;1;24;.960;3600000;0
404;15502;34;0;0;0;0;.00nan;0;0
405;376;9;0;0;0;0;.00nan;0;0
405;1796;16;0;0;0;0;.00nan;0;0
405;15437;16;27;20;5;15;.750;3569000;0
405;20853;9;65;43;5;38;.884;3600000;0
406;544;19;0;0;0;0;.00nan;0;0
406;10103;24;0;0;0;0;.00nan;0;0
406;13979;24;100;35;1;34;.971;3600000;0
406;31124;19;69;30;3;27;.900;3581000;0
407;823;23;0;0;0;0;.00nan;0;0
407;4450;5;0;0;0;0;.00nan;0;0
407;10274;23;62;31;4;27;.871;3655000;0
407;19823;5;99;53;3;50;.943;3655000;0
408;445;12;0;0;0;0;.00nan;0;0
408;724;11;0;0;0;0;.00nan;0;0
408;21522;11;79;38;3;35;.921;3900000;0
408;34786;12;70;30;3;27;.900;3900000;0
409;262;35;0;0;0;0;.00nan;0;0
409;738;27;0;0;0;0;.00nan;0;0
409;1430;35;64;30;3;27;.900;3580000;0
409;26623;27;81;32;1;31;.969;3600000;0
410;1572;4838;0;0;0;0;.00nan;0;0
410;2328;4838;85;37;2;35;.946;3900000;0
410;4506;33;70;28;2;26;.929;3900000;0
410;34740;33;0;0;0;0;.00nan;0;0
411;5385;17;0;0;0;0;.00nan;0;0
411;18104;10;0;0;0;0;.00nan;0;0
411;27488;10;73;22;1;21;.955;3598000;0
411;34006;17;100;29;0;29;1.000;3600000;0
412;51;21;0;0;0;0;.00nan;0;0
412;15464;32;94;48;2;46;.958;3839000;0
412;16006;32;0;0;0;0;.00nan;0;0
412;25843;21;72;25;1;24;.960;3839000;0
413;2423;15;100;44;1;43;.977;3600000;0
413;4106;15;0;0;0;0;.00nan;0;0
413;27739;22;0;0;0;0;.00nan;0;0
413;28026;22;78;32;2;30;.938;3575000;0
414;376;9;54;35;5;30;.857;1872000;0
414;1614;25;95;22;0;22;1.000;3600000;0
414;5182;25;0;0;0;0;.00nan;0;0
414;20853;9;63;19;2;17;.895;1728000;0
415;61;31;0;0;0;0;.00nan;0;0
415;22601;26;100;44;1;43;.977;3600000;0
415;32754;26;0;0;0;0;.00nan;0;0
415;34797;31;43;16;3;13;.813;3573000;0
416;335;18;55;5;0;5;1.000;277000;0
416;4506;33;42;20;4;16;.800;3600000;0
416;5001;18;43;42;7;35;.833;3323000;0
416;34740;33;0;0;0;0;.00nan;0;0
417;500;4182;100;32;1;31;.969;3600000;0
417;1251;14;71;26;3;23;.885;3518000;0
417;25521;4182;0;0;0;0;.00nan;0;0
417;25584;14;0;0;0;0;.00nan;0;0
418;5385;17;0;0;0;0;.00nan;0;0
418;27739;22;92;38;1;37;.974;3573000;0
418;28026;22;0;0;0;0;.00nan;0;0
418;34006;17;100;28;0;28;1.000;3600000;0
419;1821;3;0;0;0;0;.00nan;0;0
419;2054;3;74;35;3;32;.914;3600000;0
419;15505;8;51;24;4;20;.833;3548000;0
419;25076;8;0;0;0;0;.00nan;0;0
420;233;29;0;0;0;0;.00nan;0;0
420;2058;28;55;30;4;26;.867;3554000;0
420;14061;28;0;0;0;0;.00nan;0;0
420;18351;29;78;32;2;30;.938;3600000;0
421;51;21;89;35;2;33;.943;3600000;0
421;928;20;66;24;3;21;.875;3576000;0
421;18078;20;0;0;0;0;.00nan;0;0
421;25843;21;0;0;0;0;.00nan;0;0
422;1913;30;59;4;0;4;1.000;421000;0
422;2423;15;0;0;0;0;.00nan;0;0
422;4106;15;52;19;3;16;.842;3600000;0
422;4826;30;57;46;6;40;.870;3179000;0
423;1074;0;68;40;4;36;.900;3600000;0
423;1796;16;0;0;0;0;.00nan;0;0
423;15437;16;94;19;0;19;1.000;3600000;0
423;31035;0;0;0;0;0;.00nan;0;0
424;544;19;0;0;0;0;.00nan;0;0
424;4450;5;65;26;2;24;.923;3600000;0
424;19823;5;0;0;0;0;.00nan;0;0
424;31124;19;66;36;3;33;.917;3554000;0
425;823;23;0;0;0;0;.00nan;0;0
425;10103;24;0;0;0;0;.00nan;0;0
425;10274;23;89;30;1;29;.967;3688000;0
425;13979;24;92;35;2;33;.943;3688000;0
426;1251;14;0;0;0;0;.00nan;0;0
426;22601;26;0;0;0;0;.00nan;0;0
426;25584;14;65;23;2;21;.913;3745000;0
426;32754;26;100;53;1;52;.981;3745000;0
427;262;35;0;0;0;0;.00nan;0;0
427;724;11;70;32;3;29;.906;3600000;0
427;1430;35;100;35;0;35;1.000;3600000;0
427;21522;11;0;0;0;0;.00nan;0;0
428;445;12;0;0;0;0;.00nan;0;0
428;738;27;0;0;0;0;.00nan;0;0
428;26623;27;66;30;3;27;.900;3600000;0
428;34786;12;41;35;6;29;.829;3600000;0
429;1572;4838;0;0;0;0;.00nan;0;0
429;2328;4838;54;21;3;18;.857;3583000;0
429;13842;34;76;34;2;32;.941;3600000;0
429;15502;34;0;0;0;0;.00nan;0;0
430;15464;32;100;38;0;38;1.000;3600000;0
430;16006;32;0;0;0;0;.00nan;0;0
430;18104;10;0;0;0;0;.00nan;0;0
430;27488;10;58;23;2;21;.913;3516000;0
431;1796;16;0;0;0;0;.00nan;0;0
431;1913;30;90;47;3;44;.936;3600000;0
431;4826;30;0;0;0;0;.00nan;0;0
431;15437;16;89;17;0;17;1.000;3600000;0
432;61;31;75;30;2;28;.933;3900000;0
432;1614;25;68;24;2;22;.917;3900000;0
432;5182;25;0;0;0;0;.00nan;0;0
432;34797;31;0;0;0;0;.00nan;0;0
433;335;18;0;0;0;0;.00nan;0;0
433;5001;18;84;31;1;30;.968;3900000;0
433;10103;24;94;34;1;33;.971;3900000;0
433;13979;24;0;0;0;0;.00nan;0;0
434;262;35;0;0;0;0;.00nan;0;0
434;500;4182;48;36;5;31;.861;3832000;0
434;1430;35;74;36;4;32;.889;3832000;0
434;25521;4182;0;0;0;0;.00nan;0;0
435;544;19;0;0;0;0;.00nan;0;0
435;15505;8;82;31;2;29;.935;3898000;0
435;25076;8;0;0;0;0;.00nan;0;0
435;31124;19;77;28;2;26;.929;3900000;0
436;500;4182;0;0;0;0;.00nan;0;0
436;4450;5;0;0;0;0;.00nan;0;0
436;19823;5;71;25;3;22;.880;3900000;0
436;25521;4182;83;37;3;34;.919;3900000;0
437;376;9;0;0;0;0;.00nan;0;0
437;928;20;0;0;0;0;.00nan;0;0
437;18078;20;62;26;3;23;.885;3555000;0
437;20853;9;90;45;2;43;.956;3600000;0
438;233;29;0;0;0;0;.00nan;0;0
438;724;11;0;0;0;0;.00nan;0;0
438;18351;29;78;28;2;26;.929;3600000;0
438;21522;11;97;49;3;46;.939;3580000;0
439;61;31;85;34;2;32;.941;3600000;0
439;2058;28;64;41;5;36;.878;3600000;0
439;14061;28;0;0;0;0;.00nan;0;0
439;34797;31;0;0;0;0;.00nan;0;0
440;51;21;0;0;0;0;.00nan;0;0
440;1251;14;62;16;2;14;.875;3600000;0
440;25584;14;0;0;0;0;.00nan;0;0
440;25843;21;58;27;3;24;.889;3582000;0
441;1074;0;88;43;3;40;.930;3600000;0
441;2423;15;94;26;0;26;1.000;3600000;0
441;4106;15;0;0;0;0;.00nan;0;0
441;31035;0;0;0;0;0;.00nan;0;0
442;544;19;72;27;2;25;.926;3600000;0
442;15464;32;78;49;4;45;.918;3600000;0
442;16006;32;0;0;0;0;.00nan;0;0
442;31124;19;0;0;0;0;.00nan;0;0
443;445;12;77;30;3;27;.900;3543000;0
443;1796;16;0;0;0;0;.00nan;0;0
443;15437;16;88;25;1;24;.960;3600000;0
443;34786;12;0;0;0;0;.00nan;0;0
444;262;35;0;0;0;0;.00nan;0;0
444;1430;35;70;29;3;26;.897;3900000;0
444;10103;24;0;0;0;0;.00nan;0;0
444;13979;24;66;34;3;31;.912;3871000;0
445;4506;33;75;31;3;28;.903;3600000;0
445;5385;17;0;0;0;0;.00nan;0;0
445;34006;17;44;34;6;28;.824;3600000;0
445;34740;33;0;0;0;0;.00nan;0;0
446;1614;25;50;20;3;17;.850;3559000;0
446;5182;25;0;0;0;0;.00nan;0;0
446;18104;10;93;42;2;40;.952;3600000;0
446;27488;10;0;0;0;0;.00nan;0;0
447;823;23;0;0;0;0;.00nan;0;0
447;1821;3;69;28;2;26;.929;3600000;0
447;2054;3;0;0;0;0;.00nan;0;0
447;10274;23;79;46;3;43;.935;3600000;0
448;335;18;88;33;2;31;.939;3600000;0
448;5001;18;0;0;0;0;.00nan;0;0
448;13842;34;62;44;6;38;.864;3600000;0
448;15502;34;0;0;0;0;.00nan;0;0
449;738;27;53;3;0;3;1.000;342000;0
449;1572;4838;0;0;0;0;.00nan;0;0
449;2328;4838;86;29;1;28;.966;3600000;0
449;26623;27;65;37;6;31;.838;3258000;0
450;15505;8;44;41;6;35;.854;3529000;0
450;25076;8;0;0;0;0;.00nan;0;0
450;27739;22;0;0;0;0;.00nan;0;0
450;28026;22;49;26;4;22;.846;3600000;0
451;18104;10;0;0;0;0;.00nan;0;0
451;22601;26;0;0;0;0;.00nan;0;0
451;27488;10;66;23;2;21;.913;3600000;0
451;32754;26;72;32;3;29;.906;3600000;0
452;1572;4838;48;25;4;21;.840;3900000;0
452;1913;30;0;0;0;0;.00nan;0;0
452;2328;4838;0;0;0;0;.00nan;0;0
452;4826;30;67;35;4;31;.886;3900000;0
453;1074;0;76;31;3;28;.903;3600000;0
453;1251;14;51;28;4;24;.857;3600000;0
453;25584;14;0;0;0;0;.00nan;0;0
453;31035;0;0;0;0;0;.00nan;0;0
454;233;29;0;0;0;0;.00nan;0;0
454;2058;28;70;50;5;45;.900;3514000;0
454;14061;28;0;0;0;0;.00nan;0;0
454;18351;29;63;33;3;30;.909;3600000;0
455;61;31;67;33;4;29;.879;3573000;0
455;724;11;90;47;2;45;.957;3600000;0
455;21522;11;0;0;0;0;.00nan;0;0
455;34797;31;0;0;0;0;.00nan;0;0
456;51;21;67;38;4;34;.895;3515000;0
456;500;4182;73;26;2;24;.923;3600000;0
456;25521;4182;0;0;0;0;.00nan;0;0
456;25843;21;0;0;0;0;.00nan;0;0
457;928;20;60;22;2;20;.909;3600000;0
457;4450;5;74;34;3;31;.912;3555000;0
457;18078;20;0;0;0;0;.00nan;0;0
457;19823;5;0;0;0;0;.00nan;0;0
458;376;9;39;25;5;20;.800;2554000;0
458;10103;24;0;0;0;0;.00nan;0;0
458;13979;24;85;27;1;26;.963;3600000;0
458;20853;9;39;21;4;17;.810;1046000;0
459;1614;25;100;36;1;35;.972;3600000;0
459;5182;25;0;0;0;0;.00nan;0;0
459;15464;32;27;13;4;9;.692;810000;0
459;16006;32;57;13;1;12;.923;2790000;0
460;262;35;47;24;4;20;.833;3600000;0
460;1430;35;0;0;0;0;.00nan;0;0
460;5385;17;0;0;0;0;.00nan;0;0
460;34006;17;100;53;1;52;.981;3600000;0
461;544;19;0;0;0;0;.00nan;0;0
461;1821;3;76;21;2;19;.905;3600000;0
461;2054;3;0;0;0;0;.00nan;0;0
461;31124;19;69;35;3;32;.914;3564000;0
462;823;23;0;0;0;0;.00nan;0;0
462;10274;23;71;25;2;23;.920;3600000;0
462;13842;34;93;61;6;55;.902;3600000;0
462;15502;34;0;0;0;0;.00nan;0;0
463;335;18;0;0;0;0;.00nan;0;0
463;738;27;0;0;0;0;.00nan;0;0
463;5001;18;47;35;5;30;.857;3543000;0
463;26623;27;53;30;4;26;.867;3600000;0
464;500;4182;0;0;0;0;.00nan;0;0
464;18104;10;0;0;0;0;.00nan;0;0
464;25521;4182;85;35;2;33;.943;3600000;0
464;27488;10;44;39;6;33;.846;3600000;0
465;2423;15;91;41;3;38;.927;3877000;0
465;4106;15;0;0;0;0;.00nan;0;0
465;5385;17;0;0;0;0;.00nan;0;0
465;34006;17;100;46;2;44;.957;3877000;0
466;15464;32;48;27;5;22;.815;3600000;0
466;15505;8;57;18;2;16;.889;3600000;0
466;16006;32;0;0;0;0;.00nan;0;0
466;25076;8;0;0;0;0;.00nan;0;0
467;445;12;80;44;4;40;.909;3600000;0
467;1796;16;0;0;0;0;.00nan;0;0
467;15437;16;77;22;1;21;.955;3600000;0
467;34786;12;0;0;0;0;.00nan;0;0
468;4506;33;72;46;4;42;.913;3900000;0
468;27739;22;0;0;0;0;.00nan;0;0
468;28026;22;64;33;4;29;.879;3900000;0
468;34740;33;0;0;0;0;.00nan;0;0
469;1913;30;72;38;4;34;.895;3608000;0
469;4826;30;0;0;0;0;.00nan;0;0
469;22601;26;0;0;0;0;.00nan;0;0
469;32754;26;53;21;3;18;.857;3604000;0
470;1074;0;100;32;0;32;1.000;3600000;0
470;4450;5;68;32;3;29;.906;3600000;0
470;19823;5;0;0;0;0;.00nan;0;0
470;31035;0;0;0;0;0;.00nan;0;0
471;51;21;0;0;0;0;.00nan;0;0
471;376;9;0;0;0;0;.00nan;0;0
471;20853;9;39;24;5;19;.792;3596000;0
471;25843;21;84;40;4;36;.900;3600000;0
472;1251;14;81;37;3;34;.919;3600000;0
472;2058;28;40;30;5;25;.833;3543000;0
472;14061;28;0;0;0;0;.00nan;0;0
472;25584;14;0;0;0;0;.00nan;0;0
473;724;11;0;0;0;0;.00nan;0;0
473;10103;24;0;0;0;0;.00nan;0;0
473;13979;24;45;23;3;20;.870;3900000;0
473;21522;11;99;43;3;40;.930;3900000;0
474;445;12;0;0;0;0;.00nan;0;0
474;15505;8;0;0;0;0;.00nan;0;0
474;25076;8;84;41;3;38;.927;3900000;0
474;34786;12;61;27;3;24;.889;3900000;0
475;61;31;59;22;2;20;.909;3600000;0
475;262;35;0;0;0;0;.00nan;0;0
475;1430;35;98;58;4;54;.931;3600000;0
475;34797;31;0;0;0;0;.00nan;0;0
476;233;29;0;0;0;0;.00nan;0;0
476;1614;25;78;24;1;23;.958;3600000;0
476;5182;25;0;0;0;0;.00nan;0;0
476;18351;29;69;27;2;25;.926;3545000;0
477;544;19;0;0;0;0;.00nan;0;0
477;13842;34;45;32;5;27;.844;3600000;0
477;15502;34;0;0;0;0;.00nan;0;0
477;31124;19;81;31;2;29;.935;3600000;0
478;335;18;73;24;1;23;.958;3600000;0
478;1821;3;72;33;2;31;.939;3573000;0
478;2054;3;0;0;0;0;.00nan;0;0
478;5001;18;0;0;0;0;.00nan;0;0
479;823;23;0;0;0;0;.00nan;0;0
479;1572;4838;0;0;0;0;.00nan;0;0
479;2328;4838;97;41;2;39;.951;3553000;0
479;10274;23;95;33;1;32;.970;3600000;0
480;2058;28;0;0;0;0;.00nan;0;0
480;4450;5;0;0;0;0;.00nan;0;0
480;14061;28;64;33;3;30;.909;3547000;0
480;19823;5;77;22;1;21;.955;3600000;0
481;51;21;88;31;2;29;.935;3600000;0
481;2423;15;0;0;0;0;.00nan;0;0
481;4106;15;88;47;3;44;.936;3581000;0
481;25843;21;0;0;0;0;.00nan;0;0
482;500;4182;84;40;3;37;.925;3600000;0
482;928;20;60;31;4;27;.871;3566000;0
482;18078;20;0;0;0;0;.00nan;0;0
482;25521;4182;0;0;0;0;.00nan;0;0
483;724;11;65;34;4;30;.882;3600000;0
483;21522;11;0;0;0;0;.00nan;0;0
483;27739;22;0;0;0;0;.00nan;0;0
483;28026;22;100;32;0;32;1.000;3600000;0
484;10103;24;68;38;4;34;.895;3600000;0
484;13979;24;0;0;0;0;.00nan;0;0
484;15464;32;34;32;6;26;.813;3275000;0
484;16006;32;49;1;0;1;1.000;238000;0
485;1796;16;0;0;0;0;.00nan;0;0
485;4506;33;0;0;0;0;.00nan;0;0
485;15437;16;90;28;1;27;.964;3600000;0
485;34740;33;27;34;6;28;.824;3600000;0
486;335;18;0;0;0;0;.00nan;0;0
486;5001;18;88;34;2;32;.941;3600000;0
486;22601;26;0;0;0;0;.00nan;0;0
486;32754;26;73;41;4;37;.902;3579000;0
487;1572;4838;58;25;3;22;.880;3563000;0
487;1821;3;76;26;1;25;.962;3600000;0
487;2054;3;0;0;0;0;.00nan;0;0
487;2328;4838;0;0;0;0;.00nan;0;0
488;5385;17;0;0;0;0;.00nan;0;0
488;13842;34;62;36;4;32;.889;3580000;0
488;15502;34;0;0;0;0;.00nan;0;0
488;34006;17;100;46;2;44;.957;3600000;0
489;376;9;59;4;0;4;1.000;803000;0
489;1614;25;44;30;6;24;.800;3900000;0
489;5182;25;0;0;0;0;.00nan;0;0
489;20853;9;54;37;6;31;.838;3097000;0
490;928;20;0;0;0;0;.00nan;0;0
490;1074;0;77;40;4;36;.900;3568000;0
490;18078;20;64;25;3;22;.880;3600000;0
490;31035;0;0;0;0;0;.00nan;0;0
491;262;35;0;0;0;0;.00nan;0;0
491;445;12;77;24;1;23;.958;3600000;0
491;1430;35;70;28;2;26;.929;3550000;0
491;34786;12;0;0;0;0;.00nan;0;0
492;823;23;0;0;0;0;.00nan;0;0
492;1913;30;76;42;5;37;.881;3565000;0
492;4826;30;0;0;0;0;.00nan;0;0
492;10274;23;48;27;4;23;.852;3600000;0
493;4450;5;74;28;2;26;.929;3548000;0
493;10103;24;0;0;0;0;.00nan;0;0
493;13979;24;99;35;1;34;.971;3600000;0
493;19823;5;0;0;0;0;.00nan;0;0
494;1796;16;0;0;0;0;.00nan;0;0
494;2058;28;81;36;3;33;.917;3586000;0
494;14061;28;0;0;0;0;.00nan;0;0
494;15437;16;70;19;2;17;.895;3600000;0
495;1251;14;71;32;3;29;.906;3600000;0
495;25584;14;0;0;0;0;.00nan;0;0
495;27739;22;0;0;0;0;.00nan;0;0
495;28026;22;100;28;0;28;1.000;3600000;0
496;51;21;0;0;0;0;.00nan;0;0
496;2423;15;52;22;3;19;.864;3597000;0
496;4106;15;0;0;0;0;.00nan;0;0
496;25843;21;90;38;2;36;.947;3606000;0
497;61;31;64;32;4;28;.875;3600000;0
497;15505;8;89;32;1;31;.969;3600000;0
497;25076;8;0;0;0;0;.00nan;0;0
497;34797;31;0;0;0;0;.00nan;0;0
498;4506;33;72;37;4;33;.892;3600000;0
498;15464;32;0;0;0;0;.00nan;0;0
498;16006;32;57;36;5;31;.861;3553000;0
498;34740;33;0;0;0;0;.00nan;0;0
499;544;19;0;0;0;0;.00nan;0;0
499;1913;30;0;0;0;0;.00nan;0;0
499;4826;30;59;51;6;45;.882;3600000;0
499;31124;19;69;24;2;22;.917;3600000;0
500;233;29;0;0;0;0;.00nan;0;0
500;500;4182;81;34;3;31;.912;3600000;0
500;18351;29;58;19;2;17;.895;3600000;0
500;25521;4182;0;0;0;0;.00nan;0;0
501;335;18;0;0;0;0;.00nan;0;0
501;738;27;0;0;0;0;.00nan;0;0
501;5001;18;80;48;5;43;.896;3555000;0
501;26623;27;54;29;4;25;.862;3600000;0
502;1572;4838;0;0;0;0;.00nan;0;0
502;2328;4838;69;17;1;16;.941;3600000;0
502;22601;26;60;8;0;8;1.000;666000;0
502;32754;26;49;34;6;28;.824;2934000;0
503;1614;25;56;33;4;29;.879;3600000;0
503;5182;25;0;0;0;0;.00nan;0;0
503;5385;17;0;0;0;0;.00nan;0;0
503;34006;17;70;32;3;29;.906;3600000;0
504;1074;0;78;39;4;35;.897;3600000;0
504;18104;10;0;0;0;0;.00nan;0;0
504;27488;10;100;26;0;26;1.000;3600000;0
504;31035;0;0;0;0;0;.00nan;0;0
505;445;12;71;39;4;35;.897;3597000;0
505;4506;33;69;36;3;33;.917;3600000;0
505;34740;33;0;0;0;0;.00nan;0;0
505;34786;12;0;0;0;0;.00nan;0;0
506;724;11;81;36;3;33;.917;3600000;0
506;823;23;0;0;0;0;.00nan;0;0
506;10274;23;88;16;0;16;1.000;3600000;0
506;21522;11;0;0;0;0;.00nan;0;0
507;1614;25;0;0;0;0;.00nan;0;0
507;4450;5;0;0;0;0;.00nan;0;0
507;5182;25;86;44;3;41;.932;3600000;0
507;19823;5;64;33;4;29;.879;3565000;0
508;1796;16;0;0;0;0;.00nan;0;0
508;1821;3;61;20;2;18;.900;3600000;0
508;2054;3;0;0;0;0;.00nan;0;0
508;15437;16;78;39;3;36;.923;3574000;0
509;2058;28;18;8;4;4;.500;1102000;0
509;10103;24;0;0;0;0;.00nan;0;0
509;13979;24;76;25;2;23;.920;3600000;0
509;14061;28;71;23;2;21;.913;2498000;0
510;61;31;37;22;5;17;.773;3600000;0
510;15464;32;0;0;0;0;.00nan;0;0
510;16006;32;53;45;6;39;.867;3546000;0
510;34797;31;0;0;0;0;.00nan;0;0
511;51;21;0;0;0;0;.00nan;0;0
511;1074;0;0;0;0;0;.00nan;0;0
511;25843;21;65;18;2;16;.889;3600000;0
511;31035;0;60;38;4;34;.895;3576000;0
512;928;20;84;38;3;35;.921;3600000;0
512;18078;20;0;0;0;0;.00nan;0;0
512;27739;22;0;0;0;0;.00nan;0;0
512;28026;22;100;25;0;25;1.000;3600000;0
513;1251;14;24;23;6;17;.739;2189000;0
513;2423;15;88;28;1;27;.964;3600000;0
513;4106;15;0;0;0;0;.00nan;0;0
513;25584;14;69;14;0;14;1.000;1411000;0
514;5385;17;0;0;0;0;.00nan;0;0
514;13842;34;0;0;0;0;.00nan;0;0
514;15502;34;57;31;4;27;.871;3578000;0
514;34006;17;71;24;2;22;.917;3600000;0
515;445;12;0;0;0;0;.00nan;0;0
515;15505;8;77;40;4;36;.900;3528000;0
515;25076;8;0;0;0;0;.00nan;0;0
515;34786;12;71;27;2;25;.926;3600000;0
516;262;35;0;0;0;0;.00nan;0;0
516;376;9;0;0;0;0;.00nan;0;0
516;1430;35;92;33;2;31;.939;3600000;0
516;20853;9;100;28;0;28;1.000;3600000;0
517;544;19;0;0;0;0;.00nan;0;0
517;1572;4838;0;0;0;0;.00nan;0;0
517;2328;4838;80;43;4;39;.907;3600000;0
517;31124;19;90;16;0;16;1.000;3600000;0
518;233;29;0;0;0;0;.00nan;0;0
518;18351;29;84;35;2;33;.943;3900000;0
518;22601;26;0;0;0;0;.00nan;0;0
518;32754;26;90;35;2;33;.943;3900000;0
519;335;18;0;0;0;0;.00nan;0;0
519;1913;30;51;38;5;33;.868;3581000;0
519;4826;30;0;0;0;0;.00nan;0;0
519;5001;18;61;24;3;21;.875;3600000;0
520;500;4182;34;24;5;19;.792;3600000;0
520;724;11;0;0;0;0;.00nan;0;0
520;21522;11;58;51;7;44;.863;3514000;0
520;25521;4182;0;0;0;0;.00nan;0;0
521;738;27;0;0;0;0;.00nan;0;0
521;823;23;0;0;0;0;.00nan;0;0
521;10274;23;53;25;3;22;.880;3557000;0
521;26623;27;62;21;2;19;.905;3600000;0
522;2423;15;91;37;2;35;.946;3900000;0
522;4106;15;0;0;0;0;.00nan;0;0
522;4450;5;97;32;2;30;.938;3900000;0
522;19823;5;0;0;0;0;.00nan;0;0
523;928;20;88;27;1;26;.963;3600000;0
523;5385;17;0;0;0;0;.00nan;0;0
523;18078;20;0;0;0;0;.00nan;0;0
523;34006;17;60;32;4;28;.875;3600000;0
524;376;9;0;0;0;0;.00nan;0;0
524;18104;10;0;0;0;0;.00nan;0;0
524;20853;9;58;34;4;30;.882;3600000;0
524;27488;10;100;29;0;29;1.000;3600000;0
525;2058;28;89;43;4;39;.907;3600000;0
525;14061;28;0;0;0;0;.00nan;0;0
525;27739;22;0;0;0;0;.00nan;0;0
525;28026;22;71;25;2;23;.920;3600000;0
526;61;31;85;39;3;36;.923;3900000;0
526;10103;24;0;0;0;0;.00nan;0;0
526;13979;24;81;33;3;30;.909;3900000;0
526;34797;31;0;0;0;0;.00nan;0;0
527;1821;3;76;51;6;45;.882;3600000;0
527;2054;3;0;0;0;0;.00nan;0;0
527;13842;34;100;43;2;41;.953;3600000;0
527;15502;34;0;0;0;0;.00nan;0;0
528;51;21;0;0;0;0;.00nan;0;0
528;1796;16;0;0;0;0;.00nan;0;0
528;15437;16;72;23;1;22;.957;3600000;0
528;25843;21;80;34;3;31;.912;3525000;0
529;445;12;69;31;3;28;.903;3600000;0
529;15464;32;71;37;4;33;.892;3548000;0
529;16006;32;0;0;0;0;.00nan;0;0
529;34786;12;0;0;0;0;.00nan;0;0
530;262;35;78;27;2;25;.926;3093000;0
530;1430;35;37;13;3;10;.769;478000;0
530;4506;33;81;36;3;33;.917;3600000;0
530;34740;33;0;0;0;0;.00nan;0;0
531;544;19;54;5;0;5;1.000;429000;0
531;823;23;0;0;0;0;.00nan;0;0
531;10274;23;79;35;2;33;.943;3600000;0
531;31124;19;19;29;7;22;.759;3171000;0
532;724;11;60;20;2;18;.900;3600000;0
532;21522;11;0;0;0;0;.00nan;0;0
532;22601;26;0;0;0;0;.00nan;0;0
532;32754;26;77;44;4;40;.909;3535000;0
533;335;18;0;0;0;0;.00nan;0;0
533;1572;4838;0;0;0;0;.00nan;0;0
533;2328;4838;88;46;3;43;.935;3900000;0
533;5001;18;63;25;3;22;.880;3900000;0
534;500;4182;60;42;5;37;.881;3600000;0
534;1614;25;77;22;2;20;.909;3600000;0
534;5182;25;0;0;0;0;.00nan;0;0
534;25521;4182;0;0;0;0;.00nan;0;0
535;738;27;0;0;0;0;.00nan;0;0
535;1913;30;87;38;3;35;.921;3600000;0
535;4826;30;0;0;0;0;.00nan;0;0
535;26623;27;90;33;1;32;.970;3600000;0
536;233;29;0;0;0;0;.00nan;0;0
536;1074;0;0;0;0;0;.00nan;0;0
536;18351;29;74;19;1;18;.947;3600000;0
536;31035;0;83;46;4;42;.913;3600000;0
537;13842;34;0;0;0;0;.00nan;0;0
537;15502;34;100;34;1;33;.971;3600000;0
537;15505;8;78;30;2;28;.933;3600000;0
537;25076;8;0;0;0;0;.00nan;0;0
538;500;4182;0;0;0;0;.00nan;0;0
538;724;11;0;0;0;0;.00nan;0;0
538;21522;11;59;34;5;29;.853;3600000;0
538;25521;4182;95;32;1;31;.969;3600000;0
539;738;27;53;16;2;14;.875;3600000;0
539;22601;26;79;46;4;42;.913;3600000;0
539;26623;27;0;0;0;0;.00nan;0;0
539;32754;26;0;0;0;0;.00nan;0;0
540;51;21;0;0;0;0;.00nan;0;0
540;5385;17;0;0;0;0;.00nan;0;0
540;25843;21;78;30;2;28;.933;3896000;0
540;34006;17;94;33;2;31;.939;3900000;0
541;1821;3;0;0;0;0;.00nan;0;0
541;2054;3;69;27;3;24;.889;3719000;0
541;2423;15;90;42;2;40;.952;3719000;0
541;4106;15;0;0;0;0;.00nan;0;0
542;2058;28;0;0;0;0;.00nan;0;0
542;4450;5;97;37;1;36;.973;3567000;0
542;14061;28;100;38;0;38;1.000;3600000;0
542;19823;5;0;0;0;0;.00nan;0;0
543;61;31;43;32;5;27;.844;3600000;0
543;18104;10;0;0;0;0;.00nan;0;0
543;27488;10;94;41;2;39;.951;3600000;0
543;34797;31;0;0;0;0;.00nan;0;0
544;376;9;91;33;2;31;.939;3600000;0
544;928;20;0;0;0;0;.00nan;0;0
544;18078;20;72;31;3;28;.903;3572000;0
544;20853;9;0;0;0;0;.00nan;0;0
545;15464;32;0;0;0;0;.00nan;0;0
545;16006;32;77;21;1;20;.952;3600000;0
545;27739;22;0;0;0;0;.00nan;0;0
545;28026;22;76;39;4;35;.897;3600000;0
546;823;23;0;0;0;0;.00nan;0;0
546;1796;16;0;0;0;0;.00nan;0;0
546;10274;23;89;53;2;51;.962;3584000;0
546;15437;16;99;29;1;28;.966;3600000;0
547;4506;33;43;21;4;17;.810;3600000;0
547;15505;8;0;0;0;0;.00nan;0;0
547;25076;8;60;45;5;40;.889;3556000;0
547;34740;33;0;0;0;0;.00nan;0;0
548;445;12;57;23;3;20;.870;3600000;0
548;1614;25;65;38;4;34;.895;3556000;0
548;5182;25;0;0;0;0;.00nan;0;0
548;34786;12;0;0;0;0;.00nan;0;0
549;335;18;0;0;0;0;.00nan;0;0
549;1913;30;87;50;4;46;.920;3567000;0
549;4826;30;0;0;0;0;.00nan;0;0
549;5001;18;69;31;2;29;.935;3600000;0
550;1251;14;0;0;0;0;.00nan;0;0
550;1572;4838;81;29;2;27;.931;3600000;0
550;2328;4838;0;0;0;0;.00nan;0;0
550;25584;14;64;31;3;28;.903;3544000;0
551;61;31;81;29;2;27;.931;3900000;0
551;233;29;0;0;0;0;.00nan;0;0
551;18351;29;88;35;2;33;.943;3900000;0
551;34797;31;0;0;0;0;.00nan;0;0
552;928;20;72;19;1;18;.947;3600000;0
552;5385;17;0;0;0;0;.00nan;0;0
552;18078;20;0;0;0;0;.00nan;0;0
552;34006;17;86;37;2;35;.946;3568000;0
553;1074;0;96;26;0;26;1.000;3600000;0
553;10103;24;0;0;0;0;.00nan;0;0
553;13979;24;94;26;1;25;.962;3592000;0
553;31035;0;0;0;0;0;.00nan;0;0
554;13842;34;0;0;0;0;.00nan;0;0
554;15464;32;94;40;3;37;.925;3600000;0
554;15502;34;68;35;4;31;.886;3600000;0
554;16006;32;0;0;0;0;.00nan;0;0
555;335;18;0;0;0;0;.00nan;0;0
555;724;11;0;0;0;0;.00nan;0;0
555;5001;18;95;38;1;37;.974;3600000;0
555;21522;11;60;27;3;24;.889;3513000;0
556;738;27;0;0;0;0;.00nan;0;0
556;1251;14;100;33;0;33;1.000;3600000;0
556;25584;14;0;0;0;0;.00nan;0;0
556;26623;27;58;27;3;24;.889;3600000;0
557;544;19;0;0;0;0;.00nan;0;0
557;1572;4838;0;0;0;0;.00nan;0;0
557;2328;4838;62;32;4;28;.875;3600000;0
557;31124;19;100;25;0;25;1.000;3600000;0
558;2058;28;0;0;0;0;.00nan;0;0
558;2423;15;86;25;1;24;.960;3600000;0
558;4106;15;0;0;0;0;.00nan;0;0
558;14061;28;87;50;4;46;.920;3600000;0
559;376;9;0;0;0;0;.00nan;0;0
559;20853;9;87;33;2;31;.939;3600000;0
559;27739;22;0;0;0;0;.00nan;0;0
559;28026;22;59;32;4;28;.875;3581000;0
560;233;29;78;21;1;20;.952;3900000;0
560;18104;10;0;0;0;0;.00nan;0;0
560;18351;29;0;0;0;0;.00nan;0;0
560;27488;10;76;27;1;26;.963;3900000;0
561;823;23;0;0;0;0;.00nan;0;0
561;5298;21;0;0;0;0;.00nan;0;0
561;10274;23;87;40;3;37;.925;3600000;0
561;25843;21;41;31;5;26;.839;3565000;0
562;445;12;0;0;0;0;.00nan;0;0
562;1614;25;80;32;3;29;.906;3600000;0
562;5182;25;0;0;0;0;.00nan;0;0
562;34786;12;63;35;5;30;.857;3600000;0
563;544;19;0;0;0;0;.00nan;0;0
563;4506;33;64;22;2;20;.909;3600000;0
563;31124;19;75;40;3;37;.925;3557000;0
563;34740;33;0;0;0;0;.00nan;0;0
564;500;4182;70;27;2;25;.926;3600000;0
564;1913;30;97;56;3;53;.946;3600000;0
564;4826;30;0;0;0;0;.00nan;0;0
564;25521;4182;0;0;0;0;.00nan;0;0
565;4450;5;0;0;0;0;.00nan;0;0
565;5385;17;0;0;0;0;.00nan;0;0
565;19823;5;90;20;0;20;1.000;3600000;0
565;34006;17;98;44;3;41;.932;3600000;0
566;1821;3;67;26;2;24;.923;3600000;0
566;2054;3;0;0;0;0;.00nan;0;0
566;2058;28;55;33;4;29;.879;3600000;0
566;14061;28;0;0;0;0;.00nan;0;0
567;61;31;93;24;0;24;1.000;3900000;0
567;1074;0;100;38;0;38;1.000;3900000;0
567;31035;0;0;0;0;0;.00nan;0;0
567;34797;31;0;0;0;0;.00nan;0;0
568;823;23;0;0;0;0;.00nan;0;0
568;928;20;0;0;0;0;.00nan;0;0
568;10274;23;54;34;4;30;.882;3555000;0
568;18078;20;58;28;3;25;.893;3600000;0
569;10103;24;85;46;4;42;.913;3600000;0
569;13842;34;0;0;0;0;.00nan;0;0
569;13979;24;0;0;0;0;.00nan;0;0
569;15502;34;73;33;3;30;.909;3600000;0
570;15464;32;74;24;1;23;.958;3600000;0
570;15505;8;80;29;2;27;.931;3558000;0
570;16006;32;0;0;0;0;.00nan;0;0
570;25076;8;0;0;0;0;.00nan;0;0
571;262;35;45;5;1;4;.800;1259000;0
571;1430;35;16;28;7;21;.750;2341000;0
571;1796;16;0;0;0;0;.00nan;0;0
571;15437;16;86;32;1;31;.969;3600000;0
572;724;11;0;0;0;0;.00nan;0;0
572;1251;14;55;32;4;28;.875;3549000;0
572;21522;11;71;26;2;24;.923;3600000;0
572;25584;14;0;0;0;0;.00nan;0;0
573;335;18;0;0;0;0;.00nan;0;0
573;1572;4838;0;0;0;0;.00nan;0;0
573;2328;4838;64;34;3;31;.912;3543000;0
573;5001;18;91;25;1;24;.960;3600000;0
574;376;9;35;21;4;17;.810;1121000;0
574;4450;5;0;0;0;0;.00nan;0;0
574;19823;5;81;13;0;13;1.000;3600000;0
574;20853;9;57;26;3;23;.885;2479000;0
575;233;29;0;0;0;0;.00nan;0;0
575;18104;10;0;0;0;0;.00nan;0;0
575;18351;29;100;32;0;32;1.000;3600000;0
575;27488;10;74;32;3;29;.906;3600000;0
576;738;27;0;0;0;0;.00nan;0;0
576;2423;15;91;37;2;35;.946;3600000;0
576;4106;15;0;0;0;0;.00nan;0;0
576;26623;27;78;38;3;35;.921;3555000;0
577;5298;21;88;29;1;28;.966;3600000;0
577;25843;21;0;0;0;0;.00nan;0;0
577;27739;22;0;0;0;0;.00nan;0;0
577;28026;22;92;40;3;37;.925;3600000;0
578;544;19;0;0;0;0;.00nan;0;0
578;15505;8;0;0;0;0;.00nan;0;0
578;25076;8;92;41;2;39;.951;3600000;0
578;31124;19;69;29;3;26;.897;3546000;0
579;1614;25;75;23;2;21;.913;3600000;0
579;1913;30;65;39;4;35;.897;3558000;0
579;4826;30;0;0;0;0;.00nan;0;0
579;5182;25;0;0;0;0;.00nan;0;0
580;445;12;69;23;2;21;.913;3600000;0
580;22601;26;0;0;0;0;.00nan;0;0
580;32754;26;84;45;3;42;.933;3576000;0
580;34786;12;0;0;0;0;.00nan;0;0
581;500;4182;72;35;3;32;.914;3900000;0
581;4506;33;79;32;3;29;.906;3900000;0
581;25521;4182;0;0;0;0;.00nan;0;0
581;34740;33;0;0;0;0;.00nan;0;0
582;1821;3;56;19;2;17;.895;3600000;0
582;2054;3;0;0;0;0;.00nan;0;0
582;10103;24;0;0;0;0;.00nan;0;0
582;13979;24;79;41;4;37;.902;3565000;0
583;262;35;0;0;0;0;.00nan;0;0
583;1430;35;67;28;3;25;.893;3546000;0
583;2058;28;89;31;2;29;.935;3600000;0
583;14061;28;0;0;0;0;.00nan;0;0
584;823;23;0;0;0;0;.00nan;0;0
584;10274;23;91;36;1;35;.972;3600000;0
584;18104;10;60;29;3;26;.897;3594000;0
584;27488;10;0;0;0;0;.00nan;0;0
585;4450;5;0;0;0;0;.00nan;0;0
585;5298;21;43;30;4;26;.867;3900000;0
585;19823;5;73;36;4;32;.889;3900000;0
585;25843;21;0;0;0;0;.00nan;0;0
586;1074;0;75;38;3;35;.921;3564000;0
586;27739;22;91;40;3;37;.925;3600000;0
586;28026;22;0;0;0;0;.00nan;0;0
586;31035;0;0;0;0;0;.00nan;0;0
587;376;9;0;0;0;0;.00nan;0;0
587;738;27;0;0;0;0;.00nan;0;0
587;20853;9;69;36;3;33;.917;3600000;0
587;26623;27;100;29;0;29;1.000;3600000;0
588;61;31;100;25;0;25;1.000;3600000;0
588;544;19;82;34;3;31;.912;3600000;0
588;31124;19;0;0;0;0;.00nan;0;0
588;34797;31;0;0;0;0;.00nan;0;0
589;233;29;0;0;0;0;.00nan;0;0
589;13842;34;0;0;0;0;.00nan;0;0
589;15502;34;35;36;6;30;.833;3600000;0
589;18351;29;72;30;2;28;.933;3600000;0
590;1614;25;86;25;1;24;.960;3600000;0
590;5182;25;0;0;0;0;.00nan;0;0
590;15505;8;0;0;0;0;.00nan;0;0
590;25076;8;60;32;4;28;.875;3600000;0
591;4506;33;88;28;1;27;.964;3600000;0
591;22601;26;0;0;0;0;.00nan;0;0
591;32754;26;79;41;4;37;.902;3600000;0
591;34740;33;0;0;0;0;.00nan;0;0
592;500;4182;38;17;4;13;.765;3569000;0
592;15464;32;95;54;3;51;.944;3600000;0
592;16006;32;0;0;0;0;.00nan;0;0
592;25521;4182;0;0;0;0;.00nan;0;0
593;1251;14;85;21;1;20;.952;3600000;0
593;1913;30;68;30;3;27;.900;3600000;0
593;4826;30;0;0;0;0;.00nan;0;0
593;25584;14;0;0;0;0;.00nan;0;0
594;928;20;91;39;2;37;.949;3548000;0
594;1572;4838;0;0;0;0;.00nan;0;0
594;2328;4838;74;22;1;21;.955;3600000;0
594;18078;20;0;0;0;0;.00nan;0;0
595;823;23;0;0;0;0;.00nan;0;0
595;1821;3;0;0;0;0;.00nan;0;0
595;2054;3;61;22;2;20;.909;3600000;0
595;10274;23;87;49;3;46;.939;3600000;0
596;1796;16;0;0;0;0;.00nan;0;0
596;2423;15;89;44;3;41;.932;3597000;0
596;4106;15;0;0;0;0;.00nan;0;0
596;15437;16;79;29;2;27;.931;3600000;0
597;335;18;0;0;0;0;.00nan;0;0
597;928;20;0;0;0;0;.00nan;0;0
597;5001;18;60;24;3;21;.875;3600000;0
597;18078;20;73;38;4;34;.895;3567000;0
598;262;35;50;28;4;24;.857;2162000;0
598;1430;35;57;19;3;16;.842;1438000;0
598;4450;5;0;0;0;0;.00nan;0;0
598;19823;5;90;19;0;19;1.000;3600000;0
599;738;27;0;0;0;0;.00nan;0;0
599;5385;17;59;38;5;33;.868;3600000;0
599;26623;27;84;24;1;23;.958;3600000;0
599;34006;17;0;0;0;0;.00nan;0;0
600;1074;0;74;41;4;37;.902;3600000;0
600;1821;3;67;29;3;26;.897;3600000;0
600;2054;3;0;0;0;0;.00nan;0;0
600;31035;0;0;0;0;0;.00nan;0;0
601;233;29;0;0;0;0;.00nan;0;0
601;544;19;0;0;0;0;.00nan;0;0
601;18351;29;86;35;2;33;.943;3600000;0
601;31124;19;65;29;3;26;.897;3548000;0
602;5298;21;0;0;0;0;.00nan;0;0
602;13842;34;0;0;0;0;.00nan;0;0
602;15502;34;68;31;3;28;.903;3600000;0
602;25843;21;55;34;5;29;.853;3559000;0
603;1251;14;81;33;3;30;.909;3900000;0
603;2423;15;67;29;3;26;.897;3900000;0
603;4106;15;0;0;0;0;.00nan;0;0
603;25584;14;0;0;0;0;.00nan;0;0
604;61;31;83;36;3;33;.917;3600000;0
604;445;12;31;29;6;23;.793;3600000;0
604;34786;12;0;0;0;0;.00nan;0;0
604;34797;31;0;0;0;0;.00nan;0;0
605;1614;25;79;29;1;28;.966;3715000;0
605;4506;33;94;44;2;42;.955;3715000;0
605;5182;25;0;0;0;0;.00nan;0;0
605;34740;33;0;0;0;0;.00nan;0;0
606;15505;8;0;0;0;0;.00nan;0;0
606;22601;26;0;0;0;0;.00nan;0;0
606;25076;8;93;40;2;38;.950;3900000;0
606;32754;26;66;28;2;26;.929;3900000;0
607;500;4182;69;20;1;19;.950;3600000;0
607;18104;10;0;0;0;0;.00nan;0;0
607;25521;4182;0;0;0;0;.00nan;0;0
607;27488;10;92;34;2;32;.941;3569000;0
608;376;9;49;22;4;18;.818;3549000;0
608;1913;30;0;0;0;0;.00nan;0;0
608;4826;30;74;28;2;26;.929;3600000;0
608;20853;9;0;0;0;0;.00nan;0;0
609;724;11;0;0;0;0;.00nan;0;0
609;15464;32;89;41;3;38;.927;3900000;0
609;16006;32;0;0;0;0;.00nan;0;0
609;21522;11;68;28;3;25;.893;3900000;0
610;1572;4838;0;0;0;0;.00nan;0;0
610;2058;28;80;23;2;21;.913;3600000;0
610;2328;4838;44;35;6;29;.829;3600000;0
610;14061;28;0;0;0;0;.00nan;0;0
611;544;19;97;40;2;38;.950;3585000;0
611;10103;24;0;0;0;0;.00nan;0;0
611;13979;24;84;28;1;27;.964;3600000;0
611;31124;19;0;0;0;0;.00nan;0;0
612;1796;16;0;0;0;0;.00nan;0;0
612;15437;16;66;22;2;20;.909;3600000;0
612;27739;22;0;0;0;0;.00nan;0;0
612;28026;22;70;41;4;37;.902;3544000;0
613;1074;0;76;36;3;33;.917;3557000;0
613;5385;17;0;0;0;0;.00nan;0;0
613;31035;0;0;0;0;0;.00nan;0;0
613;34006;17;82;26;2;24;.923;3600000;0
614;233;29;0;0;0;0;.00nan;0;0
614;4450;5;0;0;0;0;.00nan;0;0
614;18351;29;89;40;2;38;.950;3817000;0
614;19823;5;83;27;1;26;.963;3817000;0
615;738;27;0;0;0;0;.00nan;0;0
615;1251;14;0;0;0;0;.00nan;0;0
615;25584;14;81;38;3;35;.921;3900000;0
615;26623;27;62;29;3;26;.897;3900000;0
616;61;31;58;42;7;35;.833;3176000;0
616;10103;24;52;21;3;18;.857;3600000;0
616;13979;24;0;0;0;0;.00nan;0;0
616;34797;31;53;2;0;2;1.000;424000;0
617;5298;21;0;0;0;0;.00nan;0;0
617;13842;34;82;30;1;29;.967;2510000;0
617;15502;34;1;11;6;5;.455;1090000;0
617;25843;21;60;23;2;21;.913;3600000;0
618;445;12;0;0;0;0;.00nan;0;0
618;2423;15;57;28;3;25;.893;3565000;0
618;4106;15;0;0;0;0;.00nan;0;0
618;34786;12;89;36;2;34;.944;3600000;0
619;262;35;0;0;0;0;.00nan;0;0
619;1430;35;73;29;2;27;.931;3600000;0
619;27739;22;36;34;6;28;.824;3600000;0
619;28026;22;0;0;0;0;.00nan;0;0
620;1572;4838;67;33;3;30;.909;3600000;0
620;2328;4838;0;0;0;0;.00nan;0;0
620;4506;33;97;28;0;28;1.000;3600000;0
620;34740;33;0;0;0;0;.00nan;0;0
621;1614;25;0;0;0;0;.00nan;0;0
621;1821;3;57;21;3;18;.857;3578000;0
621;2054;3;0;0;0;0;.00nan;0;0
621;5182;25;84;34;1;33;.971;3600000;0
622;823;23;0;0;0;0;.00nan;0;0
622;928;20;73;37;4;33;.892;3600000;0
622;10274;23;93;35;1;34;.971;3600000;0
622;18078;20;0;0;0;0;.00nan;0;0
623;15464;32;80;34;2;32;.941;3575000;0
623;16006;32;0;0;0;0;.00nan;0;0
623;22601;26;0;0;0;0;.00nan;0;0
623;32754;26;88;23;1;22;.957;3600000;0
624;335;18;0;0;0;0;.00nan;0;0
624;2058;28;88;30;1;29;.967;3600000;0
624;5001;18;100;32;0;32;1.000;3600000;0
624;14061;28;0;0;0;0;.00nan;0;0
625;500;4182;81;28;1;27;.964;3600000;0
625;15505;8;73;32;3;29;.906;3547000;0
625;25076;8;0;0;0;0;.00nan;0;0
625;25521;4182;0;0;0;0;.00nan;0;0
626;1913;30;44;44;8;36;.818;3600000;0
626;4826;30;0;0;0;0;.00nan;0;0
626;18104;10;0;0;0;0;.00nan;0;0
626;27488;10;93;43;3;40;.930;3600000;0
627;376;9;0;0;0;0;.00nan;0;0
627;724;11;0;0;0;0;.00nan;0;0
627;20853;9;65;34;3;31;.912;3600000;0
627;21522;11;68;24;2;22;.917;3600000;0
628;445;12;64;36;5;31;.861;3658000;0
628;1796;16;0;0;0;0;.00nan;0;0
628;15437;16;37;21;4;17;.810;3658000;0
628;34786;12;0;0;0;0;.00nan;0;0
629;1074;0;94;35;1;34;.971;3600000;0
629;13842;34;0;0;0;0;.00nan;0;0
629;15502;34;62;31;4;27;.871;3600000;0
629;31035;0;0;0;0;0;.00nan;0;0
630;233;29;0;0;0;0;.00nan;0;0
630;5298;21;64;15;1;14;.933;1507000;0
630;18351;29;67;34;4;30;.882;3600000;0
630;25843;21;19;23;6;17;.739;2093000;0
631;4450;5;0;0;0;0;.00nan;0;0
631;19823;5;65;34;4;30;.882;3600000;0
631;27739;22;0;0;0;0;.00nan;0;0
631;28026;22;55;25;3;22;.880;3600000;0
632;262;35;46;32;5;27;.844;3600000;0
632;1430;35;0;0;0;0;.00nan;0;0
632;4506;33;46;26;4;22;.846;3600000;0
632;34740;33;0;0;0;0;.00nan;0;0
633;1572;4838;0;0;0;0;.00nan;0;0
633;1614;25;79;25;1;24;.960;3600000;0
633;2328;4838;75;33;3;30;.909;3563000;0
633;5182;25;0;0;0;0;.00nan;0;0
634;823;23;0;0;0;0;.00nan;0;0
634;2058;28;0;0;0;0;.00nan;0;0
634;10274;23;87;24;1;23;.958;3600000;0
634;14061;28;79;29;2;27;.931;3600000;0
635;724;11;0;0;0;0;.00nan;0;0
635;18104;10;0;0;0;0;.00nan;0;0
635;21522;11;99;41;1;40;.976;3600000;0
635;27488;10;65;42;5;37;.881;3600000;0
636;233;29;0;0;0;0;.00nan;0;0
636;5385;17;0;0;0;0;.00nan;0;0
636;18351;29;71;25;1;24;.960;3600000;0
636;34006;17;49;32;5;27;.844;3600000;0
637;61;31;74;27;2;25;.926;2518000;0
637;335;18;0;0;0;0;.00nan;0;0
637;5001;18;65;33;4;29;.879;3600000;0
637;34797;31;21;17;5;12;.706;1082000;0
638;1251;14;0;0;0;0;.00nan;0;0
638;10103;24;0;0;0;0;.00nan;0;0
638;13979;24;70;39;4;35;.897;3576000;0
638;25584;14;74;27;3;24;.889;3600000;0
639;13842;34;75;42;4;38;.905;3600000;0
639;15502;34;0;0;0;0;.00nan;0;0
639;15505;8;0;0;0;0;.00nan;0;0
639;25076;8;70;26;2;24;.923;3600000;0
640;1614;25;0;0;0;0;.00nan;0;0
640;5182;25;85;38;3;35;.921;3600000;0
640;15464;32;63;8;0;8;1.000;771000;0
640;16006;32;29;29;6;23;.793;2829000;0
641;544;19;0;0;0;0;.00nan;0;0
641;928;20;59;36;4;32;.889;3582000;0
641;18078;20;0;0;0;0;.00nan;0;0
641;31124;19;62;21;2;19;.905;3600000;0
642;500;4182;63;35;4;31;.886;3600000;0
642;1821;3;99;40;1;39;.975;3600000;0
642;2054;3;0;0;0;0;.00nan;0;0
642;25521;4182;0;0;0;0;.00nan;0;0
643;1913;30;59;27;3;24;.889;3582000;0
643;2423;15;60;24;2;22;.917;3600000;0
643;4106;15;0;0;0;0;.00nan;0;0
643;4826;30;0;0;0;0;.00nan;0;0
644;376;9;0;0;0;0;.00nan;0;0
644;738;27;0;0;0;0;.00nan;0;0
644;20853;9;70;46;4;42;.913;3524000;0
644;26623;27;74;26;2;24;.923;3600000;0
645;1074;0;0;0;0;0;.00nan;0;0
645;4450;5;53;30;4;26;.867;3600000;0
645;19823;5;0;0;0;0;.00nan;0;0
645;31035;0;99;37;1;36;.973;3600000;0
646;445;12;82;39;3;36;.923;3577000;0
646;1572;4838;64;23;2;21;.913;3600000;0
646;2328;4838;0;0;0;0;.00nan;0;0
646;34786;12;0;0;0;0;.00nan;0;0
647;262;35;44;33;6;27;.818;2907000;0
647;823;23;53;2;0;2;1.000;496000;0
647;1430;35;45;12;2;10;.833;662000;0
647;10274;23;48;46;7;39;.848;3104000;0
648;1821;3;0;0;0;0;.00nan;0;0
648;2054;3;88;33;2;31;.939;3900000;0
648;22601;26;0;0;0;0;.00nan;0;0
648;32754;26;97;39;2;37;.949;3900000;0
649;1251;14;81;24;1;23;.958;3600000;0
649;4450;5;0;0;0;0;.00nan;0;0
649;19823;5;48;21;3;18;.857;3516000;0
649;25584;14;0;0;0;0;.00nan;0;0
650;376;9;0;0;0;0;.00nan;0;0
650;4506;33;71;20;1;19;.950;3600000;0
650;20853;9;66;43;5;38;.884;3600000;0
650;34740;33;0;0;0;0;.00nan;0;0
651;233;29;0;0;0;0;.00nan;0;0
651;335;18;0;0;0;0;.00nan;0;0
651;5001;18;61;31;4;27;.871;3545000;0
651;18351;29;91;49;3;46;.939;3600000;0
652;51;21;0;0;0;0;.00nan;0;0
652;928;20;62;29;3;26;.897;3595000;0
652;18078;20;0;0;0;0;.00nan;0;0
652;25843;21;76;27;1;26;.963;3600000;0
653;10103;24;0;0;0;0;.00nan;0;0
653;13842;34;0;0;0;0;.00nan;0;0
653;13979;24;91;30;1;29;.967;3600000;0
653;15502;34;56;33;4;29;.879;3600000;0
654;1074;0;61;36;5;31;.861;3727000;0
654;15505;8;49;31;4;27;.871;3727000;0
654;25076;8;0;0;0;0;.00nan;0;0
654;31035;0;0;0;0;0;.00nan;0;0
655;1572;4838;53;3;0;3;1.000;464000;0
655;1796;16;0;0;0;0;.00nan;0;0
655;2328;4838;47;38;6;32;.842;3136000;0
655;15437;16;78;20;1;19;.950;3600000;0
656;5385;17;0;0;0;0;.00nan;0;0
656;15464;32;51;21;3;18;.857;3600000;0
656;16006;32;0;0;0;0;.00nan;0;0
656;34006;17;62;34;4;30;.882;3571000;0
657;544;19;0;0;0;0;.00nan;0;0
657;2058;28;0;0;0;0;.00nan;0;0
657;14061;28;64;22;2;20;.909;3600000;0
657;31124;19;78;35;3;32;.914;3600000;0
658;724;11;0;0;0;0;.00nan;0;0
658;2423;15;72;24;2;22;.917;3900000;0
658;4106;15;0;0;0;0;.00nan;0;0
658;21522;11;97;42;2;40;.952;3900000;0
659;738;27;64;34;4;30;.882;3600000;0
659;18104;10;0;0;0;0;.00nan;0;0
659;26623;27;0;0;0;0;.00nan;0;0
659;27488;10;64;15;1;14;.933;3600000;0
660;61;31;68;30;3;27;.900;3600000;0
660;445;12;44;34;6;28;.824;3600000;0
660;34786;12;0;0;0;0;.00nan;0;0
660;34797;31;0;0;0;0;.00nan;0;0
661;262;35;0;0;0;0;.00nan;0;0
661;1430;35;60;20;2;18;.900;3600000;0
661;1913;30;55;35;5;30;.857;3600000;0
661;4826;30;0;0;0;0;.00nan;0;0
662;1614;25;83;33;3;30;.909;3600000;0
662;5182;25;0;0;0;0;.00nan;0;0
662;22601;26;73;46;5;41;.891;3578000;0
662;32754;26;0;0;0;0;.00nan;0;0
663;500;4182;92;49;4;45;.918;3600000;0
663;823;23;0;0;0;0;.00nan;0;0
663;10274;23;86;31;2;29;.935;3600000;0
663;25521;4182;0;0;0;0;.00nan;0;0
664;4450;5;0;0;0;0;.00nan;0;0
664;15464;32;27;37;7;30;.811;3346000;0
664;16006;32;54;2;0;2;1.000;254000;0
664;19823;5;86;30;2;28;.933;3600000;0
665;51;21;70;24;1;23;.958;3550000;0
665;1074;0;100;28;0;28;1.000;3600000;0
665;25843;21;0;0;0;0;.00nan;0;0
665;31035;0;0;0;0;0;.00nan;0;0
666;376;9;0;0;0;0;.00nan;0;0
666;5385;17;0;0;0;0;.00nan;0;0
666;20853;9;72;31;2;29;.935;3543000;0
666;34006;17;93;35;1;34;.971;3600000;0
667;233;29;0;0;0;0;.00nan;0;0
667;445;12;0;0;0;0;.00nan;0;0
667;18351;29;81;34;2;32;.941;3600000;0
667;34786;12;83;28;1;27;.964;3600000;0
668;61;31;44;32;5;27;.844;3554000;0
668;13842;34;0;0;0;0;.00nan;0;0
668;15502;34;88;42;3;39;.929;3600000;0
668;34797;31;0;0;0;0;.00nan;0;0
669;928;20;66;31;3;28;.903;3804000;0
669;18078;20;0;0;0;0;.00nan;0;0
669;27739;22;0;0;0;0;.00nan;0;0
669;28026;22;66;33;4;29;.879;3804000;0
670;1251;14;0;0;0;0;.00nan;0;0
670;18104;10;0;0;0;0;.00nan;0;0
670;25584;14;74;48;5;43;.896;3576000;0
670;27488;10;83;34;3;31;.912;3600000;0
671;335;18;0;0;0;0;.00nan;0;0
671;5001;18;100;41;1;40;.976;3600000;0
671;10103;24;0;0;0;0;.00nan;0;0
671;13979;24;67;45;6;39;.867;3600000;0
672;1913;30;0;0;0;0;.00nan;0;0
672;4826;30;68;46;5;41;.891;3900000;0
672;15505;8;0;0;0;0;.00nan;0;0
672;25076;8;70;41;5;36;.878;3900000;0
673;1796;16;0;0;0;0;.00nan;0;0
673;1821;3;100;38;1;37;.974;3600000;0
673;2054;3;0;0;0;0;.00nan;0;0
673;15437;16;78;37;3;34;.919;3563000;0
674;2058;28;0;0;0;0;.00nan;0;0
674;4506;33;75;35;2;33;.943;3555000;0
674;14061;28;72;19;1;18;.947;3600000;0
674;34740;33;0;0;0;0;.00nan;0;0
675;500;4182;0;0;0;0;.00nan;0;0
675;544;19;0;0;0;0;.00nan;0;0
675;25521;4182;85;45;3;42;.933;3591000;0
675;31124;19;70;25;2;23;.920;3600000;0
676;1614;25;0;0;0;0;.00nan;0;0
676;5182;25;88;29;1;28;.966;3600000;0
676;22601;26;0;0;0;0;.00nan;0;0
676;32754;26;87;45;4;41;.911;3600000;0
677;738;27;0;0;0;0;.00nan;0;0
677;2423;15;60;27;4;23;.852;3900000;0
677;4106;15;0;0;0;0;.00nan;0;0
677;26623;27;68;34;4;30;.882;3900000;0
678;724;11;0;0;0;0;.00nan;0;0
678;1572;4838;0;0;0;0;.00nan;0;0
678;2328;4838;51;34;5;29;.853;3600000;0
678;21522;11;99;42;1;41;.976;3600000;0
679;335;18;0;0;0;0;.00nan;0;0
679;5001;18;80;20;1;19;.950;3900000;0
679;27739;22;78;24;1;23;.958;3900000;0
679;28026;22;0;0;0;0;.00nan;0;0
680;823;23;0;0;0;0;.00nan;0;0
680;4506;33;0;0;0;0;.00nan;0;0
680;10274;23;86;38;2;36;.947;3602000;0
680;34740;33;73;28;3;25;.893;3631000;0
681;376;9;0;0;0;0;.00nan;0;0
681;5385;17;0;0;0;0;.00nan;0;0
681;20853;9;70;38;3;35;.921;3570000;0
681;34006;17;75;23;2;21;.913;3600000;0
682;51;21;19;8;4;4;.500;983000;0
682;1821;3;65;17;1;16;.941;3600000;0
682;2054;3;0;0;0;0;.00nan;0;0
682;25843;21;58;22;2;20;.909;2617000;0
683;928;20;50;29;4;25;.862;3600000;0
683;1251;14;0;0;0;0;.00nan;0;0
683;18078;20;0;0;0;0;.00nan;0;0
683;25584;14;79;30;2;28;.933;3600000;0
684;1796;16;0;0;0;0;.00nan;0;0
684;15437;16;100;49;3;46;.939;3600000;0
684;15464;32;46;26;4;22;.846;3584000;0
684;16006;32;0;0;0;0;.00nan;0;0
685;262;35;0;0;0;0;.00nan;0;0
685;1430;35;49;27;4;23;.852;3600000;0
685;1614;25;100;26;0;26;1.000;3600000;0
685;5182;25;0;0;0;0;.00nan;0;0
686;1074;0;100;49;2;47;.959;3900000;0
686;22601;26;0;0;0;0;.00nan;0;0
686;31035;0;0;0;0;0;.00nan;0;0
686;32754;26;87;34;2;32;.941;3900000;0
687;500;4182;96;21;0;21;1.000;3600000;0
687;2423;15;78;24;1;23;.958;3564000;0
687;4106;15;0;0;0;0;.00nan;0;0
687;25521;4182;0;0;0;0;.00nan;0;0
688;724;11;0;0;0;0;.00nan;0;0
688;738;27;77;21;0;21;1.000;2418000;0
688;21522;11;100;24;0;24;1.000;3600000;0
688;26623;27;29;14;4;10;.714;1182000;0
689;1572;4838;0;0;0;0;.00nan;0;0
689;2328;4838;77;28;2;26;.929;3600000;0
689;15505;8;0;0;0;0;.00nan;0;0
689;25076;8;77;31;3;28;.903;3570000;0
690;4450;5;0;0;0;0;.00nan;0;0
690;10103;24;0;0;0;0;.00nan;0;0
690;13979;24;83;25;1;24;.960;3900000;0
690;19823;5;85;26;1;25;.962;3900000;0
691;2058;28;61;30;3;27;.900;3525000;0
691;5385;17;0;0;0;0;.00nan;0;0
691;14061;28;0;0;0;0;.00nan;0;0
691;34006;17;89;30;1;29;.967;3600000;0
692;928;20;0;0;0;0;.00nan;0;0
692;13842;34;0;0;0;0;.00nan;0;0
692;15502;34;33;24;5;19;.792;3600000;0
692;18078;20;61;28;4;24;.857;3600000;0
693;323;9;100;44;1;43;.977;3900000;0
693;1251;14;82;32;1;31;.969;3900000;0
693;20853;9;0;0;0;0;.00nan;0;0
693;25584;14;0;0;0;0;.00nan;0;0
694;376;22;73;42;4;38;.905;3600000;0
694;4506;33;97;33;1;32;.970;3600000;0
694;27739;22;0;0;0;0;.00nan;0;0
694;34740;33;0;0;0;0;.00nan;0;0
695;335;18;0;0;0;0;.00nan;0;0
695;5001;18;66;23;2;21;.913;3890000;0
695;15464;32;0;0;0;0;.00nan;0;0
695;16006;32;87;47;3;44;.936;3890000;0
696;445;12;0;0;0;0;.00nan;0;0
696;1074;0;0;0;0;0;.00nan;0;0
696;31035;0;64;39;4;35;.897;3597000;0
696;34786;12;77;33;3;30;.909;3600000;0
697;61;31;56;40;5;35;.875;3900000;0
697;544;19;0;0;0;0;.00nan;0;0
697;31124;19;44;27;5;22;.815;3900000;0
697;34797;31;0;0;0;0;.00nan;0;0
698;823;23;43;32;5;27;.844;3530000;0
698;10274;23;0;0;0;0;.00nan;0;0
698;15505;8;75;33;3;30;.909;3600000;0
698;25076;8;0;0;0;0;.00nan;0;0
699;233;29;0;0;0;0;.00nan;0;0
699;724;11;88;29;1;28;.966;3600000;0
699;18351;29;36;29;6;23;.793;3600000;0
699;21522;11;0;0;0;0;.00nan;0;0
700;51;21;58;31;4;27;.871;3600000;0
700;22601;26;8;15;6;9;.600;2790000;0
700;25843;21;0;0;0;0;.00nan;0;0
700;32754;26;41;11;2;9;.818;810000;0
701;1821;3;67;49;5;44;.898;3581000;0
701;2054;3;0;0;0;0;.00nan;0;0
701;18104;10;0;0;0;0;.00nan;0;0
701;27488;10;61;32;4;28;.875;3600000;0
702;1614;25;85;26;1;25;.962;3600000;0
702;1913;30;67;25;2;23;.920;1326000;0
702;4826;30;33;26;6;20;.769;2274000;0
702;5182;25;0;0;0;0;.00nan;0;0
703;376;22;63;10;0;10;1.000;638000;0
703;4450;5;0;0;0;0;.00nan;0;0
703;19823;5;69;43;5;38;.884;3600000;0
703;27739;22;36;32;6;26;.813;2946000;0
704;445;12;40;32;6;26;.813;3570000;0
704;5385;17;57;43;5;38;.884;3600000;0
704;34006;17;0;0;0;0;.00nan;0;0
704;34786;12;0;0;0;0;.00nan;0;0
705;1251;14;0;0;0;0;.00nan;0;0
705;13842;34;0;0;0;0;.00nan;0;0
705;15502;34;84;30;2;28;.933;3600000;0
705;25584;14;82;41;3;38;.927;3541000;0
706;2058;28;99;43;2;41;.953;3600000;0
706;2423;15;56;34;4;30;.882;3574000;0
706;4106;15;0;0;0;0;.00nan;0;0
706;14061;28;0;0;0;0;.00nan;0;0
707;4506;33;79;33;4;29;.879;3600000;0
707;15464;32;89;28;1;27;.964;3600000;0
707;16006;32;0;0;0;0;.00nan;0;0
707;34740;33;0;0;0;0;.00nan;0;0
708;61;31;69;23;2;21;.913;3600000;0
708;823;23;0;0;0;0;.00nan;0;0
708;10274;23;64;26;3;23;.885;3545000;0
708;34797;31;0;0;0;0;.00nan;0;0
709;500;4182;87;25;1;24;.960;3600000;0
709;1074;0;97;40;2;38;.950;3600000;0
709;25521;4182;0;0;0;0;.00nan;0;0
709;31035;0;0;0;0;0;.00nan;0;0
710;724;11;0;0;0;0;.00nan;0;0
710;1614;25;43;24;4;20;.833;3600000;0
710;5182;25;0;0;0;0;.00nan;0;0
710;21522;11;68;37;3;34;.919;3600000;0
711;738;27;0;0;0;0;.00nan;0;0
711;1572;4838;0;0;0;0;.00nan;0;0
711;2328;4838;100;37;0;37;1.000;3600000;0
711;26623;27;63;32;3;29;.906;3600000;0
712;445;12;0;0;0;0;.00nan;0;0
712;20853;9;0;0;0;0;.00nan;0;0
712;28026;9;54;27;4;23;.852;3600000;0
712;34786;12;94;33;1;32;.970;3600000;0
713;928;20;42;34;6;28;.824;2692000;0
713;18078;20;55;6;0;6;1.000;889000;0
713;22601;26;0;0;0;0;.00nan;0;0
713;32754;26;44;31;5;26;.839;3600000;0
714;10103;24;0;0;0;0;.00nan;0;0
714;13979;24;76;35;3;32;.914;3565000;0
714;18104;10;0;0;0;0;.00nan;0;0
714;27488;10;91;31;1;30;.968;3600000;0
715;2423;15;63;28;3;25;.893;3600000;0
715;4106;15;0;0;0;0;.00nan;0;0
715;13842;34;72;42;4;38;.905;3548000;0
715;15502;34;0;0;0;0;.00nan;0;0
716;262;35;0;0;0;0;.00nan;0;0
716;1430;35;72;32;3;29;.906;3600000;0
716;15505;8;0;0;0;0;.00nan;0;0
716;25076;8;48;39;5;34;.872;3517000;0
717;61;31;94;37;2;35;.946;3600000;0
717;335;18;0;0;0;0;.00nan;0;0
717;5001;18;53;27;4;23;.852;3520000;0
717;34797;31;0;0;0;0;.00nan;0;0
718;233;29;0;0;0;0;.00nan;0;0
718;1913;30;77;38;3;35;.921;3893000;0
718;4826;30;0;0;0;0;.00nan;0;0
718;18351;29;84;36;3;33;.917;3900000;0
719;1572;4838;57;7;0;7;1.000;813000;0
719;1796;16;0;0;0;0;.00nan;0;0
719;2328;4838;36;32;6;26;.813;2787000;0
719;15437;16;65;19;2;17;.895;3600000;0
720;4450;5;0;0;0;0;.00nan;0;0
720;4506;33;76;31;2;29;.935;3600000;0
720;19823;5;59;30;4;26;.867;3527000;0
720;34740;33;0;0;0;0;.00nan;0;0
721;1251;14;0;0;0;0;.00nan;0;0
721;5385;17;0;0;0;0;.00nan;0;0
721;25584;14;100;44;0;44;1.000;3600000;0
721;34006;17;71;31;2;29;.935;3533000;0
722;928;20;0;0;0;0;.00nan;0;0
722;1821;3;100;27;0;27;1.000;3600000;0
722;2054;3;0;0;0;0;.00nan;0;0
722;18078;20;78;34;3;31;.912;3600000;0
723;51;21;0;0;0;0;.00nan;0;0
723;10103;24;41;8;2;6;.750;389000;0
723;13979;24;45;29;5;24;.828;3211000;0
723;25843;21;50;30;4;26;.867;3600000;0
724;18104;10;83;30;2;28;.933;3600000;0
724;22601;26;0;0;0;0;.00nan;0;0
724;27488;10;0;0;0;0;.00nan;0;0
724;32754;26;66;31;3;28;.903;3574000;0
725;376;22;0;0;0;0;.00nan;0;0
725;2058;28;0;0;0;0;.00nan;0;0
725;14061;28;62;22;2;20;.909;3600000;0
725;27739;22;82;24;1;23;.958;3600000;0
726;15464;32;87;21;0;21;1.000;3600000;0
726;16006;32;0;0;0;0;.00nan;0;0
726;20853;9;51;28;5;23;.821;3600000;0
726;28026;9;0;0;0;0;.00nan;0;0
727;262;35;45;28;5;23;.821;3600000;0
727;1430;35;0;0;0;0;.00nan;0;0
727;15505;8;95;43;2;41;.953;3600000;0
727;25076;8;0;0;0;0;.00nan;0;0
728;1074;0;24;29;6;23;.793;3600000;0
728;1614;25;0;0;0;0;.00nan;0;0
728;5182;25;65;34;4;30;.882;3600000;0
728;31035;0;0;0;0;0;.00nan;0;0
729;544;19;0;0;0;0;.00nan;0;0
729;823;23;0;0;0;0;.00nan;0;0
729;10274;23;82;36;2;34;.944;3549000;0
729;31124;19;94;31;1;30;.968;3600000;0
730;233;29;0;0;0;0;.00nan;0;0
730;738;27;67;18;1;17;.944;3600000;0
730;18351;29;81;43;4;39;.907;3600000;0
730;26623;27;0;0;0;0;.00nan;0;0
731;51;21;67;25;2;23;.920;3600000;0
731;724;11;68;34;3;31;.912;3177000;0
731;21522;11;35;9;3;6;.667;423000;0
731;25843;21;0;0;0;0;.00nan;0;0
732;2423;15;63;35;5;30;.857;3600000;0
732;4106;15;0;0;0;0;.00nan;0;0
732;4506;33;93;35;2;33;.943;3600000;0
732;34740;33;0;0;0;0;.00nan;0;0
733;2058;28;39;34;6;28;.824;3600000;0
733;13842;34;0;0;0;0;.00nan;0;0
733;14061;28;0;0;0;0;.00nan;0;0
733;15502;34;97;38;1;37;.974;3600000;0
734;335;18;0;0;0;0;.00nan;0;0
734;1796;16;0;0;0;0;.00nan;0;0
734;5001;18;68;43;4;39;.907;3600000;0
734;15437;16;83;27;1;26;.963;3600000;0
735;61;31;23;33;7;26;.788;3600000;0
735;1572;4838;0;0;0;0;.00nan;0;0
735;2328;4838;74;23;1;22;.957;3600000;0
735;34797;31;0;0;0;0;.00nan;0;0
736;1913;30;85;43;3;40;.930;3598000;0
736;4450;5;0;0;0;0;.00nan;0;0
736;4826;30;0;0;0;0;.00nan;0;0
736;19823;5;82;28;1;27;.964;3600000;0
737;724;11;0;0;0;0;.00nan;0;0
737;18104;10;0;0;0;0;.00nan;0;0
737;21522;11;68;45;5;40;.889;3600000;0
737;27488;10;96;34;1;33;.971;3600000;0
738;445;12;88;33;3;30;.909;3600000;0
738;1251;14;0;0;0;0;.00nan;0;0
738;25584;14;65;27;2;25;.926;3600000;0
738;34786;12;0;0;0;0;.00nan;0;0
739;376;22;100;43;2;41;.953;3600000;0
739;500;4182;70;33;3;30;.909;3600000;0
739;25521;4182;0;0;0;0;.00nan;0;0
739;27739;22;0;0;0;0;.00nan;0;0
740;262;35;33;24;5;19;.792;3514000;0
740;1074;0;64;31;3;28;.903;3600000;0
740;1430;35;0;0;0;0;.00nan;0;0
740;31035;0;0;0;0;0;.00nan;0;0
741;1614;25;47;23;3;20;.870;3900000;0
741;5182;25;0;0;0;0;.00nan;0;0
741;15505;8;72;39;3;36;.923;3900000;0
741;25076;8;0;0;0;0;.00nan;0;0
742;544;19;0;0;0;0;.00nan;0;0
742;1796;16;0;0;0;0;.00nan;0;0
742;15437;16;61;16;2;14;.875;3600000;0
742;31124;19;100;36;0;36;1.000;3600000;0
743;2058;28;0;0;0;0;.00nan;0;0
743;5385;17;0;0;0;0;.00nan;0;0
743;14061;28;77;29;2;27;.931;3600000;0
743;34006;17;55;40;6;34;.850;3600000;0
744;51;21;0;0;0;0;.00nan;0;0
744;445;12;0;0;0;0;.00nan;0;0
744;25843;21;49;32;6;26;.813;3574000;0
744;34786;12;84;46;4;42;.913;3600000;0
745;928;20;100;34;0;34;1.000;3600000;0
745;1251;14;75;29;2;27;.931;3582000;0
745;18078;20;0;0;0;0;.00nan;0;0
745;25584;14;0;0;0;0;.00nan;0;0
746;2423;15;64;30;3;27;.900;3600000;0
746;4106;15;0;0;0;0;.00nan;0;0
746;22601;26;37;12;3;9;.750;1204000;0
746;32754;26;49;39;6;33;.846;2396000;0
747;500;4182;74;40;4;36;.900;3588000;0
747;10103;24;0;0;0;0;.00nan;0;0
747;13979;24;83;33;2;31;.939;3600000;0
747;25521;4182;0;0;0;0;.00nan;0;0
748;61;31;55;33;5;28;.848;3600000;0
748;4506;33;100;32;0;32;1.000;3600000;0
748;34740;33;0;0;0;0;.00nan;0;0
748;34797;31;0;0;0;0;.00nan;0;0
749;335;18;65;27;2;25;.926;2951000;0
749;823;23;0;0;0;0;.00nan;0;0
749;5001;18;25;7;3;4;.571;562000;0
749;10274;23;81;34;3;31;.912;3600000;0
750;1572;4838;0;0;0;0;.00nan;0;0
750;2328;4838;72;47;4;43;.915;3580000;0
750;15464;32;61;27;3;24;.889;3600000;0
750;16006;32;0;0;0;0;.00nan;0;0
751;1821;3;94;20;0;20;1.000;3600000;0
751;1913;30;65;44;6;38;.864;3600000;0
751;2054;3;0;0;0;0;.00nan;0;0
751;4826;30;0;0;0;0;.00nan;0;0
752;15505;8;0;0;0;0;.00nan;0;0
752;20853;9;0;0;0;0;.00nan;0;0
752;25076;8;64;31;4;27;.871;3600000;0
752;28026;9;51;44;6;38;.864;3558000;0
753;376;22;0;0;0;0;.00nan;0;0
753;738;27;100;41;1;40;.976;3600000;0
753;26623;27;0;0;0;0;.00nan;0;0
753;27739;22;97;42;2;40;.952;3555000;0
754;544;19;0;0;0;0;.00nan;0;0
754;13842;34;0;0;0;0;.00nan;0;0
754;15502;34;65;35;4;31;.886;3900000;0
754;31124;19;68;44;4;40;.909;3900000;0
755;1614;25;100;33;0;33;1.000;3600000;0
755;4450;5;72;31;2;29;.935;3547000;0
755;5182;25;0;0;0;0;.00nan;0;0
755;19823;5;0;0;0;0;.00nan;0;0
756;1074;0;84;23;1;22;.957;3600000;0
756;1913;30;0;0;0;0;.00nan;0;0
756;4826;30;66;25;2;23;.920;3586000;0
756;31035;0;0;0;0;0;.00nan;0;0
757;2058;28;73;23;1;22;.957;3600000;0
757;10103;24;0;0;0;0;.00nan;0;0
757;13979;24;70;29;2;27;.931;3583000;0
757;14061;28;0;0;0;0;.00nan;0;0
758;51;21;37;19;4;15;.789;959000;0
758;233;29;0;0;0;0;.00nan;0;0
758;18351;29;94;34;2;32;.941;3600000;0
758;25843;21;62;15;1;14;.933;2641000;0
759;61;31;0;0;0;0;.00nan;0;0
759;500;4182;75;31;3;28;.903;3900000;0
759;25521;4182;0;0;0;0;.00nan;0;0
759;34797;31;96;46;3;43;.935;3895000;0
760;724;11;0;0;0;0;.00nan;0;0
760;928;20;100;39;2;37;.949;3600000;0
760;18078;20;0;0;0;0;.00nan;0;0
760;21522;11;88;40;3;37;.925;3552000;0
761;1572;4838;0;0;0;0;.00nan;0;0
761;2328;4838;71;26;3;23;.885;3900000;0
761;2423;15;67;29;3;26;.897;3900000;0
761;4106;15;0;0;0;0;.00nan;0;0
762;13842;34;69;36;4;32;.889;3558000;0
762;15502;34;0;0;0;0;.00nan;0;0
762;18104;10;0;0;0;0;.00nan;0;0
762;27488;10;74;24;2;22;.917;3600000;0
763;544;19;100;34;0;34;1.000;3600000;0
763;1796;16;0;0;0;0;.00nan;0;0
763;15437;16;88;35;2;33;.943;3524000;0
763;31124;19;0;0;0;0;.00nan;0;0
764;335;18;0;0;0;0;.00nan;0;0
764;4506;33;66;28;3;25;.893;3764000;0
764;5001;18;85;47;4;43;.915;3739000;0
764;34740;33;0;0;0;0;.00nan;0;0
765;823;23;0;0;0;0;.00nan;0;0
765;10274;23;60;26;3;23;.885;3590000;0
765;15464;32;99;38;2;36;.947;3600000;0
765;16006;32;0;0;0;0;.00nan;0;0
766;262;35;0;0;0;0;.00nan;0;0
766;1430;35;86;35;2;33;.943;3549000;0
766;18104;10;100;26;0;26;1.000;3600000;0
766;27488;10;0;0;0;0;.00nan;0;0
767;2423;15;0;0;0;0;.00nan;0;0
767;4106;15;58;25;3;22;.880;3547000;0
767;20853;9;0;0;0;0;.00nan;0;0
767;28026;9;71;28;2;26;.929;3600000;0
768;1614;25;83;26;1;25;.962;3600000;0
768;5182;25;0;0;0;0;.00nan;0;0
768;15505;8;0;0;0;0;.00nan;0;0
768;25076;8;74;44;5;39;.886;3600000;0
769;376;22;0;0;0;0;.00nan;0;0
769;445;12;0;0;0;0;.00nan;0;0
769;27739;22;52;27;4;23;.852;3561000;0
769;34786;12;69;32;3;29;.906;3600000;0
770;4450;5;0;0;0;0;.00nan;0;0
770;19823;5;99;22;0;22;1.000;3600000;0
770;22601;26;0;0;0;0;.00nan;0;0
770;32754;26;90;42;3;39;.929;3600000;0
771;823;23;0;0;0;0;.00nan;0;0
771;1074;0;27;11;4;7;.636;758000;0
771;10274;23;43;23;5;18;.783;3900000;0
771;31035;0;95;37;1;36;.973;3142000;0
772;1913;30;92;33;1;32;.970;3600000;0
772;2058;28;50;28;4;24;.857;3578000;0
772;4826;30;0;0;0;0;.00nan;0;0
772;14061;28;0;0;0;0;.00nan;0;0
773;1821;3;47;29;5;24;.828;3569000;0
773;2054;3;0;0;0;0;.00nan;0;0
773;20853;9;72;42;4;38;.905;3600000;0
773;28026;9;0;0;0;0;.00nan;0;0
774;233;29;0;0;0;0;.00nan;0;0
774;500;4182;90;34;1;33;.971;3900000;0
774;18351;29;100;34;1;33;.971;3900000;0
774;25521;4182;0;0;0;0;.00nan;0;0
775;61;31;89;28;1;27;.964;3600000;0
775;738;27;0;0;0;0;.00nan;0;0
775;26623;27;66;34;3;31;.912;3552000;0
775;34797;31;0;0;0;0;.00nan;0;0
776;928;20;69;27;2;25;.926;3600000;0
776;1572;4838;0;0;0;0;.00nan;0;0
776;2328;4838;53;31;3;28;.903;3600000;0
776;18078;20;0;0;0;0;.00nan;0;0
777;724;11;0;0;0;0;.00nan;0;0
777;1251;14;0;0;0;0;.00nan;0;0
777;21522;11;70;24;2;22;.917;3900000;0
777;25584;14;80;29;2;27;.931;3900000;0
778;51;21;0;0;0;0;.00nan;0;0
778;10103;24;79;39;4;35;.897;3900000;0
778;13979;24;0;0;0;0;.00nan;0;0
778;25843;21;79;46;4;42;.913;3900000;0
779;1796;16;0;0;0;0;.00nan;0;0
779;4506;33;53;30;4;26;.867;3529000;0
779;15437;16;56;21;3;18;.857;3600000;0
779;34740;33;0;0;0;0;.00nan;0;0
780;335;18;0;0;0;0;.00nan;0;0
780;544;19;89;24;1;23;.958;3600000;0
780;5001;18;83;40;3;37;.925;3515000;0
780;31124;19;0;0;0;0;.00nan;0;0
781;5385;17;0;0;0;0;.00nan;0;0
781;22601;26;0;0;0;0;.00nan;0;0
781;32754;26;71;26;2;24;.923;3600000;0
781;34006;17;63;33;4;29;.879;3515000;0
782;1074;0;77;29;2;27;.931;3593000;0
782;13842;34;0;0;0;0;.00nan;0;0
782;15502;34;95;30;1;29;.967;3600000;0
782;31035;0;0;0;0;0;.00nan;0;0
783;262;35;74;26;2;24;.923;3608000;0
783;928;20;0;0;0;0;.00nan;0;0
783;5048;35;0;0;0;0;.00nan;0;0
783;18078;20;68;31;3;28;.903;3608000;0
784;1572;4838;87;49;5;44;.898;3530000;0
784;2328;4838;0;0;0;0;.00nan;0;0
784;18104;10;51;19;3;16;.842;3600000;0
784;27488;10;0;0;0;0;.00nan;0;0
785;724;11;67;47;4;43;.915;3600000;0
785;2423;15;75;26;2;24;.923;3600000;0
785;4106;15;0;0;0;0;.00nan;0;0
785;21522;11;0;0;0;0;.00nan;0;0
786;738;27;59;32;4;28;.875;3900000;0
786;10103;24;0;0;0;0;.00nan;0;0
786;13979;24;99;54;4;50;.926;3900000;0
786;26623;27;0;0;0;0;.00nan;0;0
787;1796;16;32;22;5;17;.773;3600000;0
787;15437;16;0;0;0;0;.00nan;0;0
787;25076;8;98;36;2;34;.944;3600000;0
787;34788;8;0;0;0;0;.00nan;0;0
788;445;12;0;0;0;0;.00nan;0;0
788;4450;5;0;0;0;0;.00nan;0;0
788;19823;5;92;46;3;43;.935;3600000;0
788;34786;12;61;33;4;29;.879;3591000;0
789;1614;25;100;23;0;23;1.000;3600000;0
789;5182;25;0;0;0;0;.00nan;0;0
789;5385;17;58;32;4;28;.875;3600000;0
789;34006;17;0;0;0;0;.00nan;0;0
790;823;23;0;0;0;0;.00nan;0;0
790;2058;28;0;0;0;0;.00nan;0;0
790;10274;23;70;37;4;33;.892;3523000;0
790;14061;28;97;38;2;36;.947;3600000;0
791;1913;30;59;41;6;35;.854;3600000;0
791;4826;30;0;0;0;0;.00nan;0;0
791;20853;9;0;0;0;0;.00nan;0;0
791;28026;9;93;31;1;30;.968;3600000;0
792;61;31;71;23;1;22;.957;3600000;0
792;13842;34;72;29;2;27;.931;3547000;0
792;15502;34;0;0;0;0;.00nan;0;0
792;34797;31;0;0;0;0;.00nan;0;0
793;335;18;0;0;0;0;.00nan;0;0
793;5001;18;77;27;2;25;.926;3600000;0
793;25076;8;0;0;0;0;.00nan;0;0
793;34788;8;70;40;5;35;.875;3600000;0
794;1572;4838;0;0;0;0;.00nan;0;0
794;2328;4838;98;41;2;39;.951;3600000;0
794;4450;5;0;0;0;0;.00nan;0;0
794;19823;5;93;28;1;27;.964;3600000;0
795;1074;0;0;0;0;0;.00nan;0;0
795;1796;16;0;0;0;0;.00nan;0;0
795;15437;16;100;25;0;25;1.000;3600000;0
795;31035;0;78;38;3;35;.921;3600000;0
796;233;29;0;0;0;0;.00nan;0;0
796;738;27;0;0;0;0;.00nan;0;0
796;18351;29;90;28;1;27;.964;3677000;0
796;26623;27;56;17;2;15;.882;3677000;0
797;51;21;0;0;0;0;.00nan;0;0
797;1821;3;87;32;2;30;.938;3600000;0
797;2054;3;0;0;0;0;.00nan;0;0
797;25843;21;95;47;3;44;.936;3567000;0
798;928;20;81;34;2;32;.941;3600000;0
798;2058;28;82;24;1;23;.958;3600000;0
798;14061;28;0;0;0;0;.00nan;0;0
798;18078;20;0;0;0;0;.00nan;0;0
799;61;31;91;20;0;20;1.000;3600000;0
799;18104;10;0;0;0;0;.00nan;0;0
799;27488;10;75;40;3;37;.925;3600000;0
799;34797;31;0;0;0;0;.00nan;0;0
800;1251;14;0;0;0;0;.00nan;0;0
800;4506;33;89;38;2;36;.947;3600000;0
800;25584;14;99;44;1;43;.977;3600000;0
800;34740;33;0;0;0;0;.00nan;0;0
801;376;22;0;0;0;0;.00nan;0;0
801;2423;15;94;31;1;30;.968;3600000;0
801;4106;15;0;0;0;0;.00nan;0;0
801;27739;22;64;35;4;31;.886;3600000;0
802;335;18;0;0;0;0;.00nan;0;0
802;5001;18;99;34;1;33;.971;3600000;0
802;15464;32;92;40;3;37;.925;3518000;0
802;16006;32;0;0;0;0;.00nan;0;0
803;445;12;89;48;4;44;.917;3555000;0
803;544;19;0;0;0;0;.00nan;0;0
803;31124;19;66;29;3;26;.897;3600000;0
803;34786;12;0;0;0;0;.00nan;0;0
804;1614;25;74;19;1;18;.947;3600000;0
804;5182;25;0;0;0;0;.00nan;0;0
804;22601;26;27;27;6;21;.778;1514000;0
804;32754;26;50;28;4;24;.857;2086000;0
805;500;4182;58;22;3;19;.864;3600000;0
805;5385;17;0;0;0;0;.00nan;0;0
805;25521;4182;0;0;0;0;.00nan;0;0
805;34006;17;56;44;6;38;.864;3600000;0
806;724;11;0;0;0;0;.00nan;0;0
806;20853;9;0;0;0;0;.00nan;0;0
806;21522;11;69;60;7;53;.883;3600000;0
806;28026;9;72;24;2;22;.917;3600000;0
807;376;22;73;30;2;28;.933;3900000;0
807;823;23;0;0;0;0;.00nan;0;0
807;10274;23;93;37;2;35;.946;3900000;0
807;27739;22;0;0;0;0;.00nan;0;0
808;262;35;39;28;5;23;.821;3600000;0
808;5048;35;0;0;0;0;.00nan;0;0
808;25076;8;92;39;2;37;.949;3600000;0
808;34788;8;0;0;0;0;.00nan;0;0
809;544;19;51;24;3;21;.875;3600000;0
809;22601;26;100;24;0;24;1.000;3600000;0
809;31124;19;0;0;0;0;.00nan;0;0
809;32754;26;0;0;0;0;.00nan;0;0
810;1251;14;0;0;0;0;.00nan;0;0
810;20853;9;0;0;0;0;.00nan;0;0
810;25584;14;55;23;3;20;.870;3600000;0
810;28026;9;100;30;0;30;1.000;3600000;0
811;233;29;100;37;1;36;.973;3600000;0
811;823;23;0;0;0;0;.00nan;0;0
811;10274;23;64;27;2;25;.926;3549000;0
811;18351;29;0;0;0;0;.00nan;0;0
812;445;12;89;44;3;41;.932;3600000;0
812;4506;33;100;30;0;30;1.000;3600000;0
812;34740;33;0;0;0;0;.00nan;0;0
812;34786;12;0;0;0;0;.00nan;0;0
813;724;11;0;0;0;0;.00nan;0;0
813;21522;11;89;41;2;39;.951;3600000;0
813;22601;26;91;29;1;28;.966;3600000;0
813;32754;26;0;0;0;0;.00nan;0;0
814;1430;35;0;0;0;0;.00nan;0;0
814;1821;3;75;30;2;28;.933;3600000;0
814;2054;3;0;0;0;0;.00nan;0;0
814;26840;35;70;36;3;33;.917;3556000;0
815;61;31;88;23;1;22;.957;3600000;0
815;13842;34;0;0;0;0;.00nan;0;0
815;15502;34;83;30;2;28;.933;3600000;0
815;34797;31;0;0;0;0;.00nan;0;0
816;51;21;97;39;2;37;.949;3600000;0
816;2423;15;69;45;5;40;.889;3600000;0
816;4106;15;0;0;0;0;.00nan;0;0
816;25843;21;0;0;0;0;.00nan;0;0
817;376;22;91;36;2;34;.944;3600000;0
817;18104;10;0;0;0;0;.00nan;0;0
817;27488;10;71;37;4;33;.892;3573000;0
817;27739;22;0;0;0;0;.00nan;0;0
818;445;12;0;0;0;0;.00nan;0;0
818;15464;32;88;19;0;19;1.000;3600000;0
818;16006;32;0;0;0;0;.00nan;0;0
818;34786;12;61;29;3;26;.897;3600000;0
819;335;18;59;42;5;37;.881;3539000;0
819;544;19;0;0;0;0;.00nan;0;0
819;5001;18;0;0;0;0;.00nan;0;0
819;31124;19;93;35;3;32;.914;3600000;0
820;738;27;92;37;2;35;.946;3560000;0
820;928;20;91;28;1;27;.964;3600000;0
820;18078;20;0;0;0;0;.00nan;0;0
820;26623;27;0;0;0;0;.00nan;0;0
821;1572;4838;66;44;4;40;.909;3600000;0
821;2328;4838;0;0;0;0;.00nan;0;0
821;4450;5;0;0;0;0;.00nan;0;0
821;19823;5;80;21;1;20;.952;3600000;0
822;10103;24;0;0;0;0;.00nan;0;0
822;13842;34;27;35;7;28;.800;3600000;0
822;13979;24;56;29;4;25;.862;3600000;0
822;15502;34;0;0;0;0;.00nan;0;0
823;51;21;0;0;0;0;.00nan;0;0
823;15505;8;0;0;0;0;.00nan;0;0
823;25076;8;84;43;3;40;.930;3835000;0
823;25843;21;63;22;2;20;.909;3835000;0
824;1796;16;0;0;0;0;.00nan;0;0
824;5385;17;0;0;0;0;.00nan;0;0
824;15437;16;64;25;2;23;.920;3600000;0
824;34006;17;30;36;7;29;.806;3600000;0
825;1614;25;54;41;5;36;.878;3600000;0
825;4506;33;88;33;2;31;.939;3600000;0
825;5182;25;0;0;0;0;.00nan;0;0
825;34740;33;0;0;0;0;.00nan;0;0
826;500;4182;68;21;2;19;.905;3600000;0
826;22601;26;49;1;0;1;1.000;251000;0
826;25521;4182;0;0;0;0;.00nan;0;0
826;32754;26;37;31;6;25;.806;3349000;0
827;724;11;0;0;0;0;.00nan;0;0
827;1913;30;0;0;0;0;.00nan;0;0
827;4826;30;96;48;3;45;.938;3643000;0
827;21522;11;59;22;4;18;.818;3643000;0
828;1821;3;100;32;0;32;1.000;3600000;0
828;2054;3;0;0;0;0;.00nan;0;0
828;20853;9;0;0;0;0;.00nan;0;0
828;28026;9;97;39;2;37;.949;3544000;0
829;1074;0;59;33;4;29;.879;3544000;0
829;2058;28;55;26;3;23;.885;3600000;0
829;14061;28;0;0;0;0;.00nan;0;0
829;31035;0;0;0;0;0;.00nan;0;0
830;61;31;68;24;2;22;.917;3570000;0
830;823;23;0;0;0;0;.00nan;0;0
830;10274;23;100;55;0;55;1.000;3600000;0
830;34797;31;0;0;0;0;.00nan;0;0
831;376;22;50;15;2;13;.867;1574000;0
831;1251;14;99;26;0;26;1.000;3600000;0
831;25584;14;0;0;0;0;.00nan;0;0
831;27739;22;21;23;6;17;.739;2026000;0
832;2423;15;71;33;3;30;.909;3665000;0
832;4106;15;0;0;0;0;.00nan;0;0
832;18104;10;0;0;0;0;.00nan;0;0
832;27488;10;54;28;4;24;.857;3665000;0
833;233;29;0;0;0;0;.00nan;0;0
833;15464;32;77;21;2;19;.905;3726000;0
833;16006;32;0;0;0;0;.00nan;0;0
833;18351;29;71;27;3;24;.889;3726000;0
834;544;19;0;0;0;0;.00nan;0;0
834;1430;35;90;41;3;38;.927;3600000;0
834;26840;35;0;0;0;0;.00nan;0;0
834;31124;19;100;31;0;31;1.000;3600000;0
835;500;4182;0;0;0;0;.00nan;0;0
835;1614;25;64;33;4;29;.879;3600000;0
835;5182;25;0;0;0;0;.00nan;0;0
835;25521;4182;74;22;1;21;.955;3600000;0
836;724;11;100;42;1;41;.976;3600000;0
836;928;20;62;30;3;27;.900;3525000;0
836;18078;20;0;0;0;0;.00nan;0;0
836;21522;11;0;0;0;0;.00nan;0;0
837;738;27;45;18;3;15;.833;1884000;0
837;4450;5;56;29;3;26;.897;3600000;0
837;19823;5;0;0;0;0;.00nan;0;0
837;26623;27;1;22;8;14;.636;1716000;0
838;335;18;0;0;0;0;.00nan;0;0
838;5001;18;65;32;4;28;.875;3600000;0
838;18104;10;0;0;0;0;.00nan;0;0
838;27488;10;65;42;5;37;.881;3586000;0
839;823;23;0;0;0;0;.00nan;0;0
839;10103;24;0;0;0;0;.00nan;0;0
839;10274;23;53;33;4;29;.879;3574000;0
839;13979;24;73;38;3;35;.921;3600000;0
840;262;34;0;0;0;0;.00nan;0;0
840;2423;15;80;31;2;29;.935;3900000;0
840;4106;15;0;0;0;0;.00nan;0;0
840;15502;34;100;40;2;38;.950;3900000;0
841;1796;16;0;0;0;0;.00nan;0;0
841;15437;16;97;30;1;29;.967;3600000;0
841;15505;8;0;0;0;0;.00nan;0;0
841;25076;8;70;35;3;32;.914;3582000;0
842;445;12;74;31;2;29;.935;3650000;0
842;5385;17;0;0;0;0;.00nan;0;0
842;34006;17;82;33;3;30;.909;3650000;0
842;34786;12;0;0;0;0;.00nan;0;0
843;4506;33;99;30;1;29;.967;3600000;0
843;22601;26;0;0;0;0;.00nan;0;0
843;32754;26;46;21;3;18;.857;3523000;0
843;34740;33;0;0;0;0;.00nan;0;0
844;928;20;0;0;0;0;.00nan;0;0
844;1913;30;0;0;0;0;.00nan;0;0
844;4826;30;94;43;2;41;.953;3591000;0
844;18078;20;88;24;1;23;.958;3600000;0
845;738;27;41;29;6;23;.793;3670000;0
845;1572;4838;0;0;0;0;.00nan;0;0
845;2328;4838;54;43;5;38;.884;3670000;0
845;26623;27;0;0;0;0;.00nan;0;0
846;51;21;77;37;4;33;.892;3517000;0
846;335;18;0;0;0;0;.00nan;0;0
846;5001;18;85;33;2;31;.939;3600000;0
846;25843;21;0;0;0;0;.00nan;0;0
847;1251;14;83;39;3;36;.923;3600000;0
847;1796;16;45;32;5;27;.844;3545000;0
847;15437;16;0;0;0;0;.00nan;0;0
847;25584;14;0;0;0;0;.00nan;0;0
848;376;22;0;0;0;0;.00nan;0;0
848;1821;3;58;34;4;30;.882;3588000;0
848;2054;3;0;0;0;0;.00nan;0;0
848;27739;22;68;32;3;29;.906;3600000;0
849;724;11;0;0;0;0;.00nan;0;0
849;4450;5;70;35;3;32;.914;3728000;0
849;19823;5;0;0;0;0;.00nan;0;0
849;21522;11;69;36;4;32;.889;3728000;0
850;10103;24;0;0;0;0;.00nan;0;0
850;13979;24;32;23;5;18;.783;3600000;0
850;20853;9;0;0;0;0;.00nan;0;0
850;28026;9;88;38;2;36;.947;3600000;0
851;233;29;0;0;0;0;.00nan;0;0
851;2058;28;0;0;0;0;.00nan;0;0
851;14061;28;35;33;6;27;.818;3600000;0
851;18351;29;76;22;1;21;.955;3600000;0
852;823;23;0;0;0;0;.00nan;0;0
852;1251;14;0;0;0;0;.00nan;0;0
852;10274;23;83;33;1;32;.970;3812000;0
852;25584;14;86;37;2;35;.946;3812000;0
853;51;21;72;26;2;24;.923;3514000;0
853;262;34;0;0;0;0;.00nan;0;0
853;15502;34;100;31;0;31;1.000;3600000;0
853;25843;21;0;0;0;0;.00nan;0;0
854;544;19;0;0;0;0;.00nan;0;0
854;1430;35;0;0;0;0;.00nan;0;0
854;26840;35;99;35;2;33;.943;3600000;0
854;31124;19;55;31;4;27;.871;3569000;0
855;1074;0;67;45;5;40;.889;3600000;0
855;4506;33;58;16;2;14;.875;3600000;0
855;31035;0;0;0;0;0;.00nan;0;0
855;34740;33;0;0;0;0;.00nan;0;0
856;928;20;76;39;4;35;.897;3568000;0
856;1614;25;76;24;2;22;.917;3600000;0
856;5182;25;0;0;0;0;.00nan;0;0
856;18078;20;0;0;0;0;.00nan;0;0
857;500;4182;89;38;3;35;.921;3600000;0
857;738;27;0;0;0;0;.00nan;0;0
857;25521;4182;0;0;0;0;.00nan;0;0
857;26623;27;81;43;4;39;.907;3600000;0
858;1913;30;85;39;3;36;.923;3900000;0
858;4450;5;0;0;0;0;.00nan;0;0
858;4826;30;0;0;0;0;.00nan;0;0
858;19823;5;53;20;3;17;.850;3900000;0
859;1821;3;59;30;4;26;.867;3900000;0
859;2054;3;0;0;0;0;.00nan;0;0
859;5385;17;0;0;0;0;.00nan;0;0
859;34006;17;83;46;4;42;.913;3900000;0
860;1796;16;55;17;2;15;.882;1135000;0
860;15437;16;32;30;6;24;.800;2465000;0
860;18104;10;0;0;0;0;.00nan;0;0
860;27488;10;47;29;4;25;.862;3600000;0
861;445;12;100;27;0;27;1.000;3600000;0
861;724;11;57;42;5;37;.881;3600000;0
861;21522;11;0;0;0;0;.00nan;0;0
861;34786;12;0;0;0;0;.00nan;0;0
862;1572;4838;0;0;0;0;.00nan;0;0
862;2328;4838;93;28;2;26;.929;3900000;0
862;15464;32;59;17;2;15;.882;3900000;0
862;16006;32;0;0;0;0;.00nan;0;0
863;233;29;0;0;0;0;.00nan;0;0
863;2423;15;99;42;1;41;.976;3600000;0
863;4106;15;0;0;0;0;.00nan;0;0
863;18351;29;82;41;3;38;.927;3591000;0
864;61;31;48;40;6;34;.850;3600000;0
864;2058;28;99;40;1;39;.975;3600000;0
864;14061;28;0;0;0;0;.00nan;0;0
864;34797;31;0;0;0;0;.00nan;0;0
865;335;18;0;0;0;0;.00nan;0;0
865;928;20;94;40;3;37;.925;3625000;0
865;5001;18;92;37;2;35;.946;3625000;0
865;18078;20;0;0;0;0;.00nan;0;0
866;1251;14;0;0;0;0;.00nan;0;0
866;1430;35;0;0;0;0;.00nan;0;0
866;25584;14;89;40;2;38;.950;3554000;0
866;26840;35;74;23;1;22;.957;3600000;0
867;376;22;0;0;0;0;.00nan;0;0
867;10103;24;0;0;0;0;.00nan;0;0
867;13979;24;53;16;2;14;.875;3600000;0
867;27739;22;61;27;3;24;.889;3544000;0
868;823;23;0;0;0;0;.00nan;0;0
868;10274;23;30;40;8;32;.800;3600000;0
868;15505;8;0;0;0;0;.00nan;0;0
868;25076;8;66;29;3;26;.897;3600000;0
869;544;19;0;0;0;0;.00nan;0;0
869;1074;0;60;29;4;25;.862;3555000;0
869;31035;0;0;0;0;0;.00nan;0;0
869;31124;19;77;32;2;30;.938;3600000;0
870;1614;25;90;33;1;32;.970;3600000;0
870;5182;25;0;0;0;0;.00nan;0;0
870;22601;26;73;38;4;34;.895;3600000;0
870;32754;26;0;0;0;0;.00nan;0;0
871;500;4182;68;23;2;21;.913;3600000;0
871;4450;5;0;0;0;0;.00nan;0;0
871;19823;5;59;41;5;36;.878;3600000;0
871;25521;4182;0;0;0;0;.00nan;0;0
872;1430;35;95;21;0;21;1.000;3600000;0
872;5385;17;54;34;4;30;.882;3600000;0
872;26840;35;0;0;0;0;.00nan;0;0
872;34006;17;0;0;0;0;.00nan;0;0
873;233;29;58;23;3;20;.870;3600000;0
873;18351;29;0;0;0;0;.00nan;0;0
873;20853;9;0;0;0;0;.00nan;0;0
873;28026;9;70;37;4;33;.892;3569000;0
874;51;21;80;33;3;30;.909;3575000;0
874;18104;10;0;0;0;0;.00nan;0;0
874;25843;21;0;0;0;0;.00nan;0;0
874;27488;10;94;38;2;36;.947;3600000;0
875;2423;15;59;10;1;9;.900;904000;0
875;4106;15;27;33;7;26;.788;2696000;0
875;10103;24;91;29;1;28;.966;3600000;0
875;13979;24;0;0;0;0;.00nan;0;0
876;262;34;0;0;0;0;.00nan;0;0
876;724;11;92;37;1;36;.973;3600000;0
876;15502;34;72;40;5;35;.875;3600000;0
876;21522;11;0;0;0;0;.00nan;0;0
877;445;12;43;34;6;28;.824;2787000;0
877;4506;33;0;0;0;0;.00nan;0;0
877;34740;33;72;26;2;24;.923;3600000;0
877;34786;12;59;7;0;7;1.000;813000;0
878;500;4182;0;0;0;0;.00nan;0;0
878;1913;30;45;30;5;25;.833;3582000;0
878;4826;30;0;0;0;0;.00nan;0;0
878;25521;4182;66;31;4;27;.871;3600000;0
879;335;18;0;0;0;0;.00nan;0;0
879;1821;3;0;0;0;0;.00nan;0;0
879;2054;3;67;34;4;30;.882;3571000;0
879;5001;18;99;38;2;36;.947;3600000;0
880;61;31;68;30;3;27;.900;3600000;0
880;20853;9;69;35;4;31;.886;3566000;0
880;28026;9;0;0;0;0;.00nan;0;0
880;34797;31;0;0;0;0;.00nan;0;0
881;928;20;77;29;2;27;.931;3600000;0
881;1796;16;0;0;0;0;.00nan;0;0
881;15437;16;68;27;3;24;.889;3562000;0
881;18078;20;0;0;0;0;.00nan;0;0
882;1251;14;68;24;2;22;.917;3600000;0
882;15505;8;0;0;0;0;.00nan;0;0
882;25076;8;78;35;3;32;.914;3589000;0
882;25584;14;0;0;0;0;.00nan;0;0
883;376;22;0;0;0;0;.00nan;0;0
883;1572;4838;0;0;0;0;.00nan;0;0
883;2328;4838;74;31;3;28;.903;3591000;0
883;27739;22;91;42;2;40;.952;3600000;0
884;262;34;82;32;2;30;.938;3600000;0
884;4450;5;42;23;4;19;.826;3522000;0
884;15502;34;0;0;0;0;.00nan;0;0
884;19823;5;0;0;0;0;.00nan;0;0
885;544;19;0;0;0;0;.00nan;0;0
885;1614;25;83;33;2;31;.939;3600000;0
885;5182;25;0;0;0;0;.00nan;0;0
885;31124;19;44;23;4;19;.826;3562000;0
886;823;23;82;31;2;29;.935;3600000;0
886;1074;0;49;6;1;5;.833;318000;0
886;10274;23;0;0;0;0;.00nan;0;0
886;31035;0;21;27;6;21;.778;3282000;0
887;2058;28;0;0;0;0;.00nan;0;0
887;14061;28;55;27;4;23;.852;3543000;0
887;22601;26;0;0;0;0;.00nan;0;0
887;32754;26;79;34;3;31;.912;3600000;0
888;738;27;0;0;0;0;.00nan;0;0
888;15464;32;0;0;0;0;.00nan;0;0
888;16006;32;85;38;3;35;.921;3600000;0
888;26623;27;52;34;5;29;.853;3553000;0
889;724;11;0;0;0;0;.00nan;0;0
889;5385;17;0;0;0;0;.00nan;0;0
889;21522;11;72;32;2;30;.938;3578000;0
889;34006;17;86;25;1;24;.960;3600000;0
890;51;21;0;0;0;0;.00nan;0;0
890;1796;16;79;29;1;28;.966;3600000;0
890;15437;16;0;0;0;0;.00nan;0;0
890;25843;21;64;28;2;26;.929;3600000;0
891;1572;4838;74;28;2;26;.929;3544000;0
891;2328;4838;0;0;0;0;.00nan;0;0
891;10103;24;0;0;0;0;.00nan;0;0
891;13979;24;83;26;1;25;.962;3600000;0
892;233;29;0;0;0;0;.00nan;0;0
892;15505;8;68;39;4;35;.897;3600000;0
892;18351;29;85;25;1;24;.960;3600000;0
892;25076;8;0;0;0;0;.00nan;0;0
893;445;12;94;26;1;25;.962;3600000;0
893;1430;35;89;41;2;39;.951;3566000;0
893;26840;35;0;0;0;0;.00nan;0;0
893;34786;12;0;0;0;0;.00nan;0;0
894;4506;33;86;37;2;35;.946;3563000;0
894;18104;10;0;0;0;0;.00nan;0;0
894;27488;10;95;33;1;32;.970;3600000;0
894;34740;33;0;0;0;0;.00nan;0;0
895;500;4182;66;21;2;19;.905;3600000;0
895;2058;28;40;37;6;31;.838;2375000;0
895;14061;28;33;11;3;8;.727;1225000;0
895;25521;4182;0;0;0;0;.00nan;0;0
896;738;27;49;15;2;13;.867;3600000;0
896;1913;30;37;21;4;17;.810;1666000;0
896;4826;30;25;26;6;20;.769;1934000;0
896;26623;27;0;0;0;0;.00nan;0;0
897;724;11;55;27;3;24;.889;3550000;0
897;4450;5;0;0;0;0;.00nan;0;0
897;19823;5;74;28;2;26;.929;3600000;0
897;21522;11;0;0;0;0;.00nan;0;0
898;61;31;87;18;0;18;1.000;3600000;0
898;5385;17;68;34;3;31;.912;3600000;0
898;34006;17;0;0;0;0;.00nan;0;0
898;34797;31;0;0;0;0;.00nan;0;0
899;928;20;65;42;5;37;.881;3900000;0
899;1614;25;76;52;5;47;.904;3900000;0
899;5182;25;0;0;0;0;.00nan;0;0
899;18078;20;0;0;0;0;.00nan;0;0
900;262;34;0;0;0;0;.00nan;0;0
900;1821;3;96;33;1;32;.970;3600000;0
900;2054;3;0;0;0;0;.00nan;0;0
900;15502;34;87;42;3;39;.929;3568000;0
901;1572;4838;0;0;0;0;.00nan;0;0
901;1821;3;85;18;0;18;1.000;2747000;0
901;2054;3;40;20;4;16;.800;1074000;0
901;2328;4838;61;40;5;35;.875;3821000;0
902;20853;9;0;0;0;0;.00nan;0;0
902;22601;26;0;0;0;0;.00nan;0;0
902;28026;9;98;35;2;33;.943;3900000;0
902;32754;26;95;30;2;28;.933;3900000;0
903;51;21;98;25;0;25;1.000;3600000;0
903;1614;25;0;0;0;0;.00nan;0;0
903;5182;25;79;29;1;28;.966;3586000;0
903;25843;21;0;0;0;0;.00nan;0;0
904;500;4182;46;35;5;30;.857;3770000;0
904;1251;14;0;0;0;0;.00nan;0;0
904;25521;4182;0;0;0;0;.00nan;0;0
904;25584;14;60;50;6;44;.880;3770000;0
905;61;31;21;37;8;29;.784;3600000;0
905;2423;15;50;23;3;20;.870;3600000;0
905;4106;15;0;0;0;0;.00nan;0;0
905;34797;31;0;0;0;0;.00nan;0;0
906;1913;30;82;50;4;46;.920;3900000;0
906;4826;30;0;0;0;0;.00nan;0;0
906;15505;8;0;0;0;0;.00nan;0;0
906;25076;8;83;44;4;40;.909;3900000;0
907;1796;16;0;0;0;0;.00nan;0;0
907;2058;28;0;0;0;0;.00nan;0;0
907;14061;28;29;30;6;24;.800;3600000;0
907;15437;16;80;29;2;27;.931;3600000;0
908;445;12;92;30;2;28;.933;3900000;0
908;15464;32;88;36;2;34;.944;3900000;0
908;16006;32;0;0;0;0;.00nan;0;0
908;34786;12;0;0;0;0;.00nan;0;0
909;1430;35;0;0;0;0;.00nan;0;0
909;18104;10;0;0;0;0;.00nan;0;0
909;26840;35;53;34;5;29;.853;3548000;0
909;27488;10;60;30;3;27;.900;3600000;0
910;233;29;0;0;0;0;.00nan;0;0
910;4506;33;64;17;1;16;.941;3600000;0
910;18351;29;100;35;0;35;1.000;3600000;0
910;34740;33;0;0;0;0;.00nan;0;0
911;376;22;45;32;5;27;.844;3551000;0
911;544;19;0;0;0;0;.00nan;0;0
911;27739;22;0;0;0;0;.00nan;0;0
911;31124;19;49;21;3;18;.857;3600000;0
912;376;22;0;0;0;0;.00nan;0;0
912;823;23;0;0;0;0;.00nan;0;0
912;10274;23;85;26;1;25;.962;3600000;0
912;27739;22;70;30;2;28;.933;3581000;0
913;335;18;0;0;0;0;.00nan;0;0
913;1074;0;0;0;0;0;.00nan;0;0
913;5001;18;68;31;3;28;.903;3900000;0
913;31035;0;65;33;3;30;.909;3900000;0
914;4450;5;0;0;0;0;.00nan;0;0
914;15505;8;61;45;6;39;.867;3600000;0
914;19823;5;73;25;2;23;.920;3600000;0
914;25076;8;0;0;0;0;.00nan;0;0
915;500;4182;82;24;1;23;.958;3600000;0
915;5385;17;0;0;0;0;.00nan;0;0
915;25521;4182;0;0;0;0;.00nan;0;0
915;34006;17;81;33;2;31;.939;3600000;0
916;1821;3;80;25;1;24;.960;3600000;0
916;2054;3;0;0;0;0;.00nan;0;0
916;22601;26;0;0;0;0;.00nan;0;0
916;32754;26;75;29;2;27;.931;3585000;0
917;1572;4838;0;0;0;0;.00nan;0;0
917;2058;28;68;31;3;28;.903;3900000;0
917;2328;4838;74;35;3;32;.914;3900000;0
917;14061;28;0;0;0;0;.00nan;0;0
918;1430;35;0;0;0;0;.00nan;0;0
918;20853;9;0;0;0;0;.00nan;0;0
918;26840;35;58;28;4;24;.857;3582000;0
918;28026;9;94;36;2;34;.944;3600000;0
919;61;31;24;11;4;7;.636;1159000;0
919;1251;14;77;28;1;27;.964;3600000;0
919;25584;14;0;0;0;0;.00nan;0;0
919;34797;31;47;19;3;16;.842;2441000;0
920;51;21;19;23;6;17;.739;2124000;0
920;4506;33;64;23;2;21;.913;3600000;0
920;25843;21;86;20;0;20;1.000;1476000;0
920;34740;33;0;0;0;0;.00nan;0;0
921;928;20;68;31;4;27;.871;3600000;0
921;2423;15;57;39;5;34;.872;3576000;0
921;4106;15;0;0;0;0;.00nan;0;0
921;18078;20;0;0;0;0;.00nan;0;0
922;1614;25;57;38;4;34;.895;3900000;0
922;5182;25;0;0;0;0;.00nan;0;0
922;10103;24;0;0;0;0;.00nan;0;0
922;13979;24;70;41;4;37;.902;3900000;0
923;1796;16;0;0;0;0;.00nan;0;0
923;15437;16;100;28;0;28;1.000;3600000;0
923;18104;10;0;0;0;0;.00nan;0;0
923;27488;10;87;35;2;33;.943;3513000;0
924;1913;30;71;47;5;42;.894;3842000;0
924;4826;30;0;0;0;0;.00nan;0;0
924;15464;32;32;30;6;24;.800;3842000;0
924;16006;32;0;0;0;0;.00nan;0;0
925;233;29;0;0;0;0;.00nan;0;0
925;544;19;0;0;0;0;.00nan;0;0
925;18351;29;80;50;5;45;.900;3600000;0
925;31124;19;72;26;2;24;.923;3600000;0
926;724;11;0;0;0;0;.00nan;0;0
926;738;27;0;0;0;0;.00nan;0;0
926;21522;11;78;41;3;38;.927;3900000;0
926;26623;27;57;27;3;24;.889;3900000;0
927;928;20;0;0;0;0;.00nan;0;0
927;4506;33;0;0;0;0;.00nan;0;0
927;18078;20;60;26;3;23;.885;3550000;0
927;34740;33;88;32;1;31;.969;3600000;0
928;500;4182;0;0;0;0;.00nan;0;0
928;2423;15;100;24;0;24;1.000;3600000;0
928;4106;15;0;0;0;0;.00nan;0;0
928;25521;4182;88;34;1;33;.971;3563000;0
929;1430;35;100;37;0;37;1.000;3600000;0
929;13842;34;44;26;4;22;.846;2487000;0
929;15502;34;30;20;5;15;.750;1113000;0
929;26840;35;0;0;0;0;.00nan;0;0
930;335;18;0;0;0;0;.00nan;0;0
930;376;22;80;34;3;31;.912;3900000;0
930;5001;18;72;40;3;37;.925;3900000;0
930;27739;22;0;0;0;0;.00nan;0;0
931;4450;5;0;0;0;0;.00nan;0;0
931;19823;5;79;32;2;30;.938;3600000;0
931;22601;26;0;0;0;0;.00nan;0;0
931;32754;26;59;36;4;32;.889;3587000;0
932;1074;0;99;41;1;40;.976;3600000;0
932;1572;4838;0;0;0;0;.00nan;0;0
932;2328;4838;67;23;2;21;.913;3570000;0
932;31035;0;0;0;0;0;.00nan;0;0
933;2058;28;0;0;0;0;.00nan;0;0
933;14061;28;46;26;4;22;.846;3900000;0
933;15505;8;84;49;4;45;.918;3900000;0
933;25076;8;0;0;0;0;.00nan;0;0
934;51;21;82;25;1;24;.960;3600000;0
934;1913;30;83;29;2;27;.931;3561000;0
934;4826;30;0;0;0;0;.00nan;0;0
934;25843;21;0;0;0;0;.00nan;0;0
935;1251;14;42;30;5;25;.833;3600000;0
935;10103;24;0;0;0;0;.00nan;0;0
935;13979;24;89;32;1;31;.969;3600000;0
935;25584;14;0;0;0;0;.00nan;0;0
936;1796;16;0;0;0;0;.00nan;0;0
936;15437;16;63;22;2;20;.909;3539000;0
936;15464;32;100;46;0;46;1.000;3600000;0
936;16006;32;0;0;0;0;.00nan;0;0
937;445;12;86;31;1;30;.968;3600000;0
937;18104;10;0;0;0;0;.00nan;0;0
937;27488;10;63;34;3;31;.912;3565000;0
937;34786;12;0;0;0;0;.00nan;0;0
938;544;19;0;0;0;0;.00nan;0;0
938;20853;9;0;0;0;0;.00nan;0;0
938;28026;9;50;38;6;32;.842;3600000;0
938;31124;19;57;24;3;21;.875;3600000;0
939;233;29;0;0;0;0;.00nan;0;0
939;823;23;0;0;0;0;.00nan;0;0
939;10274;23;99;37;1;36;.973;3600000;0
939;18351;29;65;19;2;17;.895;3572000;0
940;724;11;0;0;0;0;.00nan;0;0
940;738;27;0;0;0;0;.00nan;0;0
940;21522;11;69;21;1;20;.952;3600000;0
940;26623;27;56;24;3;21;.875;3574000;0
941;1821;3;82;25;1;24;.960;3600000;0
941;2054;3;0;0;0;0;.00nan;0;0
941;5385;17;0;0;0;0;.00nan;0;0
941;34006;17;74;30;2;28;.933;3600000;0
942;928;20;55;18;2;16;.889;3600000;0
942;1913;30;54;11;1;10;.909;629000;0
942;4826;30;41;37;6;31;.838;2971000;0
942;18078;20;0;0;0;0;.00nan;0;0
943;1074;0;0;0;0;0;.00nan;0;0
943;1251;14;0;0;0;0;.00nan;0;0
943;25584;14;77;36;3;33;.917;3600000;0
943;31035;0;100;28;0;28;1.000;3600000;0
944;2423;15;71;52;6;46;.885;3900000;0
944;4106;15;0;0;0;0;.00nan;0;0
944;10103;24;0;0;0;0;.00nan;0;0
944;13979;24;40;36;6;30;.833;3900000;0
945;500;4182;21;28;6;22;.786;3600000;0
945;13842;34;0;0;0;0;.00nan;0;0
945;15502;34;78;34;3;31;.912;3600000;0
945;25521;4182;0;0;0;0;.00nan;0;0
946;1796;16;74;34;4;30;.882;3614000;0
946;4506;33;69;28;3;25;.893;3614000;0
946;15437;16;0;0;0;0;.00nan;0;0
946;34740;33;0;0;0;0;.00nan;0;0
947;1430;35;87;28;1;27;.964;3574000;0
947;15464;32;100;37;0;37;1.000;3600000;0
947;16006;32;0;0;0;0;.00nan;0;0
947;26840;35;0;0;0;0;.00nan;0;0
948;544;19;75;20;1;19;.950;3600000;0
948;1614;25;77;41;4;37;.902;3600000;0
948;5182;25;0;0;0;0;.00nan;0;0
948;31124;19;0;0;0;0;.00nan;0;0
949;233;29;57;22;3;19;.864;3600000;0
949;335;18;0;0;0;0;.00nan;0;0
949;5001;18;68;37;4;33;.892;3558000;0
949;18351;29;0;0;0;0;.00nan;0;0
950;61;31;87;31;1;30;.968;3600000;0
950;724;11;51;31;5;26;.839;3600000;0
950;21522;11;0;0;0;0;.00nan;0;0
950;34797;31;0;0;0;0;.00nan;0;0
951;2058;28;67;33;3;30;.909;3560000;0
951;14061;28;0;0;0;0;.00nan;0;0
951;22601;26;0;0;0;0;.00nan;0;0
951;32754;26;87;38;2;36;.947;3600000;0
952;445;12;57;36;5;31;.861;3579000;0
952;1821;3;59;25;3;22;.880;3600000;0
952;2054;3;0;0;0;0;.00nan;0;0
952;34786;12;0;0;0;0;.00nan;0;0
953;1074;0;0;0;0;0;.00nan;0;0
953;22601;26;56;24;3;21;.875;3561000;0
953;31035;0;81;31;2;29;.935;3600000;0
953;32754;26;0;0;0;0;.00nan;0;0
954;1913;30;0;0;0;0;.00nan;0;0
954;4826;30;72;43;4;39;.907;3900000;0
954;18104;10;0;0;0;0;.00nan;0;0
954;27488;10;47;24;4;20;.833;3900000;0
955;376;22;57;21;3;18;.857;3600000;0
955;928;20;31;10;3;7;.700;1502000;0
955;18078;20;43;37;6;31;.838;2098000;0
955;27739;22;0;0;0;0;.00nan;0;0
956;4450;5;0;0;0;0;.00nan;0;0
956;15505;8;0;0;0;0;.00nan;0;0
956;19823;5;54;23;3;20;.870;3574000;0
956;25076;8;96;41;2;39;.951;3600000;0
957;2423;15;75;32;3;29;.906;3558000;0
957;4106;15;0;0;0;0;.00nan;0;0
957;15464;32;88;34;2;32;.941;3600000;0
957;16006;32;0;0;0;0;.00nan;0;0
958;500;4182;90;42;3;39;.929;3786000;0
958;4506;33;65;26;2;24;.923;3786000;0
958;25521;4182;0;0;0;0;.00nan;0;0
958;34740;33;0;0;0;0;.00nan;0;0
959;823;23;0;0;0;0;.00nan;0;0
959;10274;23;100;28;0;28;1.000;3600000;0
959;20853;9;0;0;0;0;.00nan;0;0
959;28026;9;41;37;6;31;.838;3600000;0
960;51;21;80;37;4;33;.892;3727000;0
960;335;18;0;0;0;0;.00nan;0;0
960;5001;18;79;37;3;34;.919;3727000;0
960;25843;21;0;0;0;0;.00nan;0;0
961;724;11;0;0;0;0;.00nan;0;0
961;1614;25;47;35;6;29;.829;3600000;0
961;5182;25;0;0;0;0;.00nan;0;0
961;21522;11;97;34;1;33;.971;3600000;0
962;61;31;61;32;4;28;.875;3900000;0
962;738;27;0;0;0;0;.00nan;0;0
962;26623;27;75;44;4;40;.909;3900000;0
962;34797;31;0;0;0;0;.00nan;0;0
963;2058;28;58;45;6;39;.867;3096000;0
963;13842;34;0;0;0;0;.00nan;0;0
963;14061;28;49;1;0;1;1.000;453000;0
963;15502;34;57;32;5;27;.844;3600000;0
964;1430;35;73;26;2;24;.923;3900000;0
964;4450;5;74;29;2;27;.931;3900000;0
964;19823;5;0;0;0;0;.00nan;0;0
964;26840;35;0;0;0;0;.00nan;0;0
965;51;21;0;0;0;0;.00nan;0;0
965;544;19;0;0;0;0;.00nan;0;0
965;25843;21;82;39;3;36;.923;3569000;0
965;31124;19;59;18;2;16;.889;3600000;0
966;233;29;0;0;0;0;.00nan;0;0
966;1572;4838;56;31;4;27;.871;3553000;0
966;2328;4838;0;0;0;0;.00nan;0;0
966;18351;29;74;33;3;30;.909;3600000;0
967;1821;3;66;36;4;32;.889;3600000;0
967;2054;3;0;0;0;0;.00nan;0;0
967;10103;24;0;0;0;0;.00nan;0;0
967;13979;24;46;35;5;30;.857;3595000;0
968;445;12;66;29;2;27;.931;3900000;0
968;717;0;0;0;0;0;.00nan;0;0
968;1074;0;86;41;2;39;.951;3900000;0
968;34786;12;0;0;0;0;.00nan;0;0
969;1251;14;41;32;5;27;.844;3600000;0
969;15464;32;23;30;7;23;.767;3522000;0
969;16006;32;0;0;0;0;.00nan;0;0
969;25584;14;0;0;0;0;.00nan;0;0
970;376;22;0;0;0;0;.00nan;0;0
970;13842;34;99;46;2;44;.957;3900000;0
970;15502;34;0;0;0;0;.00nan;0;0
970;27739;22;94;41;2;39;.951;3900000;0
971;1796;16;0;0;0;0;.00nan;0;0
971;2423;15;87;31;2;29;.935;3600000;0
971;4106;15;0;0;0;0;.00nan;0;0
971;15437;16;54;34;5;29;.853;3600000;0
972;823;23;0;0;0;0;.00nan;0;0
972;5385;17;75;31;2;29;.935;3600000;0
972;10274;23;77;34;3;31;.912;3600000;0
972;34006;17;0;0;0;0;.00nan;0;0
973;335;18;0;0;0;0;.00nan;0;0
973;5001;18;60;29;3;26;.897;3600000;0
973;20853;9;0;0;0;0;.00nan;0;0
973;28026;9;47;40;6;34;.850;3600000;0
974;61;31;47;24;4;20;.833;3600000;0
974;500;4182;100;28;0;28;1.000;3600000;0
974;25521;4182;0;0;0;0;.00nan;0;0
974;34797;31;0;0;0;0;.00nan;0;0
975;724;11;0;0;0;0;.00nan;0;0
975;738;27;0;0;0;0;.00nan;0;0
975;21522;11;36;28;6;22;.786;3517000;0
975;26623;27;85;49;4;45;.918;3600000;0
976;1251;14;0;0;0;0;.00nan;0;0
976;2058;28;0;0;0;0;.00nan;0;0
976;14061;28;75;44;4;40;.909;3600000;0
976;25584;14;47;41;6;35;.854;3549000;0
977;376;22;28;20;5;15;.750;3600000;0
977;10103;24;97;39;2;37;.949;3600000;0
977;13979;24;0;0;0;0;.00nan;0;0
977;27739;22;0;0;0;0;.00nan;0;0
978;4450;5;0;0;0;0;.00nan;0;0
978;4506;33;22;30;7;23;.767;3600000;0
978;19823;5;100;47;1;46;.979;3600000;0
978;34740;33;0;0;0;0;.00nan;0;0
979;544;19;49;1;0;1;1.000;309000;0
979;5385;17;0;0;0;0;.00nan;0;0
979;31124;19;35;28;6;22;.786;3213000;0
979;34006;17;94;41;4;37;.902;3600000;0
980;61;31;0;0;0;0;.00nan;0;0
980;1913;30;99;36;1;35;.972;3600000;0
980;4826;30;0;0;0;0;.00nan;0;0
980;34797;31;60;29;3;26;.897;3576000;0
981;738;27;52;26;4;22;.846;2058000;0
981;1614;25;85;25;1;24;.960;3600000;0
981;5182;25;0;0;0;0;.00nan;0;0
981;26623;27;20;19;5;14;.737;1542000;0
982;717;0;63;15;1;14;.933;1189000;0
982;1074;0;16;23;6;17;.739;2411000;0
982;2058;28;80;24;1;23;.958;3600000;0
982;14061;28;0;0;0;0;.00nan;0;0
983;233;29;0;0;0;0;.00nan;0;0
983;18104;10;0;0;0;0;.00nan;0;0
983;18351;29;71;32;4;28;.875;3599000;0
983;27488;10;63;29;3;26;.897;3600000;0
984;445;12;69;28;2;26;.929;3900000;0
984;928;20;83;31;2;29;.935;3900000;0
984;18078;20;0;0;0;0;.00nan;0;0
984;34786;12;0;0;0;0;.00nan;0;0
985;1796;16;0;0;0;0;.00nan;0;0
985;13842;34;0;0;0;0;.00nan;0;0
985;15437;16;80;23;1;22;.957;3600000;0
985;15502;34;58;35;4;31;.886;3600000;0
986;1821;3;27;24;6;18;.750;3522000;0
986;2054;3;0;0;0;0;.00nan;0;0
986;15464;32;0;0;0;0;.00nan;0;0
986;16006;32;67;41;5;36;.878;3600000;0
987;1430;35;0;0;0;0;.00nan;0;0
987;15505;8;0;0;0;0;.00nan;0;0
987;25076;8;90;52;3;49;.942;3896000;0
987;26840;35;76;35;2;33;.943;3896000;0
988;51;21;79;53;6;47;.887;3881000;0
988;823;23;0;0;0;0;.00nan;0;0
988;10274;23;56;41;5;36;.878;3881000;0
988;25843;21;0;0;0;0;.00nan;0;0
989;335;18;0;0;0;0;.00nan;0;0
989;544;19;53;23;3;20;.870;3600000;0
989;5001;18;75;41;5;36;.878;3536000;0
989;31124;19;0;0;0;0;.00nan;0;0
990;2423;15;60;30;3;27;.900;3600000;0
990;4106;15;0;0;0;0;.00nan;0;0
990;22601;26;0;0;0;0;.00nan;0;0
990;32754;26;73;44;5;39;.886;3558000;0
991;724;11;58;19;2;17;.895;3600000;0
991;3626;4182;0;0;0;0;.00nan;0;0
991;21522;11;0;0;0;0;.00nan;0;0
991;25521;4182;41;25;4;21;.840;3543000;0
992;1572;4838;0;0;0;0;.00nan;0;0
992;2328;4838;62;22;2;20;.909;3684000;0
992;20853;9;0;0;0;0;.00nan;0;0
992;28026;9;69;34;3;31;.912;3684000;0
993;928;20;0;0;0;0;.00nan;0;0
993;1251;14;100;31;0;31;1.000;3600000;0
993;18078;20;79;32;2;30;.938;3587000;0
993;25584;14;0;0;0;0;.00nan;0;0
994;376;22;0;0;0;0;.00nan;0;0
994;445;12;0;0;0;0;.00nan;0;0
994;27739;22;58;27;3;24;.889;3900000;0
994;34786;12;92;42;3;39;.929;3900000;0
995;10103;24;0;0;0;0;.00nan;0;0
995;13979;24;81;26;2;24;.923;3825000;0
995;18104;10;94;52;3;49;.942;3825000;0
995;27488;10;0;0;0;0;.00nan;0;0
996;4506;33;17;22;6;16;.727;2077000;0
996;15505;8;100;52;3;49;.942;3600000;0
996;25076;8;0;0;0;0;.00nan;0;0
996;34740;33;32;5;2;3;.600;1523000;0
997;335;18;89;39;3;36;.923;3900000;0
997;5001;18;0;0;0;0;.00nan;0;0
997;5385;17;89;37;3;34;.919;3900000;0
997;34006;17;0;0;0;0;.00nan;0;0
998;738;27;0;0;0;0;.00nan;0;0
998;22601;26;77;40;4;36;.900;3600000;0
998;26623;27;70;30;2;28;.933;3600000;0
998;32754;26;0;0;0;0;.00nan;0;0
999;717;0;0;0;0;0;.00nan;0;0
999;1074;0;66;45;5;40;.889;3543000;0
999;4450;5;48;23;4;19;.826;3600000;0
999;19823;5;0;0;0;0;.00nan;0;0
1000;1430;35;99;33;2;31;.939;3900000;0
1000;3626;4182;80;28;2;26;.929;3900000;0
1000;25521;4182;0;0;0;0;.00nan;0;0
1000;26840;35;0;0;0;0;.00nan;0;0
1001;823;23;0;0;0;0;.00nan;0;0
1001;1614;25;79;22;1;21;.955;3826000;0
1001;5182;25;0;0;0;0;.00nan;0;0
1001;10274;23;92;43;2;41;.953;3826000;0
1002;1913;30;62;44;5;39;.886;3600000;0
1002;4826;30;0;0;0;0;.00nan;0;0
1002;15464;32;0;0;0;0;.00nan;0;0
1002;16006;32;94;36;2;34;.944;3600000;0
1003;1251;14;55;30;4;26;.867;3528000;0
1003;20853;9;0;0;0;0;.00nan;0;0
1003;25584;14;0;0;0;0;.00nan;0;0
1003;28026;9;70;28;2;26;.929;3600000;0
1004;51;21;0;0;0;0;.00nan;0;0
1004;18104;10;0;0;0;0;.00nan;0;0
1004;25843;21;58;33;4;29;.879;3563000;0
1004;27488;10;97;41;2;39;.951;3600000;0
1005;928;20;86;16;0;16;1.000;3600000;0
1005;4450;5;0;0;0;0;.00nan;0;0
1005;18078;20;0;0;0;0;.00nan;0;0
1005;19823;5;91;37;2;35;.946;3534000;0
1006;2423;15;62;30;4;26;.867;3600000;0
1006;4106;15;0;0;0;0;.00nan;0;0
1006;13842;34;0;0;0;0;.00nan;0;0
1006;15502;34;87;29;1;28;.966;3600000;0
1007;376;22;0;0;0;0;.00nan;0;0
1007;1796;16;0;0;0;0;.00nan;0;0
1007;15437;16;68;32;3;29;.906;3600000;0
1007;27739;22;55;37;5;32;.865;3531000;0
1008;233;29;0;0;0;0;.00nan;0;0
1008;10103;24;0;0;0;0;.00nan;0;0
1008;13979;24;82;30;2;28;.933;3590000;0
1008;18351;29;99;25;0;25;1.000;3600000;0
1009;445;12;72;32;3;29;.906;3900000;0
1009;823;23;0;0;0;0;.00nan;0;0
1009;10274;23;73;28;3;25;.893;3900000;0
1009;34786;12;0;0;0;0;.00nan;0;0
1010;3626;4182;0;0;0;0;.00nan;0;0
1010;4506;33;94;28;1;27;.964;3600000;0
1010;25521;4182;74;33;3;30;.909;3592000;0
1010;34740;33;0;0;0;0;.00nan;0;0
1011;544;19;0;0;0;0;.00nan;0;0
1011;738;27;42;18;3;15;.833;1740000;0
1011;26623;27;54;32;4;28;.875;1860000;0
1011;31124;19;54;24;3;21;.875;3600000;0
1012;724;11;0;0;0;0;.00nan;0;0
1012;15464;32;0;0;0;0;.00nan;0;0
1012;16006;32;87;25;1;24;.960;3600000;0
1012;21522;11;36;29;5;24;.828;3600000;0
1013;2423;15;69;31;2;29;.935;3600000;0
1013;4106;15;0;0;0;0;.00nan;0;0
1013;5385;17;0;0;0;0;.00nan;0;0
1013;34006;17;82;44;4;40;.909;3600000;0
1014;51;21;85;38;3;35;.921;3582000;0
1014;1821;3;0;0;0;0;.00nan;0;0
1014;2054;3;73;29;2;27;.931;3600000;0
1014;25843;21;0;0;0;0;.00nan;0;0
1015;335;18;0;0;0;0;.00nan;0;0
1015;1614;25;81;31;2;29;.935;3600000;0
1015;5001;18;85;45;4;41;.911;3539000;0
1015;5182;25;0;0;0;0;.00nan;0;0
1016;1572;4838;74;29;2;27;.931;3600000;0
1016;2328;4838;0;0;0;0;.00nan;0;0
1016;22601;26;0;0;0;0;.00nan;0;0
1016;32754;26;66;38;4;34;.895;3513000;0
1017;1913;30;65;23;1;22;.957;3580000;0
1017;4826;30;0;0;0;0;.00nan;0;0
1017;15505;8;0;0;0;0;.00nan;0;0
1017;25076;8;100;37;0;37;1.000;3600000;0
1018;233;29;0;0;0;0;.00nan;0;0
1018;4450;5;93;43;2;41;.953;3577000;0
1018;18351;29;82;28;1;27;.964;3600000;0
1018;19823;5;0;0;0;0;.00nan;0;0
1019;61;31;43;28;5;23;.821;3600000;0
1019;717;0;26;31;6;25;.806;3600000;0
1019;1074;0;0;0;0;0;.00nan;0;0
1019;34797;31;0;0;0;0;.00nan;0;0
1020;928;20;95;33;1;32;.970;3900000;0
1020;2058;28;0;0;0;0;.00nan;0;0
1020;14061;28;92;30;1;29;.967;3900000;0
1020;18078;20;0;0;0;0;.00nan;0;0
1021;445;12;86;27;1;26;.963;3600000;0
1021;10103;24;0;0;0;0;.00nan;0;0
1021;13979;24;66;30;4;26;.867;3600000;0
1021;34786;12;0;0;0;0;.00nan;0;0
1022;1251;14;77;26;2;24;.923;3588000;0
1022;1796;16;0;0;0;0;.00nan;0;0
1022;15437;16;84;27;1;26;.963;3600000;0
1022;25584;14;0;0;0;0;.00nan;0;0
1023;335;18;0;0;0;0;.00nan;0;0
1023;1430;35;0;0;0;0;.00nan;0;0
1023;5001;18;67;25;3;22;.880;3900000;0
1023;26840;35;97;55;3;52;.945;3900000;0
1024;738;27;0;0;0;0;.00nan;0;0
1024;823;23;0;0;0;0;.00nan;0;0
1024;10274;23;54;24;3;21;.875;3600000;0
1024;26623;27;100;37;0;37;1.000;3600000;0
1025;3626;4182;71;31;3;28;.903;3600000;0
1025;15464;32;65;40;6;34;.850;3600000;0
1025;16006;32;0;0;0;0;.00nan;0;0
1025;25521;4182;0;0;0;0;.00nan;0;0
1026;724;11;0;0;0;0;.00nan;0;0
1026;15505;8;0;0;0;0;.00nan;0;0
1026;21522;11;100;28;0;28;1.000;3600000;0
1026;25076;8;89;49;4;45;.918;3600000;0
1027;376;22;0;0;0;0;.00nan;0;0
1027;5385;17;91;37;2;35;.946;3600000;0
1027;27739;22;77;43;4;39;.907;3559000;0
1027;34006;17;0;0;0;0;.00nan;0;0
1028;2423;15;80;35;2;33;.943;3600000;0
1028;4106;15;0;0;0;0;.00nan;0;0
1028;18104;10;0;0;0;0;.00nan;0;0
1028;27488;10;69;33;4;29;.879;3598000;0
1029;4506;33;0;0;0;0;.00nan;0;0
1029;13842;34;0;0;0;0;.00nan;0;0
1029;15502;34;85;46;4;42;.913;3753000;0
1029;34740;33;70;31;3;28;.903;3731000;0
1030;1251;14;0;0;0;0;.00nan;0;0
1030;1614;25;71;21;1;20;.952;3600000;0
1030;5182;25;0;0;0;0;.00nan;0;0
1030;25584;14;76;40;4;36;.900;3600000;0
1031;544;19;0;0;0;0;.00nan;0;0
1031;22601;26;0;0;0;0;.00nan;0;0
1031;31124;19;70;31;3;28;.903;3600000;0
1031;32754;26;69;31;4;27;.871;3600000;0
1032;1572;4838;68;26;3;23;.885;3900000;0
1032;1913;30;81;37;3;34;.919;3888000;0
1032;2328;4838;0;0;0;0;.00nan;0;0
1032;4826;30;0;0;0;0;.00nan;0;0
1033;928;20;0;0;0;0;.00nan;0;0
1033;4450;5;0;0;0;0;.00nan;0;0
1033;18078;20;70;27;2;25;.926;3900000;0
1033;19823;5;89;33;2;31;.939;3900000;0
1034;717;0;0;0;0;0;.00nan;0;0
1034;1074;0;70;48;5;43;.896;3874000;0
1034;1821;3;0;0;0;0;.00nan;0;0
1034;2054;3;60;33;4;29;.879;3874000;0
1035;61;31;70;33;4;29;.879;3600000;0
1035;2058;28;45;31;5;26;.839;3555000;0
1035;14061;28;0;0;0;0;.00nan;0;0
1035;34797;31;0;0;0;0;.00nan;0;0
1036;233;29;0;0;0;0;.00nan;0;0
1036;18351;29;61;26;3;23;.885;3600000;0
1036;20853;9;0;0;0;0;.00nan;0;0
1036;28026;9;54;37;6;31;.838;3600000;0
1037;51;21;0;0;0;0;.00nan;0;0
1037;376;22;74;37;3;34;.919;3600000;0
1037;25843;21;82;17;0;17;1.000;3600000;0
1037;27739;22;0;0;0;0;.00nan;0;0
1038;1796;16;0;0;0;0;.00nan;0;0
1038;10103;24;0;0;0;0;.00nan;0;0
1038;13979;24;79;33;3;30;.909;3596000;0
1038;15437;16;86;28;1;27;.964;3600000;0
1039;335;18;0;0;0;0;.00nan;0;0
1039;445;12;58;19;2;17;.895;3554000;0
1039;5001;18;100;38;1;37;.974;3600000;0
1039;34786;12;0;0;0;0;.00nan;0;0
1040;1430;35;93;33;2;31;.939;3600000;0
1040;13842;34;51;34;6;28;.824;3600000;0
1040;15502;34;0;0;0;0;.00nan;0;0
1040;26840;35;0;0;0;0;.00nan;0;0
1041;544;19;80;21;1;20;.952;3600000;0
1041;823;23;0;0;0;0;.00nan;0;0
1041;10274;23;74;39;3;36;.923;3584000;0
1041;31124;19;0;0;0;0;.00nan;0;0
1042;3626;4182;74;18;1;17;.944;3600000;0
1042;15505;8;65;36;4;32;.889;3600000;0
1042;25076;8;0;0;0;0;.00nan;0;0
1042;25521;4182;0;0;0;0;.00nan;0;0
1043;724;11;0;0;0;0;.00nan;0;0
1043;1572;4838;0;0;0;0;.00nan;0;0
1043;2328;4838;37;37;7;30;.811;3600000;0
1043;21522;11;74;34;3;31;.912;3600000;0
1044;738;27;0;0;0;0;.00nan;0;0
1044;1913;30;0;0;0;0;.00nan;0;0
1044;4826;30;77;49;5;44;.898;3600000;0
1044;26623;27;61;14;1;13;.929;3600000;0
1045;61;31;52;36;5;31;.861;3600000;0
1045;1821;3;64;20;2;18;.900;3600000;0
1045;2054;3;0;0;0;0;.00nan;0;0
1045;34797;31;0;0;0;0;.00nan;0;0
1046;51;21;0;0;0;0;.00nan;0;0
1046;717;0;94;42;3;39;.929;3565000;0
1046;1074;0;0;0;0;0;.00nan;0;0
1046;25843;21;68;20;1;19;.950;3600000;0
1047;233;29;53;21;3;18;.857;3550000;0
1047;928;20;79;29;2;27;.931;3600000;0
1047;18078;20;0;0;0;0;.00nan;0;0
1047;18351;29;0;0;0;0;.00nan;0;0
1048;5385;17;54;36;6;30;.833;3555000;0
1048;18104;10;0;0;0;0;.00nan;0;0
1048;27488;10;73;32;3;29;.906;3600000;0
1048;34006;17;0;0;0;0;.00nan;0;0
1049;2423;15;72;32;3;29;.906;3600000;0
1049;4106;15;0;0;0;0;.00nan;0;0
1049;20853;9;46;39;5;34;.872;3584000;0
1049;28026;9;0;0;0;0;.00nan;0;0
1050;1251;14;0;0;0;0;.00nan;0;0
1050;15464;32;100;37;1;36;.973;3600000;0
1050;16006;32;0;0;0;0;.00nan;0;0
1050;25584;14;68;21;2;19;.905;3541000;0
1051;1430;35;0;0;0;0;.00nan;0;0
1051;1614;25;54;37;5;32;.865;3300000;0
1051;5182;25;50;3;0;3;1.000;300000;0
1051;26840;35;100;41;1;40;.976;3600000;0
1052;4506;33;51;32;4;28;.875;3900000;0
1052;22601;26;0;0;0;0;.00nan;0;0
1052;32754;26;94;54;4;50;.926;3900000;0
1052;34740;33;0;0;0;0;.00nan;0;0
1053;376;22;0;0;0;0;.00nan;0;0
1053;10103;24;0;0;0;0;.00nan;0;0
1053;13979;24;61;40;4;36;.900;3543000;0
1053;27739;22;73;27;2;25;.926;3600000;0
1054;5385;17;0;0;0;0;.00nan;0;0
1054;15505;8;71;35;3;32;.914;3600000;0
1054;25076;8;0;0;0;0;.00nan;0;0
1054;34006;17;57;34;5;29;.853;3529000;0
1055;335;18;0;0;0;0;.00nan;0;0
1055;1796;16;0;0;0;0;.00nan;0;0
1055;5001;18;81;24;1;23;.958;3600000;0
1055;15437;16;79;30;3;27;.900;3539000;0
1056;823;23;0;0;0;0;.00nan;0;0
1056;10274;23;87;37;1;36;.973;3600000;0
1056;22601;26;74;45;5;40;.889;3600000;0
1056;32754;26;0;0;0;0;.00nan;0;0
1057;724;11;0;0;0;0;.00nan;0;0
1057;1572;4838;81;51;5;46;.902;3600000;0
1057;2328;4838;0;0;0;0;.00nan;0;0
1057;21522;11;24;30;7;23;.767;3567000;0
1058;1821;3;71;30;2;28;.933;3539000;0
1058;2054;3;0;0;0;0;.00nan;0;0
1058;4450;5;0;0;0;0;.00nan;0;0
1058;19823;5;90;37;1;36;.973;3600000;0
1059;233;29;0;0;0;0;.00nan;0;0
1059;10103;24;0;0;0;0;.00nan;0;0
1059;13979;24;69;26;2;24;.923;3900000;0
1059;18351;29;76;35;2;33;.943;3900000;0
1060;61;31;94;30;1;29;.967;3600000;0
1060;717;0;0;0;0;0;.00nan;0;0
1060;1074;0;71;33;2;31;.939;3545000;0
1060;34797;31;0;0;0;0;.00nan;0;0
1061;2423;15;96;40;1;39;.975;3600000;0
1061;4106;15;0;0;0;0;.00nan;0;0
1061;18104;10;0;0;0;0;.00nan;0;0
1061;27488;10;94;39;2;37;.949;3578000;0
1062;928;20;90;41;3;38;.927;3563000;0
1062;13842;34;0;0;0;0;.00nan;0;0
1062;15502;34;69;25;2;23;.920;3600000;0
1062;18078;20;0;0;0;0;.00nan;0;0
1063;2058;28;54;42;5;37;.881;3600000;0
1063;14061;28;0;0;0;0;.00nan;0;0
1063;15464;32;88;31;1;30;.968;3600000;0
1063;16006;32;0;0;0;0;.00nan;0;0
1064;1251;14;0;0;0;0;.00nan;0;0
1064;1430;35;69;21;1;20;.952;3600000;0
1064;25584;14;72;31;2;29;.935;3578000;0
1064;26840;35;0;0;0;0;.00nan;0;0
1065;544;19;0;0;0;0;.00nan;0;0
1065;1614;25;68;29;3;26;.897;3600000;0
1065;5182;25;0;0;0;0;.00nan;0;0
1065;31124;19;83;45;4;41;.911;3577000;0
1066;445;12;39;34;6;28;.824;3147000;0
1066;1913;30;91;36;2;34;.944;3600000;0
1066;4826;30;0;0;0;0;.00nan;0;0
1066;34786;12;59;6;0;6;1.000;453000;0
1067;4506;33;81;21;1;20;.952;3600000;0
1067;5385;17;0;0;0;0;.00nan;0;0
1067;34006;17;78;40;3;37;.925;3562000;0
1067;34740;33;0;0;0;0;.00nan;0;0
1068;18104;10;71;27;2;25;.926;3600000;0
1068;20853;9;0;0;0;0;.00nan;0;0
1068;27488;10;0;0;0;0;.00nan;0;0
1068;28026;9;69;51;6;45;.882;3600000;0
1069;724;11;0;0;0;0;.00nan;0;0
1069;823;23;0;0;0;0;.00nan;0;0
1069;10274;23;82;23;1;22;.957;3600000;0
1069;21522;11;42;38;6;32;.842;3600000;0
1070;335;18;0;0;0;0;.00nan;0;0
1070;1796;16;0;0;0;0;.00nan;0;0
1070;5001;18;80;38;3;35;.921;3600000;0
1070;15437;16;77;40;4;36;.900;3566000;0
1071;738;27;0;0;0;0;.00nan;0;0
1071;22601;26;93;29;1;28;.966;3600000;0
1071;26623;27;94;37;2;35;.946;3560000;0
1071;32754;26;0;0;0;0;.00nan;0;0
1072;500;4182;52;24;3;21;.875;3589000;0
1072;1572;4838;0;0;0;0;.00nan;0;0
1072;2328;4838;97;45;2;43;.956;3600000;0
1072;25521;4182;0;0;0;0;.00nan;0;0
1073;51;21;0;0;0;0;.00nan;0;0
1073;4450;5;0;0;0;0;.00nan;0;0
1073;19823;5;84;29;1;28;.966;3600000;0
1073;25843;21;58;25;3;22;.880;3516000;0
1074;1821;3;75;38;3;35;.921;2747000;0
1074;2054;3;24;11;4;7;.636;853000;0
1074;4506;33;0;0;0;0;.00nan;0;0
1074;34740;33;46;29;4;25;.862;3600000;0
1075;61;31;0;0;0;0;.00nan;0;0
1075;15505;8;0;0;0;0;.00nan;0;0
1075;25076;8;100;39;1;38;.974;3600000;0
1075;34797;31;79;31;2;29;.935;3584000;0
1076;928;20;95;34;2;32;.941;3600000;0
1076;13842;34;0;0;0;0;.00nan;0;0
1076;15502;34;64;37;4;33;.892;3521000;0
1076;18078;20;0;0;0;0;.00nan;0;0
1077;717;0;0;0;0;0;.00nan;0;0
1077;1074;0;66;44;5;39;.886;3600000;0
1077;10103;24;67;30;3;27;.900;3600000;0
1077;13979;24;0;0;0;0;.00nan;0;0
1078;1430;35;0;0;0;0;.00nan;0;0
1078;2423;15;55;46;6;40;.870;3600000;0
1078;4106;15;0;0;0;0;.00nan;0;0
1078;26840;35;78;28;2;26;.929;3600000;0
1079;738;27;0;0;0;0;.00nan;0;0
1079;1614;25;0;0;0;0;.00nan;0;0
1079;5182;25;55;29;4;25;.862;3600000;0
1079;26623;27;60;51;6;45;.882;3549000;0
1080;544;19;0;0;0;0;.00nan;0;0
1080;724;11;76;40;4;36;.900;3586000;0
1080;21522;11;0;0;0;0;.00nan;0;0
1080;31124;19;58;16;2;14;.875;3600000;0
1081;445;12;75;20;1;19;.950;3600000;0
1081;1913;30;74;33;3;30;.909;3565000;0
1081;4826;30;0;0;0;0;.00nan;0;0
1081;34786;12;0;0;0;0;.00nan;0;0
1082;5385;17;0;0;0;0;.00nan;0;0
1082;15464;32;94;39;2;37;.949;3600000;0
1082;16006;32;0;0;0;0;.00nan;0;0
1082;34006;17;63;31;4;27;.871;3592000;0
1083;2058;28;93;28;2;26;.929;3900000;0
1083;14061;28;0;0;0;0;.00nan;0;0
1083;20853;9;0;0;0;0;.00nan;0;0
1083;28026;9;97;39;2;37;.949;3900000;0
1084;233;29;0;0;0;0;.00nan;0;0
1084;15505;8;59;45;6;39;.867;3600000;0
1084;18351;29;25;30;7;23;.767;3566000;0
1084;25076;8;0;0;0;0;.00nan;0;0
1085;928;20;0;0;0;0;.00nan;0;0
1085;18078;20;75;33;4;29;.879;3660000;0
1085;18104;10;0;0;0;0;.00nan;0;0
1085;27488;10;50;22;3;19;.864;3660000;0
1086;823;23;66;32;4;28;.875;3588000;0
1086;1796;16;0;0;0;0;.00nan;0;0
1086;10274;23;0;0;0;0;.00nan;0;0
1086;15437;16;86;32;2;30;.938;3600000;0
1087;1913;30;96;50;4;46;.920;3600000;0
1087;4826;30;0;0;0;0;.00nan;0;0
1087;22601;26;0;0;0;0;.00nan;0;0
1087;32754;26;100;30;0;30;1.000;3600000;0
1088;500;4182;83;20;1;19;.950;3600000;0
1088;1572;4838;0;0;0;0;.00nan;0;0
1088;2328;4838;84;50;4;46;.920;3600000;0
1088;25521;4182;0;0;0;0;.00nan;0;0
1089;4450;5;0;0;0;0;.00nan;0;0
1089;13842;34;0;0;0;0;.00nan;0;0
1089;15502;34;74;37;4;33;.892;3900000;0
1089;19823;5;55;26;4;22;.846;3900000;0
1090;233;29;0;0;0;0;.00nan;0;0
1090;717;0;89;40;3;37;.925;3600000;0
1090;1074;0;0;0;0;0;.00nan;0;0
1090;18351;29;68;43;4;39;.907;3564000;0
1091;51;21;66;28;3;25;.893;3600000;0
1091;61;31;74;42;5;37;.881;3536000;0
1091;25843;21;0;0;0;0;.00nan;0;0
1091;34797;31;0;0;0;0;.00nan;0;0
1092;1251;14;68;43;5;38;.884;3814000;0
1092;1821;3;51;24;4;20;.833;3814000;0
1092;2054;3;0;0;0;0;.00nan;0;0
1092;26865;14;0;0;0;0;.00nan;0;0
1093;1430;35;0;0;0;0;.00nan;0;0
1093;10103;24;0;0;0;0;.00nan;0;0
1093;13979;24;96;40;2;38;.950;3900000;0
1093;26840;35;96;30;2;28;.933;3900000;0
1094;376;22;80;29;2;27;.931;3558000;0
1094;15464;32;82;29;1;28;.966;3600000;0
1094;16006;32;0;0;0;0;.00nan;0;0
1094;27739;22;0;0;0;0;.00nan;0;0
1095;724;11;0;0;0;0;.00nan;0;0
1095;4506;33;76;25;2;23;.920;3900000;0
1095;21522;11;84;37;2;35;.946;3900000;0
1095;34740;33;0;0;0;0;.00nan;0;0
1096;1614;25;37;33;6;27;.818;3566000;0
1096;2423;15;26;5;3;2;.400;210000;0
1096;4106;15;100;48;2;46;.958;3390000;0
1096;5182;25;0;0;0;0;.00nan;0;0
1097;544;19;0;0;0;0;.00nan;0;0
1097;1796;16;79;32;2;30;.938;3900000;0
1097;15437;16;0;0;0;0;.00nan;0;0
1097;31124;19;78;34;2;32;.941;3889000;0
1098;445;12;0;0;0;0;.00nan;0;0
1098;738;27;99;42;2;40;.952;3600000;0
1098;26623;27;0;0;0;0;.00nan;0;0
1098;34786;12;49;32;5;27;.844;3600000;0
1099;61;31;0;0;0;0;.00nan;0;0
1099;5385;17;0;0;0;0;.00nan;0;0
1099;34006;17;86;40;3;37;.925;3900000;0
1099;34797;31;72;32;3;29;.906;3900000;0
1100;2058;28;0;0;0;0;.00nan;0;0
1100;14061;28;73;20;1;19;.950;3600000;0
1100;20853;9;0;0;0;0;.00nan;0;0
1100;28026;9;98;48;2;46;.958;3543000;0
1101;51;21;0;0;0;0;.00nan;0;0
1101;928;20;73;30;2;28;.933;3600000;0
1101;18078;20;0;0;0;0;.00nan;0;0
1101;25843;21;64;36;4;32;.889;3575000;0
1102;1251;14;0;0;0;0;.00nan;0;0
1102;18104;10;0;0;0;0;.00nan;0;0
1102;26865;14;73;44;4;40;.909;3600000;0
1102;27488;10;99;35;1;34;.971;3600000;0
1103;376;22;0;0;0;0;.00nan;0;0
1103;1430;35;61;46;6;40;.870;3600000;0
1103;26840;35;0;0;0;0;.00nan;0;0
1103;27739;22;55;30;4;26;.867;3600000;0
1104;15505;8;59;33;4;29;.879;3585000;0
1104;22601;26;0;0;0;0;.00nan;0;0
1104;25076;8;0;0;0;0;.00nan;0;0
1104;32754;26;68;24;2;22;.917;3600000;0
1105;335;18;53;3;0;3;1.000;290000;0
1105;500;4182;81;30;2;28;.933;3600000;0
1105;5001;18;63;44;6;38;.864;3310000;0
1105;25521;4182;0;0;0;0;.00nan;0;0
1106;823;23;0;0;0;0;.00nan;0;0
1106;1913;30;100;46;1;45;.978;3600000;0
1106;4826;30;0;0;0;0;.00nan;0;0
1106;10274;23;52;28;4;24;.857;3600000;0
1107;445;12;100;44;3;41;.932;3900000;0
1107;1572;4838;0;0;0;0;.00nan;0;0
1107;2328;4838;95;53;3;50;.943;3884000;0
1107;34786;12;0;0;0;0;.00nan;0;0
1108;233;29;0;0;0;0;.00nan;0;0
1108;1821;3;70;35;3;32;.914;3583000;0
1108;2054;3;0;0;0;0;.00nan;0;0
1108;18351;29;99;30;1;29;.967;3600000;0
1109;4450;5;0;0;0;0;.00nan;0;0
1109;13842;34;0;0;0;0;.00nan;0;0
1109;15502;34;64;40;4;36;.900;3563000;0
1109;19823;5;76;28;2;26;.929;3600000;0
1110;1796;16;0;0;0;0;.00nan;0;0
1110;15437;16;76;24;1;23;.958;3600000;0
1110;22601;26;76;36;2;34;.944;3600000;0
1110;32754;26;0;0;0;0;.00nan;0;0
1111;544;19;0;0;0;0;.00nan;0;0
1111;724;11;0;0;0;0;.00nan;0;0
1111;21522;11;94;44;2;42;.955;3600000;0
1111;31124;19;55;24;3;21;.875;3541000;0
1112;5385;17;54;27;4;23;.852;3594000;0
1112;10103;24;0;0;0;0;.00nan;0;0
1112;13979;24;86;34;2;32;.941;3600000;0
1112;34006;17;0;0;0;0;.00nan;0;0
1113;717;0;81;56;5;51;.911;3600000;0
1113;1074;0;0;0;0;0;.00nan;0;0
1113;2058;28;83;13;0;13;1.000;3600000;0
1113;14061;28;0;0;0;0;.00nan;0;0
1114;4450;5;0;0;0;0;.00nan;0;0
1114;19823;5;55;22;3;19;.864;3685000;0
1114;20853;9;0;0;0;0;.00nan;0;0
1114;28026;9;61;20;2;18;.900;3685000;0
1115;61;31;57;40;6;34;.850;3600000;0
1115;1821;3;8;17;6;11;.647;2279000;0
1115;2054;3;48;5;1;4;.800;1280000;0
1115;34797;31;0;0;0;0;.00nan;0;0
1116;51;21;0;0;0;0;.00nan;0;0
1116;18104;10;0;0;0;0;.00nan;0;0
1116;25843;21;69;19;1;18;.947;3600000;0
1116;27488;10;82;37;2;35;.946;3543000;0
1117;1251;14;0;0;0;0;.00nan;0;0
1117;13842;34;85;51;3;48;.941;3644000;0
1117;15502;34;0;0;0;0;.00nan;0;0
1117;26865;14;57;19;2;17;.895;3644000;0
1118;1614;25;62;36;4;32;.889;3600000;0
1118;2423;15;0;0;0;0;.00nan;0;0
1118;4106;15;55;37;5;32;.865;3543000;0
1118;5182;25;0;0;0;0;.00nan;0;0
1119;1430;35;0;0;0;0;.00nan;0;0
1119;15464;32;76;24;1;23;.958;3900000;0
1119;16006;32;0;0;0;0;.00nan;0;0
1119;26840;35;93;29;1;28;.966;3900000;0
1120;445;12;0;0;0;0;.00nan;0;0
1120;928;20;66;34;3;31;.912;3591000;0
1120;18078;20;0;0;0;0;.00nan;0;0
1120;34786;12;73;26;2;24;.923;3600000;0
1121;738;27;0;0;0;0;.00nan;0;0
1121;823;23;0;0;0;0;.00nan;0;0
1121;10274;23;76;41;4;37;.902;3600000;0
1121;26623;27;81;34;2;32;.941;3600000;0
1122;233;29;0;0;0;0;.00nan;0;0
1122;376;22;0;0;0;0;.00nan;0;0
1122;18351;29;75;34;3;31;.912;3600000;0
1122;27739;22;64;38;5;33;.868;3514000;0
1123;1572;4838;65;29;3;26;.897;3600000;0
1123;1796;16;0;0;0;0;.00nan;0;0
1123;2328;4838;0;0;0;0;.00nan;0;0
1123;15437;16;56;29;4;25;.862;3600000;0
1124;4506;33;63;26;3;23;.885;3785000;0
1124;20853;9;94;43;2;41;.953;3785000;0
1124;28026;9;0;0;0;0;.00nan;0;0
1124;34740;33;0;0;0;0;.00nan;0;0
1125;544;19;0;0;0;0;.00nan;0;0
1125;1913;30;22;5;3;2;.400;257000;0
1125;4826;30;76;29;2;27;.931;3305000;0
1125;31124;19;60;26;3;23;.885;3600000;0
1126;335;18;0;0;0;0;.00nan;0;0
1126;500;4182;78;19;1;18;.947;3600000;0
1126;5001;18;67;45;5;40;.889;3600000;0
1126;25521;4182;0;0;0;0;.00nan;0;0
1127;51;21;0;0;0;0;.00nan;0;0
1127;2058;28;83;31;1;30;.968;3600000;0
1127;14061;28;0;0;0;0;.00nan;0;0
1127;25843;21;66;34;4;30;.882;3600000;0
1128;2423;15;22;9;4;5;.556;621000;0
1128;4106;15;83;27;1;26;.963;2979000;0
1128;18104;10;0;0;0;0;.00nan;0;0
1128;27488;10;61;22;2;20;.909;3600000;0
1129;5385;17;0;0;0;0;.00nan;0;0
1129;10103;24;0;0;0;0;.00nan;0;0
1129;13979;24;41;34;6;28;.824;3600000;0
1129;34006;17;73;34;3;31;.912;3600000;0
1130;1251;14;47;24;4;20;.833;3544000;0
1130;13842;34;0;0;0;0;.00nan;0;0
1130;15502;34;72;28;3;25;.893;3600000;0
1130;25584;14;0;0;0;0;.00nan;0;0
1131;1572;4838;0;0;0;0;.00nan;0;0
1131;2328;4838;66;25;2;23;.920;3900000;0
1131;15505;8;0;0;0;0;.00nan;0;0
1131;25076;8;96;42;2;40;.952;3900000;0
1132;445;12;48;35;5;30;.857;3600000;0
1132;1821;3;92;39;2;37;.949;3600000;0
1132;2054;3;0;0;0;0;.00nan;0;0
1132;34786;12;0;0;0;0;.00nan;0;0
1133;335;18;0;0;0;0;.00nan;0;0
1133;5001;18;71;27;3;24;.889;3600000;0
1133;22601;26;0;0;0;0;.00nan;0;0
1133;32754;26;62;44;5;39;.886;3513000;0
1134;724;11;0;0;0;0;.00nan;0;0
1134;823;23;0;0;0;0;.00nan;0;0
1134;10274;23;99;33;1;32;.970;3600000;0
1134;21522;11;66;24;2;22;.917;3574000;0
1135;544;19;62;28;3;25;.893;3544000;0
1135;738;27;0;0;0;0;.00nan;0;0
1135;26623;27;84;33;2;31;.939;3600000;0
1135;31124;19;0;0;0;0;.00nan;0;0
1136;233;29;0;0;0;0;.00nan;0;0
1136;4450;5;0;0;0;0;.00nan;0;0
1136;18351;29;71;25;2;23;.920;3900000;0
1136;19823;5;63;20;2;18;.900;3900000;0
1137;61;31;67;38;4;34;.895;3600000;0
1137;5385;17;87;30;1;29;.967;3600000;0
1137;34006;17;0;0;0;0;.00nan;0;0
1137;34797;31;0;0;0;0;.00nan;0;0
1138;928;20;87;16;0;16;1.000;3600000;0
1138;10103;24;59;39;4;35;.897;3600000;0
1138;13979;24;0;0;0;0;.00nan;0;0
1138;18078;20;0;0;0;0;.00nan;0;0
1139;1430;35;0;0;0;0;.00nan;0;0
1139;1796;16;0;0;0;0;.00nan;0;0
1139;15437;16;98;39;2;37;.949;3600000;0
1139;26840;35;99;40;1;39;.975;3600000;0
1140;1614;25;79;31;1;30;.968;3900000;0
1140;4506;33;98;29;1;28;.966;3900000;0
1140;5182;25;0;0;0;0;.00nan;0;0
1140;34740;33;0;0;0;0;.00nan;0;0
1141;717;0;56;27;3;24;.889;3600000;0
1141;1074;0;0;0;0;0;.00nan;0;0
1141;1821;3;0;0;0;0;.00nan;0;0
1141;2054;3;67;43;5;38;.884;3567000;0
1142;13842;34;0;0;0;0;.00nan;0;0
1142;15502;34;93;43;3;40;.930;3600000;0
1142;20853;9;57;5;0;5;1.000;456000;0
1142;28026;9;45;30;6;24;.800;3144000;0
1143;2058;28;66;36;4;32;.889;3600000;0
1143;14061;28;0;0;0;0;.00nan;0;0
1143;18104;10;0;0;0;0;.00nan;0;0
1143;27488;10;41;37;6;31;.838;3528000;0
1144;1251;14;66;11;0;11;1.000;1660000;0
1144;1913;30;93;48;3;45;.938;3600000;0
1144;4826;30;0;0;0;0;.00nan;0;0
1144;25584;14;12;18;6;12;.667;1940000;0
1145;376;22;0;0;0;0;.00nan;0;0
1145;2423;15;83;37;3;34;.919;3600000;0
1145;4106;15;0;0;0;0;.00nan;0;0
1145;27739;22;41;21;4;17;.810;3556000;0
1146;928;20;97;51;4;47;.922;3600000;0
1146;1796;16;56;17;2;15;.882;3600000;0
1146;15437;16;0;0;0;0;.00nan;0;0
1146;18078;20;0;0;0;0;.00nan;0;0
1147;61;31;0;0;0;0;.00nan;0;0
1147;15464;32;89;43;3;40;.930;3600000;0
1147;16006;32;0;0;0;0;.00nan;0;0
1147;34797;31;68;37;4;33;.892;3555000;0
1148;51;21;0;0;0;0;.00nan;0;0
1148;445;12;53;17;3;14;.824;3900000;0
1148;25843;21;78;35;3;32;.914;3900000;0
1148;34786;12;0;0;0;0;.00nan;0;0
1149;724;11;99;33;1;32;.970;3600000;0
1149;1430;35;63;33;4;29;.879;3600000;0
1149;21522;11;0;0;0;0;.00nan;0;0
1149;26840;35;0;0;0;0;.00nan;0;0
1150;823;23;0;0;0;0;.00nan;0;0
1150;1614;25;0;0;0;0;.00nan;0;0
1150;5182;25;69;29;2;27;.931;3600000;0
1150;10274;23;80;49;4;45;.918;3585000;0
1151;335;18;56;14;1;13;.929;1258000;0
1151;738;27;52;21;3;18;.857;3600000;0
1151;5001;18;57;32;5;27;.844;2342000;0
1151;26623;27;0;0;0;0;.00nan;0;0
1152;500;4182;77;23;1;22;.957;3600000;0
1152;22601;26;0;0;0;0;.00nan;0;0
1152;25521;4182;0;0;0;0;.00nan;0;0
1152;32754;26;89;47;3;44;.936;3535000;0
1153;544;19;0;0;0;0;.00nan;0;0
1153;1572;4838;0;0;0;0;.00nan;0;0
1153;2328;4838;66;33;3;30;.909;3534000;0
1153;31124;19;85;28;1;27;.964;3600000;0
1154;2058;28;0;0;0;0;.00nan;0;0
1154;4506;33;63;25;2;23;.920;3900000;0
1154;14061;28;99;44;2;42;.955;3900000;0
1154;34740;33;0;0;0;0;.00nan;0;0
1155;233;29;0;0;0;0;.00nan;0;0
1155;5385;17;0;0;0;0;.00nan;0;0
1155;18351;29;95;39;2;37;.949;3600000;0
1155;34006;17;62;41;5;36;.878;3600000;0
1156;2423;15;65;18;1;17;.944;3900000;0
1156;4106;15;0;0;0;0;.00nan;0;0
1156;15464;32;100;39;1;38;.974;3900000;0
1156;16006;32;0;0;0;0;.00nan;0;0
1157;376;22;100;30;0;30;1.000;3900000;0
1157;4450;5;0;0;0;0;.00nan;0;0
1157;19823;5;95;43;0;43;1.000;3900000;0
1157;27739;22;0;0;0;0;.00nan;0;0
1158;1913;30;0;0;0;0;.00nan;0;0
1158;4826;30;60;40;5;35;.875;3582000;0
1158;10103;24;0;0;0;0;.00nan;0;0
1158;13979;24;99;39;3;36;.923;3600000;0
1159;445;12;0;0;0;0;.00nan;0;0
1159;15505;8;98;36;1;35;.972;3600000;0
1159;25076;8;0;0;0;0;.00nan;0;0
1159;34786;12;60;30;4;26;.867;3600000;0
1160;500;4182;37;25;5;20;.800;3557000;0
1160;738;27;0;0;0;0;.00nan;0;0
1160;25521;4182;0;0;0;0;.00nan;0;0
1160;26623;27;46;29;4;25;.862;3600000;0
1161;717;0;100;48;1;47;.979;3600000;0
1161;1074;0;0;0;0;0;.00nan;0;0
1161;4506;33;0;0;0;0;.00nan;0;0
1161;34740;33;50;25;4;21;.840;3600000;0
1162;823;23;0;0;0;0;.00nan;0;0
1162;1430;35;0;0;0;0;.00nan;0;0
1162;10274;23;79;46;4;42;.913;3537000;0
1162;26840;35;88;36;2;34;.944;3600000;0
1163;1796;16;50;21;3;18;.857;3543000;0
1163;4450;5;0;0;0;0;.00nan;0;0
1163;15437;16;0;0;0;0;.00nan;0;0
1163;19823;5;66;22;2;20;.909;3600000;0
1164;1821;3;53;7;1;6;.857;1261000;0
1164;2054;3;45;31;6;25;.806;2339000;0
1164;5385;17;66;37;4;33;.892;3600000;0
1164;34006;17;0;0;0;0;.00nan;0;0
1165;2058;28;100;34;1;33;.971;3640000;0
1165;14061;28;0;0;0;0;.00nan;0;0
1165;20853;9;0;0;0;0;.00nan;0;0
1165;28026;9;66;21;2;19;.905;3640000;0
1166;61;31;82;37;1;36;.973;3900000;0
1166;1913;30;98;49;1;48;.980;3900000;0
1166;4826;30;0;0;0;0;.00nan;0;0
1166;34797;31;0;0;0;0;.00nan;0;0
1167;10103;24;0;0;0;0;.00nan;0;0
1167;13979;24;85;29;1;28;.966;3900000;0
1167;18104;10;0;0;0;0;.00nan;0;0
1167;27488;10;100;38;1;37;.974;3900000;0
1168;2423;15;37;30;5;25;.833;3600000;0
1168;4106;15;0;0;0;0;.00nan;0;0
1168;13842;34;0;0;0;0;.00nan;0;0
1168;15502;34;91;31;1;30;.968;3600000;0
1169;376;22;70;33;3;30;.909;3600000;0
1169;1251;14;65;28;4;24;.857;3562000;0
1169;25584;14;0;0;0;0;.00nan;0;0
1169;27739;22;0;0;0;0;.00nan;0;0
1170;738;27;0;0;0;0;.00nan;0;0
1170;15505;8;77;27;2;25;.926;3600000;0
1170;25076;8;0;0;0;0;.00nan;0;0
1170;26623;27;67;33;4;29;.879;3561000;0
1171;823;23;0;0;0;0;.00nan;0;0
1171;10274;23;92;32;1;31;.969;3600000;0
1171;15464;32;67;26;2;24;.923;3600000;0
1171;16006;32;0;0;0;0;.00nan;0;0
1172;233;29;0;0;0;0;.00nan;0;0
1172;445;12;54;36;5;31;.861;3556000;0
1172;18351;29;81;41;3;38;.927;3600000;0
1172;34786;12;0;0;0;0;.00nan;0;0
1173;544;19;0;0;0;0;.00nan;0;0
1173;1572;4838;26;12;4;8;.667;1138000;0
1173;2328;4838;64;32;3;29;.906;2462000;0
1173;31124;19;70;20;1;19;.950;3600000;0
1174;335;18;57;13;1;12;.923;1274000;0
1174;500;4182;72;18;1;17;.944;3600000;0
1174;5001;18;40;26;5;21;.808;2326000;0
1174;25521;4182;0;0;0;0;.00nan;0;0
1175;51;21;0;0;0;0;.00nan;0;0
1175;22601;26;0;0;0;0;.00nan;0;0
1175;25843;21;64;33;3;30;.909;3600000;0
1175;32754;26;47;28;4;24;.857;3575000;0
1176;1251;14;0;0;0;0;.00nan;0;0
1176;18104;10;61;26;3;23;.885;3552000;0
1176;25584;14;71;31;2;29;.935;3600000;0
1176;27488;10;0;0;0;0;.00nan;0;0
1177;717;0;89;48;3;45;.938;3563000;0
1177;1074;0;0;0;0;0;.00nan;0;0
1177;13842;34;65;28;2;26;.929;3600000;0
1177;15502;34;0;0;0;0;.00nan;0;0
1178;1572;4838;88;38;2;36;.947;3600000;0
1178;2328;4838;0;0;0;0;.00nan;0;0
1178;4506;33;95;20;0;20;1.000;3600000;0
1178;34740;33;0;0;0;0;.00nan;0;0
1179;724;11;0;0;0;0;.00nan;0;0
1179;1614;25;53;22;3;19;.864;3709000;0
1179;5182;25;0;0;0;0;.00nan;0;0
1179;21522;11;73;38;4;34;.895;3709000;0
1180;2058;28;26;42;9;33;.786;3103000;0
1180;4450;5;0;0;0;0;.00nan;0;0
1180;14061;28;53;2;0;2;1.000;497000;0
1180;19823;5;67;20;1;19;.950;3600000;0
1181;1796;16;56;34;5;29;.853;3600000;0
1181;5385;17;0;0;0;0;.00nan;0;0
1181;15437;16;0;0;0;0;.00nan;0;0
1181;34006;17;100;30;0;30;1.000;3600000;0
1182;376;22;98;39;2;37;.949;3596000;0
1182;1821;3;100;40;1;39;.975;3600000;0
1182;2054;3;0;0;0;0;.00nan;0;0
1182;27739;22;0;0;0;0;.00nan;0;0
1183;233;29;0;0;0;0;.00nan;0;0
1183;1913;30;64;31;4;27;.871;3600000;0
1183;4826;30;0;0;0;0;.00nan;0;0
1183;18351;29;100;25;0;25;1.000;3600000;0
1184;928;20;40;29;5;24;.828;3600000;0
1184;2423;15;61;26;2;24;.923;3600000;0
1184;4106;15;0;0;0;0;.00nan;0;0
1184;18078;20;0;0;0;0;.00nan;0;0
1185;10103;24;0;0;0;0;.00nan;0;0
1185;13979;24;90;35;1;34;.971;3900000;0
1185;20853;9;0;0;0;0;.00nan;0;0
1185;28026;9;100;40;1;39;.975;3900000;0
1186;724;11;73;28;2;26;.929;3600000;0
1186;15505;8;0;0;0;0;.00nan;0;0
1186;21522;11;0;0;0;0;.00nan;0;0
1186;25076;8;98;49;3;46;.939;3600000;0
1187;738;27;0;0;0;0;.00nan;0;0
1187;15464;32;68;36;4;32;.889;3547000;0
1187;16006;32;0;0;0;0;.00nan;0;0
1187;26623;27;60;29;3;26;.897;3600000;0
1188;445;12;73;32;3;29;.906;3546000;0
1188;1430;35;0;0;0;0;.00nan;0;0
1188;26840;35;58;24;2;22;.917;3600000;0
1188;34786;12;0;0;0;0;.00nan;0;0
1189;51;21;0;0;0;0;.00nan;0;0
1189;1614;25;83;48;4;44;.917;3600000;0
1189;5182;25;0;0;0;0;.00nan;0;0
1189;25843;21;71;26;3;23;.885;3600000;0
1190;500;4182;61;29;3;26;.897;3600000;0
1190;544;19;0;0;0;0;.00nan;0;0
1190;25521;4182;0;0;0;0;.00nan;0;0
1190;31124;19;70;39;4;35;.897;3600000;0
1191;335;18;0;0;0;0;.00nan;0;0
1191;5001;18;71;22;2;20;.909;3600000;0
1191;22601;26;0;0;0;0;.00nan;0;0
1191;32754;26;70;37;4;33;.892;3582000;0
1192;717;0;64;26;3;23;.885;3600000;0
1192;928;20;0;0;0;0;.00nan;0;0
1192;1074;0;0;0;0;0;.00nan;0;0
1192;18078;20;89;48;4;44;.917;3577000;0
1193;61;31;0;0;0;0;.00nan;0;0
1193;4506;33;76;38;5;33;.868;3600000;0
1193;34740;33;0;0;0;0;.00nan;0;0
1193;34797;31;86;28;1;27;.964;3600000;0
1194;500;4182;93;26;0;26;1.000;3600000;0
1194;823;23;43;44;7;37;.841;3096000;0
1194;10274;23;58;5;0;5;1.000;504000;0
1194;25521;4182;0;0;0;0;.00nan;0;0
1195;2423;15;72;31;4;27;.871;3600000;0
1195;4106;15;0;0;0;0;.00nan;0;0
1195;4450;5;0;0;0;0;.00nan;0;0
1195;19823;5;85;27;1;26;.963;3600000;0
1196;1251;14;0;0;0;0;.00nan;0;0
1196;5385;17;0;0;0;0;.00nan;0;0
1196;25584;14;78;30;1;29;.967;3600000;0
1196;34006;17;45;15;3;12;.800;3553000;0
1197;376;22;0;0;0;0;.00nan;0;0
1197;717;0;0;0;0;0;.00nan;0;0
1197;1074;0;89;36;2;34;.944;3600000;0
1197;27739;22;38;19;3;16;.842;3552000;0
1198;1821;3;69;43;6;37;.860;3600000;0
1198;2054;3;0;0;0;0;.00nan;0;0
1198;2058;28;0;0;0;0;.00nan;0;0
1198;14061;28;73;41;3;38;.927;3600000;0
1199;233;29;0;0;0;0;.00nan;0;0
1199;4506;33;97;22;0;22;1.000;3600000;0
1199;18351;29;94;29;1;28;.966;3600000;0
1199;34740;33;0;0;0;0;.00nan;0;0
1200;18104;10;0;0;0;0;.00nan;0;0
1200;20853;9;0;0;0;0;.00nan;0;0
1200;27488;10;91;29;1;28;.966;3600000;0
1200;28026;9;72;38;3;35;.921;3577000;0
1201;1430;35;0;0;0;0;.00nan;0;0
1201;1796;16;0;0;0;0;.00nan;0;0
1201;15437;16;46;11;3;8;.727;3600000;0
1201;26840;35;45;26;4;22;.846;3600000;0
1202;15464;32;71;27;2;25;.926;3900000;0
1202;15505;8;0;0;0;0;.00nan;0;0
1202;16006;32;0;0;0;0;.00nan;0;0
1202;25076;8;81;33;2;31;.939;3889000;0
1203;445;12;0;0;0;0;.00nan;0;0
1203;738;27;89;35;2;33;.943;3600000;0
1203;26623;27;0;0;0;0;.00nan;0;0
1203;34786;12;100;37;0;37;1.000;3600000;0
1204;1614;25;92;38;2;36;.947;3900000;0
1204;5182;25;0;0;0;0;.00nan;0;0
1204;10103;24;0;0;0;0;.00nan;0;0
1204;13979;24;96;41;2;39;.951;3900000;0
1205;544;19;0;0;0;0;.00nan;0;0
1205;22601;26;0;0;0;0;.00nan;0;0
1205;31124;19;82;28;2;26;.929;3600000;0
1205;32754;26;96;43;3;40;.930;3600000;0
1206;335;18;0;0;0;0;.00nan;0;0
1206;823;23;0;0;0;0;.00nan;0;0
1206;5001;18;100;29;0;29;1.000;3600000;0
1206;10274;23;77;27;1;26;.963;3584000;0
1207;724;11;0;0;0;0;.00nan;0;0
1207;13842;34;0;0;0;0;.00nan;0;0
1207;15502;34;55;40;5;35;.875;3600000;0
1207;21522;11;87;36;2;34;.944;3600000;0
1208;51;21;0;0;0;0;.00nan;0;0
1208;1572;4838;0;0;0;0;.00nan;0;0
1208;2328;4838;97;30;1;29;.967;3600000;0
1208;25843;21;79;37;3;34;.919;3515000;0
1209;61;31;0;0;0;0;.00nan;0;0
1209;20853;9;71;44;4;40;.909;3600000;0
1209;28026;9;0;0;0;0;.00nan;0;0
1209;34797;31;54;22;3;19;.864;3600000;0
1210;928;20;71;46;5;41;.891;3600000;0
1210;1821;3;41;32;6;26;.813;3530000;0
1210;2054;3;0;0;0;0;.00nan;0;0
1210;18078;20;0;0;0;0;.00nan;0;0
1211;1251;14;62;28;3;25;.893;3571000;0
1211;5385;17;77;30;2;28;.933;3600000;0
1211;25584;14;0;0;0;0;.00nan;0;0
1211;34006;17;0;0;0;0;.00nan;0;0
1212;1796;16;16;8;4;4;.500;1009000;0
1212;15437;16;19;14;5;9;.643;2591000;0
1212;15464;32;0;0;0;0;.00nan;0;0
1212;16006;32;83;41;3;38;.927;3600000;0
1213;738;27;0;0;0;0;.00nan;0;0
1213;1430;35;65;40;4;36;.900;3569000;0
1213;26623;27;87;41;3;38;.927;3600000;0
1213;26840;35;0;0;0;0;.00nan;0;0
1214;1913;30;100;40;2;38;.950;3600000;0
1214;4826;30;0;0;0;0;.00nan;0;0
1214;13842;34;31;17;4;13;.765;3581000;0
1214;15502;34;0;0;0;0;.00nan;0;0
1215;376;22;0;0;0;0;.00nan;0;0
1215;1614;25;39;22;4;18;.818;3575000;0
1215;5182;25;0;0;0;0;.00nan;0;0
1215;27739;22;58;27;3;24;.889;3600000;0
1216;335;18;0;0;0;0;.00nan;0;0
1216;445;12;0;0;0;0;.00nan;0;0
1216;5001;18;100;35;0;35;1.000;3600000;0
1216;34786;12;69;41;5;36;.878;3600000;0
1217;10103;24;0;0;0;0;.00nan;0;0
1217;13979;24;76;27;2;25;.926;3600000;0
1217;22601;26;83;29;1;28;.966;3600000;0
1217;32754;26;0;0;0;0;.00nan;0;0
1218;51;21;77;27;2;25;.926;3900000;0
1218;500;4182;71;22;2;20;.909;3900000;0
1218;25521;4182;0;0;0;0;.00nan;0;0
1218;25843;21;0;0;0;0;.00nan;0;0
1219;1251;14;21;26;6;20;.769;2424000;0
1219;1821;3;0;0;0;0;.00nan;0;0
1219;2054;3;84;36;3;33;.917;3600000;0
1219;25584;14;65;10;0;10;1.000;1176000;0
1220;1074;0;0;0;0;0;.00nan;0;0
1220;1430;35;0;0;0;0;.00nan;0;0
1220;26840;35;82;38;2;36;.947;3569000;0
1220;31035;0;82;27;1;26;.963;3600000;0
1221;233;29;0;0;0;0;.00nan;0;0
1221;18351;29;92;15;0;15;1.000;3600000;0
1221;20853;9;0;0;0;0;.00nan;0;0
1221;28026;9;80;40;3;37;.925;3600000;0
1222;61;31;0;0;0;0;.00nan;0;0
1222;928;20;48;35;5;30;.857;3600000;0
1222;18078;20;0;0;0;0;.00nan;0;0
1222;34797;31;41;34;6;28;.824;3544000;0
1223;4506;33;42;33;6;27;.818;3543000;0
1223;18104;10;0;0;0;0;.00nan;0;0
1223;27488;10;55;38;5;33;.868;3600000;0
1223;34740;33;0;0;0;0;.00nan;0;0
1224;1796;16;0;0;0;0;.00nan;0;0
1224;4450;5;0;0;0;0;.00nan;0;0
1224;15437;16;92;35;3;32;.914;3900000;0
1224;19823;5;71;32;3;29;.906;3900000;0
1225;724;11;0;0;0;0;.00nan;0;0
1225;1913;30;86;43;3;40;.930;3600000;0
1225;4826;30;0;0;0;0;.00nan;0;0
1225;21522;11;100;22;0;22;1.000;3600000;0
1226;738;27;0;0;0;0;.00nan;0;0
1226;13842;34;0;0;0;0;.00nan;0;0
1226;15502;34;48;19;3;16;.842;3744000;0
1226;26623;27;61;40;4;36;.900;3744000;0
1227;2058;28;74;33;3;30;.909;3900000;0
1227;5385;17;0;0;0;0;.00nan;0;0
1227;14061;28;0;0;0;0;.00nan;0;0
1227;34006;17;96;43;3;40;.930;3900000;0
1228;445;12;0;0;0;0;.00nan;0;0
1228;823;23;0;0;0;0;.00nan;0;0
1228;10274;23;69;33;4;29;.879;3533000;0
1228;34786;12;67;21;2;19;.905;3600000;0
1229;15505;8;100;54;1;53;.981;3600000;0
1229;22601;26;0;0;0;0;.00nan;0;0
1229;25076;8;0;0;0;0;.00nan;0;0
1229;32754;26;63;20;2;18;.900;3545000;0
1230;376;22;82;45;4;41;.911;3546000;0
1230;500;4182;69;30;3;27;.900;3600000;0
1230;25521;4182;0;0;0;0;.00nan;0;0
1230;27739;22;0;0;0;0;.00nan;0;0
1231;1572;4838;0;0;0;0;.00nan;0;0
1231;1614;25;77;25;1;24;.960;3600000;0
1231;2328;4838;36;32;6;26;.813;3600000;0
1231;5182;25;0;0;0;0;.00nan;0;0
1232;1074;0;0;0;0;0;.00nan;0;0
1232;1251;14;0;0;0;0;.00nan;0;0
1232;25584;14;86;34;2;32;.941;3600000;0
1232;31035;0;68;28;3;25;.893;3560000;0
1233;233;29;0;0;0;0;.00nan;0;0
1233;1821;3;60;31;4;27;.871;3561000;0
1233;2054;3;0;0;0;0;.00nan;0;0
1233;18351;29;79;33;3;30;.909;3600000;0
1234;61;31;0;0;0;0;.00nan;0;0
1234;20853;9;0;0;0;0;.00nan;0;0
1234;28026;9;87;47;4;43;.915;3600000;0
1234;34797;31;57;12;1;11;.917;3600000;0
1235;51;21;0;0;0;0;.00nan;0;0
1235;5385;17;34;31;6;25;.806;3600000;0
1235;25843;21;72;28;2;26;.929;3600000;0
1235;34006;17;0;0;0;0;.00nan;0;0
1236;928;20;88;34;2;32;.941;3600000;0
1236;18078;20;0;0;0;0;.00nan;0;0
1236;18104;10;0;0;0;0;.00nan;0;0
1236;27488;10;69;37;3;34;.919;3582000;0
1237;2423;15;99;48;2;46;.958;3600000;0
1237;4106;15;0;0;0;0;.00nan;0;0
1237;4450;5;0;0;0;0;.00nan;0;0
1237;19823;5;78;36;4;32;.889;3600000;0
1238;4506;33;65;42;5;37;.881;3600000;0
1238;10103;24;0;0;0;0;.00nan;0;0
1238;13979;24;73;19;1;18;.947;3600000;0
1238;34740;33;0;0;0;0;.00nan;0;0
1239;335;18;0;0;0;0;.00nan;0;0
1239;1430;35;96;23;0;23;1.000;3600000;0
1239;5001;18;95;45;3;42;.933;3600000;0
1239;26840;35;0;0;0;0;.00nan;0;0
1240;445;12;57;38;5;33;.868;3600000;0
1240;544;19;0;0;0;0;.00nan;0;0
1240;31124;19;93;33;1;32;.970;3600000;0
1240;34786;12;0;0;0;0;.00nan;0;0
1241;724;11;0;0;0;0;.00nan;0;0
1241;15505;8;0;0;0;0;.00nan;0;0
1241;21522;11;68;22;2;20;.909;3600000;0
1241;25076;8;95;41;3;38;.927;3600000;0
1242;738;27;0;0;0;0;.00nan;0;0
1242;1796;16;68;32;3;29;.906;3582000;0
1242;15437;16;0;0;0;0;.00nan;0;0
1242;26623;27;77;26;1;25;.962;3600000;0
1243;2058;28;0;0;0;0;.00nan;0;0
1243;13842;34;0;0;0;0;.00nan;0;0
1243;14061;28;37;24;5;19;.792;3521000;0
1243;15502;34;87;40;3;37;.925;3600000;0
1244;1430;35;71;34;3;31;.912;3900000;0
1244;1572;4838;0;0;0;0;.00nan;0;0
1244;2328;4838;73;31;3;28;.903;3900000;0
1244;26840;35;0;0;0;0;.00nan;0;0
1245;823;23;0;0;0;0;.00nan;0;0
1245;1614;25;87;44;4;40;.909;3562000;0
1245;5182;25;0;0;0;0;.00nan;0;0
1245;10274;23;55;22;3;19;.864;3600000;0
1246;376;22;0;0;0;0;.00nan;0;0
1246;22601;26;0;0;0;0;.00nan;0;0
1246;27739;22;86;22;0;22;1.000;3600000;0
1246;32754;26;44;28;5;23;.821;3600000;0
1247;4450;5;0;0;0;0;.00nan;0;0
1247;18104;10;0;0;0;0;.00nan;0;0
1247;19823;5;86;32;2;30;.938;3600000;0
1247;27488;10;70;22;1;21;.955;3600000;0
1248;928;20;100;24;0;24;1.000;3600000;0
1248;5385;17;0;0;0;0;.00nan;0;0
1248;18078;20;0;0;0;0;.00nan;0;0
1248;34006;17;83;30;1;29;.967;3600000;0
1249;1074;0;0;0;0;0;.00nan;0;0
1249;2058;28;36;32;6;26;.813;3600000;0
1249;14061;28;0;0;0;0;.00nan;0;0
1249;31035;0;100;43;1;42;.977;3600000;0
1250;2423;15;60;39;5;34;.872;3600000;0
1250;4106;15;0;0;0;0;.00nan;0;0
1250;20853;9;0;0;0;0;.00nan;0;0
1250;28026;9;79;22;1;21;.955;3600000;0
1251;233;29;0;0;0;0;.00nan;0;0
1251;15464;32;61;32;4;28;.875;3600000;0
1251;16006;32;0;0;0;0;.00nan;0;0
1251;18351;29;78;16;0;16;1.000;3600000;0
1252;61;31;99;38;1;37;.974;3600000;0
1252;1821;3;42;43;7;36;.837;3600000;0
1252;2054;3;0;0;0;0;.00nan;0;0
1252;34797;31;0;0;0;0;.00nan;0;0
1253;51;21;0;0;0;0;.00nan;0;0
1253;10103;24;0;0;0;0;.00nan;0;0
1253;13979;24;70;40;4;36;.900;3600000;0
1253;25843;21;61;39;5;34;.872;3592000;0
1254;445;12;0;0;0;0;.00nan;0;0
1254;1572;4838;69;36;3;33;.917;3526000;0
1254;2328;4838;0;0;0;0;.00nan;0;0
1254;34786;12;94;33;1;32;.970;3600000;0
1255;335;18;0;0;0;0;.00nan;0;0
1255;544;19;0;0;0;0;.00nan;0;0
1255;5001;18;86;38;3;35;.921;3600000;0
1255;31124;19;53;30;4;26;.867;3554000;0
1256;1796;16;68;20;1;19;.950;3600000;0
1256;15437;16;0;0;0;0;.00nan;0;0
1256;22601;26;78;31;2;29;.935;3600000;0
1256;32754;26;0;0;0;0;.00nan;0;0
1257;724;11;78;20;1;19;.950;3600000;0
1257;1913;30;95;45;2;43;.956;3574000;0
1257;4826;30;0;0;0;0;.00nan;0;0
1257;21522;11;0;0;0;0;.00nan;0;0
1258;738;27;54;27;3;24;.889;3600000;0
1258;15505;8;100;31;1;30;.968;3600000;0
1258;25076;8;0;0;0;0;.00nan;0;0
1258;26623;27;0;0;0;0;.00nan;0;0
1259;61;31;0;0;0;0;.00nan;0;0
1259;233;29;0;0;0;0;.00nan;0;0
1259;18351;29;74;31;2;29;.935;3856000;0
1259;34797;31;71;33;3;30;.909;3856000;0
1260;51;21;80;27;2;25;.926;3813000;0
1260;20853;9;89;49;3;46;.939;3847000;0
1260;25843;21;0;0;0;0;.00nan;0;0
1260;28026;9;0;0;0;0;.00nan;0;0
1261;928;20;83;29;1;28;.966;3600000;0
1261;10103;24;0;0;0;0;.00nan;0;0
1261;13979;24;59;34;5;29;.853;3600000;0
1261;18078;20;0;0;0;0;.00nan;0;0
1262;4450;5;32;22;5;17;.773;3600000;0
1262;18104;10;64;22;2;20;.909;3600000;0
1262;19823;5;0;0;0;0;.00nan;0;0
1262;27488;10;0;0;0;0;.00nan;0;0
1263;1251;14;0;0;0;0;.00nan;0;0
1263;2423;15;66;33;3;30;.909;3600000;0
1263;4106;15;0;0;0;0;.00nan;0;0
1263;25584;14;79;45;4;41;.911;3542000;0
1264;376;22;0;0;0;0;.00nan;0;0
1264;1821;3;68;31;3;28;.903;3557000;0
1264;2054;3;0;0;0;0;.00nan;0;0
1264;27739;22;85;33;2;31;.939;3600000;0
1265;823;23;0;0;0;0;.00nan;0;0
1265;10274;23;91;50;4;46;.920;3600000;0
1265;13842;34;0;0;0;0;.00nan;0;0
1265;15502;34;40;26;5;21;.808;3546000;0
1266;1430;35;0;0;0;0;.00nan;0;0
1266;15464;32;64;35;4;31;.886;3525000;0
1266;16006;32;0;0;0;0;.00nan;0;0
1266;26840;35;72;19;2;17;.895;3600000;0
1267;1614;25;74;27;2;25;.926;3600000;0
1267;4506;33;43;31;5;26;.839;3600000;0
1267;5182;25;0;0;0;0;.00nan;0;0
1267;34740;33;0;0;0;0;.00nan;0;0
1268;500;4182;59;13;1;12;.923;3600000;0
1268;738;27;0;0;0;0;.00nan;0;0
1268;25521;4182;0;0;0;0;.00nan;0;0
1268;26623;27;51;35;5;30;.857;3600000;0
1269;1796;16;0;0;0;0;.00nan;0;0
1269;1913;30;0;0;0;0;.00nan;0;0
1269;4826;30;81;27;2;25;.926;3600000;0
1269;15437;16;53;25;3;22;.880;3556000;0
1270;1251;14;93;21;0;21;1.000;3600000;0
1270;15505;8;73;41;4;37;.902;3600000;0
1270;25076;8;0;0;0;0;.00nan;0;0
1270;25584;14;0;0;0;0;.00nan;0;0
1271;61;31;85;34;2;32;.941;3551000;0
1271;4450;5;0;0;0;0;.00nan;0;0
1271;19823;5;67;18;1;17;.944;3600000;0
1271;34797;31;0;0;0;0;.00nan;0;0
1272;1074;0;0;0;0;0;.00nan;0;0
1272;5385;17;45;9;2;7;.778;815000;0
1272;31035;0;52;36;5;31;.861;3600000;0
1272;34006;17;25;24;6;18;.750;2785000;0
1273;51;21;0;0;0;0;.00nan;0;0
1273;2058;28;0;0;0;0;.00nan;0;0
1273;14061;28;44;30;5;25;.833;3600000;0
1273;25843;21;82;39;3;36;.923;3600000;0
1274;1821;3;77;38;4;34;.895;3900000;0
1274;2054;3;0;0;0;0;.00nan;0;0
1274;20853;9;0;0;0;0;.00nan;0;0
1274;28026;9;76;51;4;47;.922;3900000;0
1275;233;29;0;0;0;0;.00nan;0;0
1275;13842;34;0;0;0;0;.00nan;0;0
1275;15502;34;78;46;5;41;.891;3600000;0
1275;18351;29;68;22;2;20;.909;3600000;0
1276;10103;24;0;0;0;0;.00nan;0;0
1276;13979;24;46;39;7;32;.821;3600000;0
1276;18104;10;0;0;0;0;.00nan;0;0
1276;27488;10;60;35;5;30;.857;3600000;0
1277;823;23;72;30;2;28;.933;1666000;0
1277;2423;15;0;0;0;0;.00nan;0;0
1277;4106;15;96;44;2;42;.955;3600000;0
1277;10274;23;42;25;4;21;.840;1934000;0
1278;376;22;0;0;0;0;.00nan;0;0
1278;928;20;80;34;2;32;.941;3610000;0
1278;18078;20;0;0;0;0;.00nan;0;0
1278;27739;22;60;23;3;20;.870;3610000;0
1279;544;19;0;0;0;0;.00nan;0;0
1279;15464;32;51;48;7;41;.854;3600000;0
1279;16006;32;0;0;0;0;.00nan;0;0
1279;31124;19;79;29;2;27;.931;3600000;0
1280;445;12;0;0;0;0;.00nan;0;0
1280;500;4182;76;26;2;24;.923;3600000;0
1280;25521;4182;0;0;0;0;.00nan;0;0
1280;34786;12;62;28;3;25;.893;3591000;0
1281;1430;35;100;47;1;46;.979;3600000;0
1281;22601;26;0;0;0;0;.00nan;0;0
1281;26840;35;0;0;0;0;.00nan;0;0
1281;32754;26;63;26;3;23;.885;3530000;0
1282;1614;25;0;0;0;0;.00nan;0;0
1282;1796;16;40;34;6;28;.824;3576000;0
1282;5182;25;64;32;4;28;.875;3600000;0
1282;15437;16;0;0;0;0;.00nan;0;0
1283;335;18;41;24;4;20;.833;3583000;0
1283;1572;4838;82;34;3;31;.912;3600000;0
1283;2328;4838;0;0;0;0;.00nan;0;0
1283;5001;18;0;0;0;0;.00nan;0;0
1284;738;27;0;0;0;0;.00nan;0;0
1284;1913;30;79;40;3;37;.925;3600000;0
1284;4826;30;0;0;0;0;.00nan;0;0
1284;26623;27;65;36;4;32;.889;3580000;0
1285;500;4182;75;32;3;29;.906;3600000;0
1285;15505;8;65;44;5;39;.886;3539000;0
1285;25076;8;0;0;0;0;.00nan;0;0
1285;25521;4182;0;0;0;0;.00nan;0;0
1286;445;12;53;24;3;21;.875;3600000;0
1286;22601;26;80;46;4;42;.913;3540000;0
1286;32754;26;0;0;0;0;.00nan;0;0
1286;34786;12;0;0;0;0;.00nan;0;0
1287;1251;14;72;43;4;39;.907;3590000;0
1287;4506;33;50;21;3;18;.857;3600000;0
1287;25584;14;0;0;0;0;.00nan;0;0
1287;34740;33;0;0;0;0;.00nan;0;0
1288;724;11;48;30;5;25;.833;2173000;0
1288;1572;4838;0;0;0;0;.00nan;0;0
1288;2328;4838;78;31;2;29;.935;3600000;0
1288;21522;11;60;13;1;12;.923;1427000;0
1289;4450;5;0;0;0;0;.00nan;0;0
1289;5385;17;0;0;0;0;.00nan;0;0
1289;19823;5;100;21;0;21;1.000;3600000;0
1289;34006;17;88;31;1;30;.968;3543000;0
1290;61;31;0;0;0;0;.00nan;0;0
1290;2058;28;0;0;0;0;.00nan;0;0
1290;14061;28;72;30;3;27;.900;3600000;0
1290;34797;31;100;33;0;33;1.000;3600000;0
1291;233;29;0;0;0;0;.00nan;0;0
1291;928;20;74;38;4;34;.895;3597000;0
1291;18078;20;0;0;0;0;.00nan;0;0
1291;18351;29;79;29;2;27;.931;3600000;0
1292;376;22;74;13;0;13;1.000;1279000;0
1292;13842;34;0;0;0;0;.00nan;0;0
1292;15502;34;95;42;2;40;.952;3600000;0
1292;27739;22;61;38;5;33;.868;2321000;0
1293;51;21;67;44;5;39;.886;3600000;0
1293;10103;24;0;0;0;0;.00nan;0;0
1293;13979;24;99;25;0;25;1.000;3600000;0
1293;25843;21;0;0;0;0;.00nan;0;0
1294;544;19;0;0;0;0;.00nan;0;0
1294;1430;35;47;29;5;24;.828;3538000;0
1294;26840;35;0;0;0;0;.00nan;0;0
1294;31124;19;77;36;3;33;.917;3600000;0
1295;1614;25;51;22;3;19;.864;3600000;0
1295;5182;25;0;0;0;0;.00nan;0;0
1295;15464;32;88;45;4;41;.911;3571000;0
1295;16006;32;0;0;0;0;.00nan;0;0
1296;738;27;0;0;0;0;.00nan;0;0
1296;823;23;41;27;4;23;.852;2494000;0
1296;10274;23;27;14;4;10;.714;1106000;0
1296;26623;27;60;34;4;30;.882;3600000;0
1297;5385;17;49;22;3;19;.864;3532000;0
1297;15505;8;100;49;1;48;.980;3600000;0
1297;25076;8;0;0;0;0;.00nan;0;0
1297;34006;17;0;0;0;0;.00nan;0;0
1298;1821;3;0;0;0;0;.00nan;0;0
1298;2054;3;23;19;5;14;.737;3600000;0
1298;4450;5;0;0;0;0;.00nan;0;0
1298;19823;5;43;39;6;33;.846;3600000;0
1299;61;31;0;0;0;0;.00nan;0;0
1299;1074;0;0;0;0;0;.00nan;0;0
1299;31035;0;53;24;3;21;.875;3558000;0
1299;34797;31;100;40;1;39;.975;3600000;0
1300;51;21;52;4;0;4;1.000;950000;0
1300;20853;9;0;0;0;0;.00nan;0;0
1300;25843;21;17;22;6;16;.727;2650000;0
1300;28026;9;99;40;1;39;.975;3600000;0
1301;376;22;78;18;0;18;1.000;1357000;0
1301;18104;10;0;0;0;0;.00nan;0;0
1301;27488;10;80;28;2;26;.929;3600000;0
1301;27739;22;27;25;5;20;.800;2243000;0
1302;1251;14;94;34;2;32;.941;3600000;0
1302;2058;28;40;22;4;18;.818;3522000;0
1302;14061;28;0;0;0;0;.00nan;0;0
1302;25584;14;0;0;0;0;.00nan;0;0
1303;2423;15;99;40;2;38;.950;3900000;0
1303;4106;15;0;0;0;0;.00nan;0;0
1303;10103;24;0;0;0;0;.00nan;0;0
1303;13979;24;97;45;2;43;.956;3900000;0
1304;233;29;0;0;0;0;.00nan;0;0
1304;13842;34;100;41;1;40;.976;3600000;0
1304;15502;34;0;0;0;0;.00nan;0;0
1304;18351;29;79;41;4;37;.902;3600000;0
1305;500;4182;60;20;2;18;.900;3600000;0
1305;1796;16;0;0;0;0;.00nan;0;0
1305;15437;16;62;30;3;27;.900;3546000;0
1305;25521;4182;0;0;0;0;.00nan;0;0
1306;445;12;0;0;0;0;.00nan;0;0
1306;1913;30;58;38;5;33;.868;3582000;0
1306;4826;30;0;0;0;0;.00nan;0;0
1306;34786;12;71;28;3;25;.893;3600000;0
1307;1430;35;0;0;0;0;.00nan;0;0
1307;1614;25;0;0;0;0;.00nan;0;0
1307;5182;25;81;23;1;22;.957;3900000;0
1307;26840;35;90;37;1;36;.973;3900000;0
1308;544;19;85;27;1;26;.963;3600000;0
1308;4506;33;80;48;5;43;.896;3600000;0
1308;31124;19;0;0;0;0;.00nan;0;0
1308;34740;33;0;0;0;0;.00nan;0;0
1309;335;18;0;0;0;0;.00nan;0;0
1309;724;11;0;0;0;0;.00nan;0;0
1309;5001;18;71;34;3;31;.912;3600000;0
1309;21522;11;64;27;4;23;.852;3545000;0
1310;15464;32;54;41;5;36;.878;3900000;0
1310;16006;32;0;0;0;0;.00nan;0;0
1310;22601;26;0;0;0;0;.00nan;0;0
1310;32754;26;74;39;5;34;.872;3900000;0
1311;738;27;81;30;1;29;.967;3544000;0
1311;1572;4838;0;0;0;0;.00nan;0;0
1311;2328;4838;100;28;0;28;1.000;3600000;0
1311;26623;27;0;0;0;0;.00nan;0;0
2701;323;9;67;23;2;21;.913;2748000;0
2701;2423;15;65;29;2;27;.931;3600000;0
2701;4106;15;0;0;0;0;.00nan;0;0
2701;20853;9;44;4;1;3;.750;848000;0
2703;1913;30;96;43;2;41;.953;3900000;0
2703;4506;33;83;31;2;29;.935;3900000;0
2703;4826;30;0;0;0;0;.00nan;0;0
2703;34740;33;0;0;0;0;.00nan;0;0
2705;1614;25;84;27;1;26;.963;3600000;0
2705;5182;25;0;0;0;0;.00nan;0;0
2705;18078;20;63;30;3;27;.900;3573000;0
2705;32146;20;0;0;0;0;.00nan;0;0
2707;500;4182;0;0;0;0;.00nan;0;0
2707;1074;0;74;46;4;42;.913;3600000;0
2707;25521;4182;80;25;1;24;.960;3600000;0
2707;31035;0;0;0;0;0;.00nan;0;0
2709;15464;32;0;0;0;0;.00nan;0;0
2709;16006;32;54;26;4;22;.846;3600000;0
2709;22601;26;28;35;6;29;.829;3304000;0
2709;32754;26;48;0;0;0;.00nan;221000;0
2711;4450;5;0;0;0;0;.00nan;0;0
2711;19823;5;88;44;3;41;.932;3600000;0
2711;27739;22;0;0;0;0;.00nan;0;0
2711;28026;22;47;42;6;36;.857;3600000;0
2713;335;18;0;0;0;0;.00nan;0;0
2713;5001;18;68;26;2;24;.923;3600000;0
2713;5385;17;0;0;0;0;.00nan;0;0
2713;34006;17;65;40;4;36;.900;3574000;0
2715;61;31;0;0;0;0;.00nan;0;0
2715;544;19;51;31;5;26;.839;3648000;0
2715;31124;19;0;0;0;0;.00nan;0;0
2715;34797;31;88;46;4;42;.913;3648000;0
2717;233;29;0;0;0;0;.00nan;0;0
2717;738;27;85;45;3;42;.933;3600000;0
2717;18351;29;65;33;4;29;.879;3568000;0
2717;26623;27;0;0;0;0;.00nan;0;0
2719;1251;14;0;0;0;0;.00nan;0;0
2719;2058;28;84;48;5;43;.896;3600000;0
2719;14061;28;0;0;0;0;.00nan;0;0
2719;25584;14;46;18;3;15;.833;3600000;0
2721;10103;24;0;0;0;0;.00nan;0;0
2721;13979;24;77;34;2;32;.941;3600000;0
2721;15505;8;81;44;4;40;.909;3566000;0
2721;25076;8;0;0;0;0;.00nan;0;0
2723;724;11;58;30;4;26;.867;3552000;0
2723;18104;10;0;0;0;0;.00nan;0;0
2723;21522;11;0;0;0;0;.00nan;0;0
2723;27488;10;69;31;3;28;.903;3600000;0
2725;823;23;69;34;3;31;.912;3561000;0
2725;10274;23;0;0;0;0;.00nan;0;0
2725;13842;34;0;0;0;0;.00nan;0;0
2725;15502;34;84;37;2;35;.946;3600000;0
2727;51;21;0;0;0;0;.00nan;0;0
2727;1796;16;100;34;0;34;1.000;3600000;0
2727;15437;16;0;0;0;0;.00nan;0;0
2727;25843;21;24;21;5;16;.762;3600000;0
2729;262;35;74;36;4;32;.889;3600000;0
2729;445;12;83;26;1;25;.962;3600000;0
2729;1430;35;0;0;0;0;.00nan;0;0
2729;34786;12;0;0;0;0;.00nan;0;0
2731;1572;4838;33;11;3;8;.727;1461000;0
2731;1821;3;0;0;0;0;.00nan;0;0
2731;2054;3;68;33;3;30;.909;3600000;0
2731;2328;4838;25;17;6;11;.647;2139000;0
2733;233;29;87;32;1;31;.969;3600000;0
2733;4506;33;65;32;3;29;.906;3526000;0
2733;18351;29;0;0;0;0;.00nan;0;0
2733;34740;33;0;0;0;0;.00nan;0;0
2735;323;9;89;55;4;51;.927;3600000;0
2735;1796;16;61;17;2;15;.882;3600000;0
2735;2553;9;0;0;0;0;.00nan;0;0
2735;15437;16;0;0;0;0;.00nan;0;0
2737;335;18;39;9;2;7;.778;825000;0
2737;5001;18;23;25;6;19;.760;2775000;0
2737;27739;22;0;0;0;0;.00nan;0;0
2737;28026;22;76;36;3;33;.917;3600000;0
2739;544;19;43;23;4;19;.826;3521000;0
2739;1572;4838;84;27;2;25;.926;3600000;0
2739;2328;4838;0;0;0;0;.00nan;0;0
2739;31124;19;0;0;0;0;.00nan;0;0
2741;13842;34;59;27;3;24;.889;3600000;0
2741;15464;32;54;40;5;35;.875;3554000;0
2741;15502;34;0;0;0;0;.00nan;0;0
2741;16006;32;0;0;0;0;.00nan;0;0
2743;724;11;95;28;1;27;.964;3600000;0
2743;21522;11;0;0;0;0;.00nan;0;0
2743;22601;26;0;0;0;0;.00nan;0;0
2743;32754;26;80;33;2;31;.939;3553000;0
2745;2058;28;86;25;1;24;.960;3900000;0
2745;14061;28;0;0;0;0;.00nan;0;0
2745;18104;10;0;0;0;0;.00nan;0;0
2745;27488;10;88;32;1;31;.969;3900000;0
2747;1821;3;92;35;2;33;.943;3600000;0
2747;2054;3;0;0;0;0;.00nan;0;0
2747;18078;20;42;29;5;24;.828;3600000;0
2747;32146;20;0;0;0;0;.00nan;0;0
2749;1913;30;0;0;0;0;.00nan;0;0
2749;2423;15;0;0;0;0;.00nan;0;0
2749;4106;15;63;28;3;25;.893;3600000;0
2749;4826;30;65;23;2;21;.913;3600000;0
2751;1251;14;0;0;0;0;.00nan;0;0
2751;10103;24;0;0;0;0;.00nan;0;0
2751;13979;24;63;17;2;15;.882;3600000;0
2751;25584;14;84;54;5;49;.907;3600000;0
2753;500;4182;90;37;1;36;.973;3665000;0
2753;15505;8;81;30;2;28;.933;3665000;0
2753;25076;8;0;0;0;0;.00nan;0;0
2753;25521;4182;0;0;0;0;.00nan;0;0
2755;61;31;59;29;4;25;.862;3900000;0
2755;823;23;0;0;0;0;.00nan;0;0
2755;10274;23;72;35;4;31;.886;3900000;0
2755;34797;31;0;0;0;0;.00nan;0;0
2757;51;21;0;0;0;0;.00nan;0;0
2757;1074;0;45;43;6;37;.860;3330000;0
2757;25843;21;93;15;0;15;1.000;3600000;0
2757;31035;0;53;2;0;2;1.000;270000;0
2759;738;27;74;38;3;35;.921;3558000;0
2759;4450;5;74;29;2;27;.931;3600000;0
2759;19823;5;0;0;0;0;.00nan;0;0
2759;26623;27;0;0;0;0;.00nan;0;0
2761;1614;25;80;22;1;21;.955;3880000;0
2761;5182;25;0;0;0;0;.00nan;0;0
2761;5385;17;68;27;2;25;.926;3880000;0
2761;34006;17;0;0;0;0;.00nan;0;0
2763;262;35;53;32;5;27;.844;3600000;0
2763;445;12;0;0;0;0;.00nan;0;0
2763;1430;35;0;0;0;0;.00nan;0;0
2763;34786;12;81;37;2;35;.946;3600000;0
2765;233;29;0;0;0;0;.00nan;0;0
2765;15464;32;0;0;0;0;.00nan;0;0
2765;16006;32;79;44;3;41;.932;3900000;0
2765;18351;29;76;33;3;30;.909;3900000;0
2767;1251;14;97;19;0;19;1.000;3600000;0
2767;1796;16;0;0;0;0;.00nan;0;0
2767;15437;16;59;35;4;31;.886;3600000;0
2767;25584;14;0;0;0;0;.00nan;0;0
2769;500;4182;0;0;0;0;.00nan;0;0
2769;1572;4838;0;0;0;0;.00nan;0;0
2769;2328;4838;68;30;3;27;.900;3900000;0
2769;25521;4182;51;18;3;15;.833;3900000;0
2771;2423;15;91;34;2;32;.941;3900000;0
2771;4106;15;0;0;0;0;.00nan;0;0
2771;22601;26;83;34;2;32;.941;3900000;0
2771;32754;26;0;0;0;0;.00nan;0;0
2773;61;31;0;0;0;0;.00nan;0;0
2773;2058;28;0;0;0;0;.00nan;0;0
2773;14061;28;100;40;1;39;.975;3600000;0
2773;34797;31;56;39;5;34;.872;3600000;0
2775;51;21;68;13;0;13;1.000;1374000;0
2775;4506;33;0;0;0;0;.00nan;0;0
2775;25843;21;26;27;6;21;.778;2155000;0
2775;34740;33;60;34;4;30;.882;3600000;0
2777;724;11;0;0;0;0;.00nan;0;0
2777;1821;3;0;0;0;0;.00nan;0;0
2777;2054;3;57;27;4;23;.852;3563000;0
2777;21522;11;61;31;3;28;.903;3600000;0
2779;1913;30;63;40;4;36;.900;3564000;0
2779;4826;30;0;0;0;0;.00nan;0;0
2779;10103;24;55;24;3;21;.875;3600000;0
2779;13979;24;0;0;0;0;.00nan;0;0
2781;323;9;0;0;0;0;.00nan;0;0
2781;738;27;0;0;0;0;.00nan;0;0
2781;2553;9;95;44;2;42;.955;3600000;0
2781;26623;27;64;25;3;22;.880;3547000;0
2783;15505;8;0;0;0;0;.00nan;0;0
2783;25076;8;100;43;2;41;.953;3600000;0
2783;27739;22;58;28;3;25;.893;3569000;0
2783;28026;22;0;0;0;0;.00nan;0;0
2785;544;19;0;0;0;0;.00nan;0;0
2785;1614;25;0;0;0;0;.00nan;0;0
2785;5182;25;92;39;2;37;.949;3900000;0
2785;31124;19;66;23;2;21;.913;3900000;0
2787;262;35;0;0;0;0;.00nan;0;0
2787;335;18;84;49;4;45;.918;3600000;0
2787;1430;35;49;19;3;16;.842;3600000;0
2787;5001;18;0;0;0;0;.00nan;0;0
2789;823;23;58;23;2;21;.913;3600000;0
2789;5385;17;0;0;0;0;.00nan;0;0
2789;10274;23;0;0;0;0;.00nan;0;0
2789;34006;17;45;44;7;37;.841;3600000;0
2791;4450;5;0;0;0;0;.00nan;0;0
2791;13842;34;0;0;0;0;.00nan;0;0
2791;15502;34;100;36;1;35;.972;3600000;0
2791;19823;5;28;34;6;28;.824;3600000;0
2793;18078;20;0;0;0;0;.00nan;0;0
2793;18104;10;87;32;2;30;.938;3600000;0
2793;27488;10;0;0;0;0;.00nan;0;0
2793;32146;20;58;31;4;27;.871;3555000;0
2795;445;12;57;14;2;12;.857;3600000;0
2795;1074;0;0;0;0;0;.00nan;0;0
2795;31035;0;73;42;4;38;.905;3579000;0
2795;34786;12;0;0;0;0;.00nan;0;0
2797;544;19;0;0;0;0;.00nan;0;0
2797;1572;4838;0;0;0;0;.00nan;0;0
2797;2328;4838;90;48;3;45;.938;3900000;0
2797;31124;19;86;39;3;36;.923;3900000;0
2799;1614;25;100;31;1;30;.968;3600000;0
2799;5182;25;0;0;0;0;.00nan;0;0
2799;13842;34;82;37;2;35;.946;3543000;0
2799;15502;34;0;0;0;0;.00nan;0;0
2801;738;27;79;26;1;25;.962;3600000;0
2801;5385;17;0;0;0;0;.00nan;0;0
2801;26623;27;0;0;0;0;.00nan;0;0
2801;34006;17;85;31;2;29;.935;3600000;0
2803;233;29;71;20;1;19;.950;3600000;0
2803;323;9;49;34;5;29;.853;3600000;0
2803;2553;9;0;0;0;0;.00nan;0;0
2803;18351;29;0;0;0;0;.00nan;0;0
2805;1074;0;99;55;2;53;.964;3600000;0
2805;22601;26;69;33;3;30;.909;3550000;0
2805;31035;0;0;0;0;0;.00nan;0;0
2805;32754;26;0;0;0;0;.00nan;0;0
2807;1913;30;81;32;2;30;.938;3600000;0
2807;4826;30;0;0;0;0;.00nan;0;0
2807;15505;8;0;0;0;0;.00nan;0;0
2807;25076;8;100;32;0;32;1.000;3600000;0
2809;724;11;85;48;4;44;.917;3900000;0
2809;21522;11;0;0;0;0;.00nan;0;0
2809;27739;22;0;0;0;0;.00nan;0;0
2809;28026;22;43;31;4;27;.871;3900000;0
2811;335;18;0;0;0;0;.00nan;0;0
2811;500;4182;76;34;3;31;.912;3736000;0
2811;5001;18;80;35;2;33;.943;3736000;0
2811;25521;4182;0;0;0;0;.00nan;0;0
2813;1796;16;67;23;2;21;.913;3600000;0
2813;15437;16;0;0;0;0;.00nan;0;0
2813;18104;10;60;35;5;30;.857;3600000;0
2813;27488;10;0;0;0;0;.00nan;0;0
2815;61;31;0;0;0;0;.00nan;0;0
2815;1821;3;87;30;1;29;.967;3600000;0
2815;2054;3;0;0;0;0;.00nan;0;0
2815;34797;31;57;20;3;17;.850;3530000;0
2817;51;21;80;23;1;22;.957;3600000;0
2817;18078;20;78;43;4;39;.907;3600000;0
2817;25843;21;0;0;0;0;.00nan;0;0
2817;32146;20;0;0;0;0;.00nan;0;0
2819;262;35;85;46;3;43;.935;3600000;0
2819;823;23;48;26;4;22;.846;3556000;0
2819;1430;35;0;0;0;0;.00nan;0;0
2819;10274;23;0;0;0;0;.00nan;0;0
2821;2058;28;0;0;0;0;.00nan;0;0
2821;10103;24;0;0;0;0;.00nan;0;0
2821;13979;24;82;24;1;23;.958;3600000;0
2821;14061;28;64;31;3;28;.903;3517000;0
2823;445;12;0;0;0;0;.00nan;0;0
2823;15464;32;0;0;0;0;.00nan;0;0
2823;16006;32;72;40;4;36;.900;3550000;0
2823;34786;12;76;29;2;27;.931;3600000;0
2825;2423;15;78;49;5;44;.898;3600000;0
2825;4106;15;0;0;0;0;.00nan;0;0
2825;4450;5;60;22;2;20;.909;3600000;0
2825;19823;5;0;0;0;0;.00nan;0;0
2827;1251;14;41;24;4;20;.833;3569000;0
2827;4506;33;0;0;0;0;.00nan;0;0
2827;25584;14;0;0;0;0;.00nan;0;0
2827;34740;33;73;28;2;26;.929;3600000;0
2829;1821;3;0;0;0;0;.00nan;0;0
2829;2054;3;83;24;1;23;.958;3600000;0
2829;22601;26;0;0;0;0;.00nan;0;0
2829;32754;26;50;29;4;25;.862;3600000;0
2831;500;4182;0;0;0;0;.00nan;0;0
2831;823;23;0;0;0;0;.00nan;0;0
2831;10274;23;47;34;5;29;.853;3600000;0
2831;25521;4182;52;27;4;23;.852;3600000;0
2833;1251;14;0;0;0;0;.00nan;0;0
2833;2423;15;0;0;0;0;.00nan;0;0
2833;4106;15;83;28;1;27;.964;3600000;0
2833;8046;14;47;21;3;18;.857;3600000;0
2835;323;9;0;0;0;0;.00nan;0;0
2835;2553;9;43;19;4;15;.789;3600000;0
2835;15464;32;34;30;6;24;.800;3576000;0
2835;16006;32;0;0;0;0;.00nan;0;0
2837;1074;0;58;6;0;6;1.000;678000;0
2837;1796;16;0;0;0;0;.00nan;0;0
2837;15437;16;46;17;3;14;.824;3600000;0
2837;31035;0;52;44;6;38;.864;2922000;0
2839;445;12;59;26;3;23;.885;3600000;0
2839;13842;34;0;0;0;0;.00nan;0;0
2839;15502;34;100;26;0;26;1.000;3600000;0
2839;34786;12;0;0;0;0;.00nan;0;0
2841;335;18;62;29;3;26;.897;3600000;0
2841;738;27;0;0;0;0;.00nan;0;0
2841;5001;18;0;0;0;0;.00nan;0;0
2841;26623;27;49;35;5;30;.857;3541000;0
2843;233;29;0;0;0;0;.00nan;0;0
2843;15505;8;0;0;0;0;.00nan;0;0
2843;18351;29;79;25;2;23;.920;3557000;0
2843;25076;8;99;43;1;42;.977;3600000;0
2845;51;21;0;0;0;0;.00nan;0;0
2845;5385;17;71;39;4;35;.897;3538000;0
2845;25843;21;82;25;2;23;.920;3600000;0
2845;34006;17;0;0;0;0;.00nan;0;0
2847;724;11;0;0;0;0;.00nan;0;0
2847;2058;28;42;26;4;22;.846;3600000;0
2847;14061;28;0;0;0;0;.00nan;0;0
2847;21522;11;100;39;0;39;1.000;3600000;0
2849;1913;30;0;0;0;0;.00nan;0;0
2849;4826;30;73;35;3;32;.914;3558000;0
2849;27739;22;60;22;2;20;.909;3600000;0
2849;28026;22;0;0;0;0;.00nan;0;0
2851;4450;5;0;0;0;0;.00nan;0;0
2851;4506;33;88;40;3;37;.925;3600000;0
2851;19823;5;61;24;2;22;.917;3600000;0
2851;34740;33;0;0;0;0;.00nan;0;0
2853;18078;20;0;0;0;0;.00nan;0;0
2853;18104;10;0;0;0;0;.00nan;0;0
2853;27488;10;71;24;2;22;.917;3553000;0
2853;32146;20;99;39;1;38;.974;3600000;0
2855;1614;25;0;0;0;0;.00nan;0;0
2855;5182;25;69;36;3;33;.917;3600000;0
2855;10103;24;76;30;2;28;.933;3600000;0
2855;13979;24;0;0;0;0;.00nan;0;0
2857;262;35;0;0;0;0;.00nan;0;0
2857;1430;35;87;36;2;34;.944;3600000;0
2857;1572;4838;65;31;3;28;.903;3600000;0
2857;2328;4838;0;0;0;0;.00nan;0;0
2859;61;31;95;25;0;25;1.000;3600000;0
2859;544;19;69;35;3;32;.914;3600000;0
2859;31124;19;0;0;0;0;.00nan;0;0
2859;34797;31;0;0;0;0;.00nan;0;0
2861;335;18;0;0;0;0;.00nan;0;0
2861;2423;15;74;30;2;28;.933;3571000;0
2861;4106;15;0;0;0;0;.00nan;0;0
2861;5001;18;89;31;1;30;.968;3600000;0
2863;724;11;0;0;0;0;.00nan;0;0
2863;1074;0;30;39;7;32;.821;2757000;0
2863;21522;11;53;20;2;18;.900;3600000;0
2863;31035;0;23;12;4;8;.667;843000;0
2865;1796;16;59;21;3;18;.857;3584000;0
2865;15437;16;0;0;0;0;.00nan;0;0
2865;15464;32;75;44;4;40;.909;3579000;0
2865;16006;32;0;0;0;0;.00nan;0;0
2867;51;21;0;0;0;0;.00nan;0;0
2867;4506;33;56;42;6;36;.857;3680000;0
2867;25843;21;49;37;5;32;.865;3680000;0
2867;34740;33;0;0;0;0;.00nan;0;0
2869;10103;24;0;0;0;0;.00nan;0;0
2869;13979;24;41;24;4;20;.833;3900000;0
2869;22601;26;93;44;4;40;.909;3900000;0
2869;32754;26;0;0;0;0;.00nan;0;0
2871;500;4182;92;32;1;31;.969;3900000;0
2871;738;27;100;38;1;37;.974;3900000;0
2871;25521;4182;0;0;0;0;.00nan;0;0
2871;26623;27;0;0;0;0;.00nan;0;0
2873;233;29;0;0;0;0;.00nan;0;0
2873;1614;25;89;28;1;27;.964;3600000;0
2873;5182;25;0;0;0;0;.00nan;0;0
2873;18351;29;59;19;2;17;.895;3581000;0
2875;1821;3;59;34;4;30;.882;3600000;0
2875;2054;3;0;0;0;0;.00nan;0;0
2875;13842;34;0;0;0;0;.00nan;0;0
2875;15502;34;99;38;2;36;.947;3600000;0
2877;1913;30;60;18;3;15;.833;3600000;0
2877;4826;30;0;0;0;0;.00nan;0;0
2877;5385;17;0;0;0;0;.00nan;0;0
2877;34006;17;57;32;4;28;.875;3600000;0
2879;4450;5;62;23;3;20;.870;3600000;0
2879;15505;8;46;32;5;27;.844;2305000;0
2879;19823;5;0;0;0;0;.00nan;0;0
2879;25076;8;35;13;3;10;.769;1295000;0
2881;262;35;0;0;0;0;.00nan;0;0
2881;1430;35;56;23;2;21;.913;3522000;0
2881;18078;20;97;21;0;21;1.000;3600000;0
2881;32146;20;0;0;0;0;.00nan;0;0
2883;323;9;0;0;0;0;.00nan;0;0
2883;1251;14;79;31;2;29;.935;3600000;0
2883;2553;9;74;41;3;38;.927;3586000;0
2883;8046;14;0;0;0;0;.00nan;0;0
2885;61;31;73;34;3;31;.912;3600000;0
2885;445;12;0;0;0;0;.00nan;0;0
2885;34786;12;93;19;0;19;1.000;3600000;0
2885;34797;31;0;0;0;0;.00nan;0;0
2887;2058;28;38;36;7;29;.806;3600000;0
2887;14061;28;0;0;0;0;.00nan;0;0
2887;27739;22;0;0;0;0;.00nan;0;0
2887;28026;22;100;27;0;27;1.000;3600000;0
2889;544;19;0;0;0;0;.00nan;0;0
2889;18104;10;0;0;0;0;.00nan;0;0
2889;27488;10;71;28;3;25;.893;3600000;0
2889;31124;19;41;33;6;27;.818;3600000;0
2891;823;23;0;0;0;0;.00nan;0;0
2891;1572;4838;79;29;2;27;.931;3588000;0
2891;2328;4838;0;0;0;0;.00nan;0;0
2891;10274;23;100;37;0;37;1.000;3600000;0
2893;61;31;0;0;0;0;.00nan;0;0
2893;233;29;67;29;2;27;.931;3900000;0
2893;18351;29;0;0;0;0;.00nan;0;0
2893;34797;31;78;32;2;30;.938;3900000;0
2895;1251;14;0;0;0;0;.00nan;0;0
2895;8046;14;69;33;2;31;.939;3900000;0
2895;27739;22;0;0;0;0;.00nan;0;0
2895;28026;22;92;35;2;33;.943;3900000;0
2897;823;23;0;0;0;0;.00nan;0;0
2897;10274;23;59;27;3;24;.889;3546000;0
2897;18104;10;85;34;2;32;.941;3600000;0
2897;27488;10;0;0;0;0;.00nan;0;0
2899;262;35;55;45;7;38;.844;3131000;0
2899;1430;35;65;10;0;10;1.000;469000;0
2899;15505;8;0;0;0;0;.00nan;0;0
2899;25076;8;45;24;4;20;.833;3600000;0
2901;335;18;84;37;3;34;.919;3544000;0
2901;5001;18;0;0;0;0;.00nan;0;0
2901;13842;34;100;32;1;31;.969;3600000;0
2901;15502;34;0;0;0;0;.00nan;0;0
2903;1074;0;0;0;0;0;.00nan;0;0
2903;2423;15;0;0;0;0;.00nan;0;0
2903;4106;15;88;33;2;31;.939;3559000;0
2903;31035;0;100;33;0;33;1.000;3600000;0
2905;51;21;25;7;3;4;.571;440000;0
2905;1796;16;0;0;0;0;.00nan;0;0
2905;15437;16;78;29;2;27;.931;3600000;0
2905;25843;21;72;28;2;26;.929;3160000;0
2907;1913;30;0;0;0;0;.00nan;0;0
2907;2058;28;0;0;0;0;.00nan;0;0
2907;4826;30;62;45;5;40;.889;3590000;0
2907;14061;28;53;25;3;22;.880;3600000;0
2909;724;11;45;20;3;17;.850;3600000;0
2909;21522;11;0;0;0;0;.00nan;0;0
2909;22601;26;0;0;0;0;.00nan;0;0
2909;32754;26;68;50;6;44;.880;3600000;0
2911;500;4182;0;0;0;0;.00nan;0;0
2911;544;19;74;38;3;35;.921;3600000;0
2911;25521;4182;37;38;6;32;.842;3600000;0
2911;31124;19;0;0;0;0;.00nan;0;0
2913;323;9;95;33;1;32;.970;3900000;0
2913;2553;9;0;0;0;0;.00nan;0;0
2913;5385;17;71;16;1;15;.938;3900000;0
2913;34006;17;0;0;0;0;.00nan;0;0
2915;4450;5;62;7;0;7;1.000;853000;0
2915;15464;32;0;0;0;0;.00nan;0;0
2915;16006;32;100;29;0;29;1.000;3600000;0
2915;19823;5;5;15;6;9;.600;2747000;0
2917;445;12;0;0;0;0;.00nan;0;0
2917;1614;25;0;0;0;0;.00nan;0;0
2917;5182;25;77;24;1;23;.958;3600000;0
2917;34786;12;39;28;4;24;.857;3600000;0
2919;738;27;0;0;0;0;.00nan;0;0
2919;1572;4838;53;3;0;3;1.000;263000;0
2919;2328;4838;44;41;6;35;.854;3337000;0
2919;26623;27;88;33;3;30;.909;3600000;0
2921;4506;33;0;0;0;0;.00nan;0;0
2921;18078;20;55;22;3;19;.864;3595000;0
2921;32146;20;0;0;0;0;.00nan;0;0
2921;34740;33;77;30;2;28;.933;3600000;0
2923;1821;3;0;0;0;0;.00nan;0;0
2923;2054;3;69;33;4;29;.879;3543000;0
2923;10103;24;79;32;3;29;.906;3600000;0
2923;13979;24;0;0;0;0;.00nan;0;0
1312;780;52;0;0;0;0;.00nan;0;0
1312;23255;52;93;38;3;35;.921;3790000;0
1312;28772;53;0;0;0;0;.00nan;0;0
1312;31156;53;65;35;4;31;.886;3790000;0
1313;1486;43;0;0;0;0;.00nan;0;0
1313;2900;36;0;0;0;0;.00nan;0;0
1313;3625;43;89;33;1;32;.970;3600000;0
1313;14874;36;79;12;0;12;1.000;3600000;0
1314;6081;56;0;0;0;0;.00nan;0;0
1314;23493;51;0;0;0;0;.00nan;0;0
1314;26824;56;95;32;1;31;.969;3600000;0
1314;31408;51;54;27;4;23;.852;3600000;0
1315;37;46;62;30;3;27;.900;3546000;0
1315;2553;46;0;0;0;0;.00nan;0;0
1315;34788;42;0;0;0;0;.00nan;0;0
1315;37416;42;86;33;2;31;.939;3600000;0
1316;1051;44;0;0;0;0;.00nan;0;0
1316;3281;44;73;36;3;33;.917;3600000;0
1316;14351;40;97;21;0;21;1.000;3600000;0
1316;26840;40;0;0;0;0;.00nan;0;0
1317;3626;48;90;25;1;24;.960;3600000;0
1317;4716;4619;0;0;0;0;.00nan;0;0
1317;35210;4619;59;29;3;26;.897;3553000;0
1317;38547;48;0;0;0;0;.00nan;0;0
1318;1592;63;0;0;0;0;.00nan;0;0
1318;5883;37;0;0;0;0;.00nan;0;0
1318;23043;37;84;40;3;37;.925;3593000;0
1318;26967;63;87;36;2;34;.944;3600000;0
1319;2796;59;0;0;0;0;.00nan;0;0
1319;8046;57;0;0;0;0;.00nan;0;0
1319;26865;57;75;30;2;28;.933;3600000;0
1319;34819;59;51;26;4;22;.846;3537000;0
1320;4338;65;86;28;2;26;.929;3900000;0
1320;4987;65;0;0;0;0;.00nan;0;0
1320;19640;41;0;0;0;0;.00nan;0;0
1320;23075;41;100;38;2;36;.947;3900000;0
1321;1486;43;96;25;0;25;1.000;3600000;0
1321;2900;36;0;0;0;0;.00nan;0;0
1321;3625;43;0;0;0;0;.00nan;0;0
1321;14874;36;70;29;3;26;.897;3600000;0
1322;6081;56;99;41;1;40;.976;3600000;0
1322;23493;51;44;32;5;27;.844;3600000;0
1322;26824;56;0;0;0;0;.00nan;0;0
1322;31408;51;0;0;0;0;.00nan;0;0
1323;37;46;0;0;0;0;.00nan;0;0
1323;2553;46;49;29;4;25;.862;3600000;0
1323;4447;54;0;0;0;0;.00nan;0;0
1323;31643;54;90;18;0;18;1.000;3600000;0
1324;780;52;85;30;2;28;.933;3900000;0
1324;3847;38;0;0;0;0;.00nan;0;0
1324;23255;52;0;0;0;0;.00nan;0;0
1324;31021;38;68;25;2;23;.920;3900000;0
1325;5137;58;0;0;0;0;.00nan;0;0
1325;14321;58;67;22;3;19;.864;3600000;0
1325;28772;53;53;9;1;8;.889;509000;0
1325;31156;53;43;34;6;28;.824;3091000;0
1326;5146;64;0;0;0;0;.00nan;0;0
1326;14323;64;51;18;2;16;.889;3600000;0
1326;34788;42;69;58;7;51;.879;3600000;0
1326;37416;42;0;0;0;0;.00nan;0;0
1327;3;50;88;35;1;34;.971;3561000;0
1327;2198;45;100;28;0;28;1.000;3600000;0
1327;5048;50;0;0;0;0;.00nan;0;0
1327;36703;45;0;0;0;0;.00nan;0;0
1328;2152;49;0;0;0;0;.00nan;0;0
1328;4435;49;81;28;1;27;.964;3600000;0
1328;6572;62;0;0;0;0;.00nan;0;0
1328;26919;62;22;24;6;18;.750;3600000;0
1329;1051;44;43;23;4;19;.826;3600000;0
1329;3281;44;0;0;0;0;.00nan;0;0
1329;14351;40;85;31;2;29;.935;3600000;0
1329;26840;40;0;0;0;0;.00nan;0;0
1330;2016;61;0;0;0;0;.00nan;0;0
1330;7049;47;0;0;0;0;.00nan;0;0
1330;30971;61;38;24;4;20;.833;3593000;0
1330;33654;47;92;33;1;32;.970;3600000;0
1331;3847;38;73;36;3;33;.917;3556000;0
1331;28772;53;84;38;2;36;.947;3600000;0
1331;31021;38;0;0;0;0;.00nan;0;0
1331;31156;53;0;0;0;0;.00nan;0;0
1332;4338;65;0;0;0;0;.00nan;0;0
1332;4987;65;30;15;4;11;.733;3600000;0
1332;8046;57;77;25;1;24;.960;3600000;0
1332;26865;57;0;0;0;0;.00nan;0;0
1333;907;39;0;0;0;0;.00nan;0;0
1333;5298;55;55;36;5;31;.861;3600000;0
1333;9238;39;65;16;1;15;.938;3600000;0
1333;34770;55;0;0;0;0;.00nan;0;0
1334;2796;59;58;27;3;24;.889;3600000;0
1334;19640;41;53;26;4;22;.846;3564000;0
1334;23075;41;0;0;0;0;.00nan;0;0
1334;34819;59;0;0;0;0;.00nan;0;0
1335;780;52;61;7;0;7;1.000;1478000;0
1335;5137;58;96;41;1;40;.976;3600000;0
1335;14321;58;0;0;0;0;.00nan;0;0
1335;23255;52;37;24;5;19;.792;2122000;0
1336;1592;63;49;39;5;34;.872;3600000;0
1336;5883;37;68;20;1;19;.950;3600000;0
1336;23043;37;0;0;0;0;.00nan;0;0
1336;26967;63;0;0;0;0;.00nan;0;0
1337;3;50;67;10;0;10;1.000;1370000;0
1337;2198;45;67;32;3;29;.906;3600000;0
1337;5048;50;47;29;4;25;.862;2230000;0
1337;36703;45;0;0;0;0;.00nan;0;0
1338;7049;47;93;42;3;39;.929;3600000;0
1338;20717;60;0;0;0;0;.00nan;0;0
1338;33654;47;0;0;0;0;.00nan;0;0
1338;35536;60;100;38;0;38;1.000;3600000;0
1339;2016;61;68;34;5;29;.853;3686000;0
1339;2152;49;55;32;4;28;.875;3686000;0
1339;4435;49;0;0;0;0;.00nan;0;0
1339;30971;61;0;0;0;0;.00nan;0;0
1340;3626;48;0;0;0;0;.00nan;0;0
1340;4716;4619;0;0;0;0;.00nan;0;0
1340;35210;4619;92;25;1;24;.960;3600000;0
1340;38547;48;52;28;4;24;.857;3600000;0
1341;2016;61;0;0;0;0;.00nan;0;0
1341;2152;49;57;26;2;24;.923;3900000;0
1341;4435;49;0;0;0;0;.00nan;0;0
1341;30971;61;88;34;2;32;.941;3900000;0
1342;5883;37;91;40;2;38;.950;3600000;0
1342;23043;37;0;0;0;0;.00nan;0;0
1342;23493;51;0;0;0;0;.00nan;0;0
1342;31408;51;85;36;3;33;.917;3544000;0
1343;4338;65;0;0;0;0;.00nan;0;0
1343;4987;65;63;32;3;29;.906;3600000;0
1343;19640;41;0;0;0;0;.00nan;0;0
1343;23075;41;57;36;5;31;.861;3545000;0
1344;3847;38;82;27;2;25;.926;3900000;0
1344;5298;55;0;0;0;0;.00nan;0;0
1344;31021;38;0;0;0;0;.00nan;0;0
1344;34770;55;71;25;2;23;.920;3900000;0
1345;1486;43;91;19;0;19;1.000;3600000;0
1345;3625;43;0;0;0;0;.00nan;0;0
1345;6081;56;76;27;2;25;.926;3512000;0
1345;26824;56;0;0;0;0;.00nan;0;0
1346;2796;59;0;0;0;0;.00nan;0;0
1346;28772;53;0;0;0;0;.00nan;0;0
1346;31156;53;98;51;1;50;.980;3600000;0
1346;34819;59;79;26;2;24;.923;3578000;0
1347;780;52;0;0;0;0;.00nan;0;0
1347;5137;58;43;24;4;20;.833;3600000;0
1347;14321;58;0;0;0;0;.00nan;0;0
1347;23255;52;23;32;7;25;.781;3600000;0
1348;907;39;0;0;0;0;.00nan;0;0
1348;2900;36;0;0;0;0;.00nan;0;0
1348;9238;39;85;31;1;30;.968;3600000;0
1348;14874;36;18;29;7;22;.759;3600000;0
1349;37;46;0;0;0;0;.00nan;0;0
1349;2553;46;39;23;4;19;.826;3547000;0
1349;5883;37;49;21;3;18;.857;3600000;0
1349;23043;37;0;0;0;0;.00nan;0;0
1350;4447;54;0;0;0;0;.00nan;0;0
1350;5146;64;0;0;0;0;.00nan;0;0
1350;14323;64;53;25;3;22;.880;3600000;0
1350;31643;54;43;19;4;15;.789;3578000;0
1351;3;50;57;24;3;21;.875;3900000;0
1351;5048;50;0;0;0;0;.00nan;0;0
1351;34788;42;0;0;0;0;.00nan;0;0
1351;37416;42;70;34;3;31;.912;3900000;0
1352;4716;4619;68;25;2;23;.920;3600000;0
1352;20717;60;0;0;0;0;.00nan;0;0
1352;35210;4619;0;0;0;0;.00nan;0;0
1352;35536;60;66;33;4;29;.879;3534000;0
1353;2152;49;60;26;3;23;.885;3600000;0
1353;4435;49;0;0;0;0;.00nan;0;0
1353;7049;47;72;30;2;28;.933;3600000;0
1353;33654;47;0;0;0;0;.00nan;0;0
1354;6572;62;0;0;0;0;.00nan;0;0
1354;14351;40;63;24;2;22;.917;3900000;0
1354;26840;40;0;0;0;0;.00nan;0;0
1354;26919;62;70;31;2;29;.935;3900000;0
1355;2016;61;88;31;1;30;.968;3600000;0
1355;3626;48;85;41;3;38;.927;3578000;0
1355;30971;61;0;0;0;0;.00nan;0;0
1355;38547;48;0;0;0;0;.00nan;0;0
1356;1592;63;0;0;0;0;.00nan;0;0
1356;2163;39;67;28;3;25;.893;3600000;0
1356;9238;39;0;0;0;0;.00nan;0;0
1356;26967;63;67;38;4;34;.895;3550000;0
1357;4338;65;59;27;3;24;.889;3566000;0
1357;4987;65;0;0;0;0;.00nan;0;0
1357;19640;41;99;39;1;38;.974;3600000;0
1357;23075;41;0;0;0;0;.00nan;0;0
1358;780;52;89;35;2;33;.943;3589000;0
1358;5137;58;0;0;0;0;.00nan;0;0
1358;14321;58;93;37;1;36;.973;3600000;0
1358;23255;52;0;0;0;0;.00nan;0;0
1359;2900;36;60;28;4;24;.857;3540000;0
1359;5298;55;97;36;2;34;.944;3600000;0
1359;14874;36;0;0;0;0;.00nan;0;0
1359;34770;55;0;0;0;0;.00nan;0;0
1360;1486;43;64;21;2;19;.905;3600000;0
1360;3625;43;0;0;0;0;.00nan;0;0
1360;6081;56;0;0;0;0;.00nan;0;0
1360;26824;56;33;27;5;22;.815;3600000;0
1361;3;50;0;0;0;0;.00nan;0;0
1361;5048;50;65;28;3;25;.893;3600000;0
1361;34788;42;60;37;6;31;.838;3600000;0
1361;37416;42;0;0;0;0;.00nan;0;0
1362;3847;38;0;0;0;0;.00nan;0;0
1362;23493;51;43;33;6;27;.818;3600000;0
1362;31021;38;78;34;3;31;.912;3600000;0
1362;31408;51;0;0;0;0;.00nan;0;0
1363;8046;57;0;0;0;0;.00nan;0;0
1363;26865;57;71;34;3;31;.912;3600000;0
1363;28772;53;0;0;0;0;.00nan;0;0
1363;31156;53;46;24;4;20;.833;3561000;0
1364;4447;54;79;45;4;41;.911;3600000;0
1364;5146;64;100;46;2;44;.957;3600000;0
1364;14323;64;0;0;0;0;.00nan;0;0
1364;31643;54;0;0;0;0;.00nan;0;0
1365;2152;49;0;0;0;0;.00nan;0;0
1365;4435;49;62;33;4;29;.879;3600000;0
1365;6572;62;93;33;1;32;.970;3600000;0
1365;26919;62;0;0;0;0;.00nan;0;0
1366;4716;4619;0;0;0;0;.00nan;0;0
1366;20717;60;68;36;4;32;.889;3600000;0
1366;35210;4619;73;26;2;24;.923;3600000;0
1366;35536;60;0;0;0;0;.00nan;0;0
1367;7049;47;0;0;0;0;.00nan;0;0
1367;14351;40;0;0;0;0;.00nan;0;0
1367;26840;40;77;35;3;32;.914;3544000;0
1367;33654;47;55;19;2;17;.895;3600000;0
1368;1051;44;53;25;3;22;.880;3560000;0
1368;2198;45;0;0;0;0;.00nan;0;0
1368;3281;44;0;0;0;0;.00nan;0;0
1368;36703;45;86;36;2;34;.944;3600000;0
1369;780;52;0;0;0;0;.00nan;0;0
1369;23255;52;69;25;2;23;.920;3600000;0
1369;23493;51;0;0;0;0;.00nan;0;0
1369;31408;51;78;35;3;32;.914;3543000;0
1370;323;46;73;36;3;33;.917;3900000;0
1370;2553;46;0;0;0;0;.00nan;0;0
1370;5883;37;44;20;3;17;.850;3900000;0
1370;23043;37;0;0;0;0;.00nan;0;0
1371;3847;38;79;25;1;24;.960;3600000;0
1371;5137;58;75;30;2;28;.933;3600000;0
1371;14321;58;0;0;0;0;.00nan;0;0
1371;31021;38;0;0;0;0;.00nan;0;0
1372;2796;59;0;0;0;0;.00nan;0;0
1372;8046;57;46;35;5;30;.857;3900000;0
1372;26865;57;0;0;0;0;.00nan;0;0
1372;34819;59;69;33;5;28;.848;3900000;0
1373;1486;43;0;0;0;0;.00nan;0;0
1373;1592;63;72;30;2;28;.933;3521000;0
1373;3625;43;100;27;0;27;1.000;3600000;0
1373;26967;63;0;0;0;0;.00nan;0;0
1374;1051;44;0;0;0;0;.00nan;0;0
1374;2198;45;76;32;2;30;.938;3543000;0
1374;3281;44;74;21;1;20;.952;3600000;0
1374;36703;45;0;0;0;0;.00nan;0;0
1375;2016;61;64;18;1;17;.944;3600000;0
1375;3626;48;38;33;6;27;.818;2555000;0
1375;30971;61;0;0;0;0;.00nan;0;0
1375;38547;48;35;5;2;3;.600;1045000;0
1376;2900;36;0;0;0;0;.00nan;0;0
1376;4338;65;86;35;2;33;.943;3600000;0
1376;4987;65;0;0;0;0;.00nan;0;0
1376;14874;36;46;32;5;27;.844;3600000;0
1377;2163;39;0;0;0;0;.00nan;0;0
1377;6081;56;97;56;3;53;.946;3578000;0
1377;9238;39;80;25;1;24;.960;3600000;0
1377;26824;56;0;0;0;0;.00nan;0;0
1378;323;46;60;23;2;21;.913;3900000;0
1378;2553;46;0;0;0;0;.00nan;0;0
1378;5146;64;0;0;0;0;.00nan;0;0
1378;14323;64;67;24;2;22;.917;3900000;0
1379;2796;59;0;0;0;0;.00nan;0;0
1379;8046;57;0;0;0;0;.00nan;0;0
1379;26865;57;32;30;5;25;.833;3600000;0
1379;34819;59;76;31;2;29;.935;3600000;0
1380;1592;63;46;40;6;34;.850;2942000;0
1380;23493;51;0;0;0;0;.00nan;0;0
1380;26967;63;41;3;1;2;.667;658000;0
1380;31408;51;83;30;2;28;.933;3600000;0
1381;4716;4619;0;0;0;0;.00nan;0;0
1381;7049;47;89;50;3;47;.940;3563000;0
1381;33654;47;0;0;0;0;.00nan;0;0
1381;35210;4619;77;23;2;21;.913;3600000;0
1382;2198;45;80;24;1;23;.958;3600000;0
1382;34788;42;48;32;6;26;.813;3600000;0
1382;36703;45;0;0;0;0;.00nan;0;0
1382;37416;42;0;0;0;0;.00nan;0;0
1383;3626;48;0;0;0;0;.00nan;0;0
1383;7049;47;13;10;5;5;.500;765000;0
1383;33654;47;67;13;1;12;.923;2835000;0
1383;38547;48;67;32;3;29;.906;3600000;0
1384;2796;59;0;0;0;0;.00nan;0;0
1384;28772;53;0;0;0;0;.00nan;0;0
1384;31156;53;66;31;3;28;.903;3544000;0
1384;34819;59;85;38;2;36;.947;3600000;0
1385;1486;43;73;11;0;11;1.000;1194000;0
1385;2900;36;18;7;4;3;.429;1005000;0
1385;3625;43;12;21;7;14;.667;2706000;0
1385;14874;36;53;30;3;27;.900;2895000;0
1386;3533;57;0;0;0;0;.00nan;0;0
1386;5298;55;29;7;3;4;.571;313000;0
1386;26865;57;89;37;3;34;.919;3600000;0
1386;34770;55;79;43;3;40;.930;3269000;0
1387;1592;63;57;40;5;35;.875;3600000;0
1387;6081;56;0;0;0;0;.00nan;0;0
1387;26824;56;72;19;1;18;.947;3600000;0
1387;26967;63;0;0;0;0;.00nan;0;0
1388;2163;39;92;26;1;25;.962;3600000;0
1388;9238;39;0;0;0;0;.00nan;0;0
1388;23493;51;0;0;0;0;.00nan;0;0
1388;31408;51;69;34;4;30;.882;3600000;0
1389;3847;38;0;0;0;0;.00nan;0;0
1389;19640;41;38;38;6;32;.842;3600000;0
1389;23075;41;0;0;0;0;.00nan;0;0
1389;31021;38;100;29;0;29;1.000;3600000;0
1390;4447;54;65;29;3;26;.897;3600000;0
1390;5146;64;0;0;0;0;.00nan;0;0
1390;14323;64;36;26;5;21;.808;3580000;0
1390;31643;54;0;0;0;0;.00nan;0;0
1391;4716;4619;92;32;2;30;.938;3900000;0
1391;20717;60;0;0;0;0;.00nan;0;0
1391;35210;4619;0;0;0;0;.00nan;0;0
1391;35536;60;74;31;2;29;.935;3900000;0
1392;1051;44;0;0;0;0;.00nan;0;0
1392;3281;44;60;31;4;27;.871;3579000;0
1392;6572;62;0;0;0;0;.00nan;0;0
1392;26919;62;80;34;2;32;.941;3600000;0
1393;2016;61;75;28;2;26;.929;3591000;0
1393;2152;49;92;23;0;23;1.000;3600000;0
1393;4435;49;0;0;0;0;.00nan;0;0
1393;30971;61;0;0;0;0;.00nan;0;0
1394;2163;39;0;0;0;0;.00nan;0;0
1394;9238;39;74;20;1;19;.950;3600000;0
1394;23493;51;86;33;2;31;.939;3547000;0
1394;31408;51;0;0;0;0;.00nan;0;0
1395;3;50;0;0;0;0;.00nan;0;0
1395;5048;50;77;24;2;22;.917;3670000;0
1395;5883;37;100;36;1;35;.972;3670000;0
1395;23043;37;0;0;0;0;.00nan;0;0
1396;1592;63;0;0;0;0;.00nan;0;0
1396;6081;56;100;31;1;30;.968;3600000;0
1396;26824;56;0;0;0;0;.00nan;0;0
1396;26967;63;23;32;7;25;.781;3600000;0
1397;19640;41;0;0;0;0;.00nan;0;0
1397;23075;41;63;32;3;29;.906;3600000;0
1397;28772;53;43;36;6;30;.833;3063000;0
1397;31156;53;57;4;0;4;1.000;537000;0
1398;780;52;0;0;0;0;.00nan;0;0
1398;3847;38;0;0;0;0;.00nan;0;0
1398;31021;38;64;33;4;29;.879;3514000;0
1398;32146;52;70;23;2;21;.913;3600000;0
1399;1486;43;100;54;2;52;.963;3600000;0
1399;3625;43;0;0;0;0;.00nan;0;0
1399;4338;65;0;0;0;0;.00nan;0;0
1399;4987;65;78;29;3;26;.897;3600000;0
1400;323;46;0;0;0;0;.00nan;0;0
1400;2553;46;81;31;2;29;.935;3644000;0
1400;4447;54;0;0;0;0;.00nan;0;0
1400;31643;54;62;21;3;18;.857;3645000;0
1401;2900;36;86;36;2;34;.944;3600000;0
1401;3533;57;61;25;3;22;.880;3600000;0
1401;14874;36;0;0;0;0;.00nan;0;0
1401;26865;57;0;0;0;0;.00nan;0;0
1402;2796;59;70;31;3;28;.903;3600000;0
1402;5137;58;0;0;0;0;.00nan;0;0
1402;14321;58;67;23;2;21;.913;3600000;0
1402;34819;59;0;0;0;0;.00nan;0;0
1403;2198;45;0;0;0;0;.00nan;0;0
1403;34788;42;0;0;0;0;.00nan;0;0
1403;36703;45;76;34;3;31;.912;3613000;0
1403;37416;42;79;42;4;38;.905;3613000;0
1404;4716;4619;0;0;0;0;.00nan;0;0
1404;14351;40;100;31;0;31;1.000;3600000;0
1404;26840;40;0;0;0;0;.00nan;0;0
1404;35210;4619;64;30;3;27;.900;3600000;0
1405;1051;44;82;40;3;37;.925;3553000;0
1405;3281;44;0;0;0;0;.00nan;0;0
1405;6572;62;80;27;2;25;.926;3600000;0
1405;26919;62;0;0;0;0;.00nan;0;0
1406;3626;48;90;35;1;34;.971;3600000;0
1406;7049;47;64;23;2;21;.913;3567000;0
1406;33654;47;0;0;0;0;.00nan;0;0
1406;38547;48;0;0;0;0;.00nan;0;0
1407;2016;61;0;0;0;0;.00nan;0;0
1407;2152;49;64;31;3;28;.903;3600000;0
1407;4435;49;0;0;0;0;.00nan;0;0
1407;30971;61;100;23;0;23;1.000;3600000;0
1408;5137;58;96;32;1;31;.969;3600000;0
1408;14321;58;0;0;0;0;.00nan;0;0
1408;19640;41;88;17;0;17;1.000;3600000;0
1408;23075;41;0;0;0;0;.00nan;0;0
1409;780;52;100;39;0;39;1.000;3600000;0
1409;28772;53;0;0;0;0;.00nan;0;0
1409;31156;53;82;32;2;30;.938;3568000;0
1409;32146;52;0;0;0;0;.00nan;0;0
1410;3;50;77;33;4;29;.879;3900000;0
1410;5048;50;0;0;0;0;.00nan;0;0
1410;5883;37;0;0;0;0;.00nan;0;0
1410;23043;37;61;33;4;29;.879;3900000;0
1411;323;46;64;30;4;26;.867;3655000;0
1411;2553;46;0;0;0;0;.00nan;0;0
1411;5146;64;0;0;0;0;.00nan;0;0
1411;14323;64;64;49;5;44;.898;3655000;0
1412;1486;43;0;0;0;0;.00nan;0;0
1412;3625;43;87;46;3;43;.935;3900000;0
1412;4338;65;50;21;3;18;.857;3900000;0
1412;4987;65;0;0;0;0;.00nan;0;0
1413;14351;40;45;29;6;23;.793;3726000;0
1413;20717;60;0;0;0;0;.00nan;0;0
1413;26840;40;0;0;0;0;.00nan;0;0
1413;35536;60;70;46;5;41;.891;3726000;0
1414;2198;45;81;37;3;34;.919;3600000;0
1414;4716;4619;42;33;6;27;.818;3600000;0
1414;35210;4619;0;0;0;0;.00nan;0;0
1414;36703;45;0;0;0;0;.00nan;0;0
1415;2796;59;0;0;0;0;.00nan;0;0
1415;3533;57;0;0;0;0;.00nan;0;0
1415;26865;57;52;43;6;37;.860;3600000;0
1415;34819;59;70;19;1;18;.947;3600000;0
1416;2163;39;0;0;0;0;.00nan;0;0
1416;6081;56;98;45;2;43;.956;3546000;0
1416;9238;39;73;21;1;20;.952;3600000;0
1416;26824;56;0;0;0;0;.00nan;0;0
1417;2198;45;0;0;0;0;.00nan;0;0
1417;4716;4619;0;0;0;0;.00nan;0;0
1417;35210;4619;70;27;3;24;.889;3600000;0
1417;36703;45;100;28;0;28;1.000;3600000;0
1418;14351;40;0;0;0;0;.00nan;0;0
1418;20717;60;0;0;0;0;.00nan;0;0
1418;26840;40;98;50;2;48;.960;3563000;0
1418;35536;60;78;26;1;25;.962;3600000;0
1419;2152;49;69;32;3;29;.906;3578000;0
1419;3626;48;0;0;0;0;.00nan;0;0
1419;4435;49;0;0;0;0;.00nan;0;0
1419;38547;48;77;32;2;30;.938;3600000;0
1420;780;52;100;34;0;34;1.000;3600000;0
1420;28772;53;96;36;1;35;.972;3557000;0
1420;31156;53;0;0;0;0;.00nan;0;0
1420;32146;52;0;0;0;0;.00nan;0;0
1421;2900;36;0;0;0;0;.00nan;0;0
1421;5298;55;58;26;4;22;.846;3600000;0
1421;14874;36;70;28;3;25;.893;3600000;0
1421;34770;55;0;0;0;0;.00nan;0;0
1422;1486;43;39;23;4;19;.826;3705000;0
1422;3625;43;0;0;0;0;.00nan;0;0
1422;6081;56;0;0;0;0;.00nan;0;0
1422;26824;56;88;53;5;48;.906;3701000;0
1423;3;50;69;22;2;20;.909;3600000;0
1423;323;46;0;0;0;0;.00nan;0;0
1423;2553;46;58;23;3;20;.870;3543000;0
1423;5048;50;0;0;0;0;.00nan;0;0
1424;2796;59;47;14;2;12;.857;1554000;0
1424;3847;38;63;26;3;23;.885;3600000;0
1424;31021;38;0;0;0;0;.00nan;0;0
1424;34819;59;28;14;4;10;.714;2046000;0
1425;4338;65;80;25;1;24;.960;3600000;0
1425;4987;65;0;0;0;0;.00nan;0;0
1425;5137;58;0;0;0;0;.00nan;0;0
1425;14321;58;93;49;3;46;.939;3600000;0
1426;1592;63;0;0;0;0;.00nan;0;0
1426;2163;39;0;0;0;0;.00nan;0;0
1426;9238;39;55;25;3;22;.880;3600000;0
1426;26967;63;56;34;5;29;.853;3551000;0
1427;4447;54;49;15;2;13;.867;3069000;0
1427;5883;37;82;42;3;39;.929;3600000;0
1427;23043;37;0;0;0;0;.00nan;0;0
1427;31643;54;21;3;3;0;.000;531000;0
1428;6572;62;47;33;5;28;.848;3600000;0
1428;7049;47;20;23;6;17;.739;1633000;0
1428;26919;62;0;0;0;0;.00nan;0;0
1428;33654;47;67;12;0;12;1.000;1938000;0
1429;2016;61;0;0;0;0;.00nan;0;0
1429;14351;40;0;0;0;0;.00nan;0;0
1429;26840;40;88;42;3;39;.929;3600000;0
1429;30971;61;40;21;4;17;.810;3571000;0
1430;1051;44;83;21;1;20;.952;3600000;0
1430;3281;44;0;0;0;0;.00nan;0;0
1430;3626;48;72;39;3;36;.923;3558000;0
1430;38547;48;0;0;0;0;.00nan;0;0
1431;2198;45;0;0;0;0;.00nan;0;0
1431;20717;60;0;0;0;0;.00nan;0;0
1431;35536;60;70;37;4;33;.892;3600000;0
1431;36703;45;100;29;0;29;1.000;3600000;0
1432;3533;57;0;0;0;0;.00nan;0;0
1432;19640;41;74;22;1;21;.955;3600000;0
1432;23075;41;0;0;0;0;.00nan;0;0
1432;26865;57;44;55;8;47;.855;3600000;0
1433;2796;59;0;0;0;0;.00nan;0;0
1433;28772;53;0;0;0;0;.00nan;0;0
1433;31156;53;61;32;3;29;.906;3900000;0
1433;34819;59;70;32;3;29;.906;3900000;0
1434;780;52;0;0;0;0;.00nan;0;0
1434;5137;58;82;43;4;39;.907;3600000;0
1434;14321;58;0;0;0;0;.00nan;0;0
1434;32146;52;61;30;3;27;.900;3600000;0
1435;3847;38;43;3;1;2;.667;711000;0
1435;4338;65;0;0;0;0;.00nan;0;0
1435;4987;65;52;24;4;20;.833;3600000;0
1435;31021;38;29;32;6;26;.813;2889000;0
1436;2900;36;12;16;6;10;.625;2132000;0
1436;14874;36;66;9;0;9;1.000;1442000;0
1436;23493;51;0;0;0;0;.00nan;0;0
1436;31408;51;38;23;5;18;.783;3600000;0
1437;1486;43;62;13;1;12;.923;3600000;0
1437;3625;43;0;0;0;0;.00nan;0;0
1437;6081;56;51;23;3;20;.870;3570000;0
1437;26824;56;0;0;0;0;.00nan;0;0
1438;1592;63;90;44;3;41;.932;3600000;0
1438;5298;55;0;0;0;0;.00nan;0;0
1438;26967;63;0;0;0;0;.00nan;0;0
1438;34770;55;70;28;2;26;.929;3600000;0
1439;3;50;0;0;0;0;.00nan;0;0
1439;4447;54;0;0;0;0;.00nan;0;0
1439;5048;50;76;35;3;32;.914;3900000;0
1439;31643;54;62;27;3;24;.889;3900000;0
1440;323;46;76;28;2;26;.929;3600000;0
1440;2553;46;0;0;0;0;.00nan;0;0
1440;34788;42;0;0;0;0;.00nan;0;0
1440;37416;42;67;30;3;27;.900;3557000;0
1441;5146;64;46;19;3;16;.842;3553000;0
1441;5883;37;100;43;1;42;.977;3600000;0
1441;14323;64;0;0;0;0;.00nan;0;0
1441;23043;37;0;0;0;0;.00nan;0;0
1442;2016;61;71;38;4;34;.895;3600000;0
1442;14351;40;41;32;5;27;.844;3560000;0
1442;26840;40;0;0;0;0;.00nan;0;0
1442;30971;61;0;0;0;0;.00nan;0;0
1443;2152;49;65;20;1;19;.950;3600000;0
1443;4435;49;0;0;0;0;.00nan;0;0
1443;7049;47;0;0;0;0;.00nan;0;0
1443;33654;47;68;32;3;29;.906;3556000;0
1444;4716;4619;57;17;2;15;.882;3900000;0
1444;6572;62;0;0;0;0;.00nan;0;0
1444;26919;62;95;48;2;46;.958;3900000;0
1444;35210;4619;0;0;0;0;.00nan;0;0
1445;1051;44;0;0;0;0;.00nan;0;0
1445;3281;44;54;24;3;21;.875;3600000;0
1445;3626;48;0;0;0;0;.00nan;0;0
1445;38547;48;35;35;6;29;.829;3600000;0
1446;3533;57;57;22;3;19;.864;3544000;0
1446;19640;41;0;0;0;0;.00nan;0;0
1446;23075;41;95;38;2;36;.947;3600000;0
1446;26865;57;0;0;0;0;.00nan;0;0
1447;780;52;95;21;0;21;1.000;3600000;0
1447;28772;53;74;37;4;33;.892;3600000;0
1447;31156;53;0;0;0;0;.00nan;0;0
1447;32146;52;0;0;0;0;.00nan;0;0
1448;4338;65;50;31;5;26;.839;3600000;0
1448;4987;65;0;0;0;0;.00nan;0;0
1448;5137;58;0;0;0;0;.00nan;0;0
1448;14321;58;76;22;1;21;.955;3600000;0
1449;4447;54;54;42;5;37;.881;3524000;0
1449;5146;64;0;0;0;0;.00nan;0;0
1449;14323;64;66;28;3;25;.893;3600000;0
1449;31643;54;0;0;0;0;.00nan;0;0
1450;5298;55;65;35;4;31;.886;3900000;0
1450;23493;51;65;32;4;28;.875;3900000;0
1450;31408;51;0;0;0;0;.00nan;0;0
1450;34770;55;0;0;0;0;.00nan;0;0
1451;5883;37;78;40;4;36;.900;3600000;0
1451;23043;37;0;0;0;0;.00nan;0;0
1451;34788;42;100;22;0;22;1.000;3600000;0
1451;37416;42;0;0;0;0;.00nan;0;0
1452;2152;49;51;7;1;6;.857;732000;0
1452;4435;49;28;27;6;21;.778;2868000;0
1452;4716;4619;0;0;0;0;.00nan;0;0
1452;35210;4619;61;32;3;29;.906;3600000;0
1453;2198;45;0;0;0;0;.00nan;0;0
1453;20717;60;79;33;2;31;.939;3900000;0
1453;35536;60;0;0;0;0;.00nan;0;0
1453;36703;45;97;40;2;38;.950;3900000;0
1454;3533;57;42;24;4;20;.833;3600000;0
1454;4338;65;100;28;0;28;1.000;3600000;0
1454;4987;65;0;0;0;0;.00nan;0;0
1454;26865;57;0;0;0;0;.00nan;0;0
1455;780;52;99;25;0;25;1.000;3600000;0
1455;2900;36;0;0;0;0;.00nan;0;0
1455;14874;36;67;21;1;20;.952;3600000;0
1455;32146;52;0;0;0;0;.00nan;0;0
1456;3847;38;63;28;3;25;.893;3574000;0
1456;5137;58;0;0;0;0;.00nan;0;0
1456;14321;58;86;30;1;29;.967;3600000;0
1456;31021;38;0;0;0;0;.00nan;0;0
1457;2163;39;49;35;5;30;.857;3600000;0
1457;2796;59;0;0;0;0;.00nan;0;0
1457;9238;39;0;0;0;0;.00nan;0;0
1457;34819;59;75;29;2;27;.931;3600000;0
1458;6081;56;75;25;1;24;.960;3600000;0
1458;23493;51;0;0;0;0;.00nan;0;0
1458;26824;56;0;0;0;0;.00nan;0;0
1458;31408;51;42;31;5;26;.839;3600000;0
1459;4447;54;77;21;1;20;.952;3600000;0
1459;5883;37;67;34;3;31;.912;3549000;0
1459;23043;37;0;0;0;0;.00nan;0;0
1459;31643;54;0;0;0;0;.00nan;0;0
1460;3;50;0;0;0;0;.00nan;0;0
1460;5048;50;45;23;3;20;.870;3545000;0
1460;34788;42;82;34;2;32;.941;3600000;0
1460;37416;42;0;0;0;0;.00nan;0;0
1461;7049;47;70;29;2;27;.931;3600000;0
1461;14351;40;0;0;0;0;.00nan;0;0
1461;26840;40;21;17;5;12;.706;3600000;0
1461;33654;47;0;0;0;0;.00nan;0;0
1462;3626;48;0;0;0;0;.00nan;0;0
1462;6572;62;100;24;0;24;1.000;3600000;0
1462;33438;62;0;0;0;0;.00nan;0;0
1462;38547;48;49;23;3;20;.870;3600000;0
1463;2900;36;61;29;3;26;.897;3530000;0
1463;5298;55;0;0;0;0;.00nan;0;0
1463;14874;36;0;0;0;0;.00nan;0;0
1463;34770;55;85;28;1;27;.964;3600000;0
1464;780;52;23;21;6;15;.714;2443000;0
1464;23493;51;0;0;0;0;.00nan;0;0
1464;31408;51;61;37;5;32;.865;3600000;0
1464;32146;52;62;10;0;10;1.000;1103000;0
1465;323;46;79;29;2;27;.931;3900000;0
1465;2553;46;0;0;0;0;.00nan;0;0
1465;5883;37;64;26;2;24;.923;3900000;0
1465;23043;37;0;0;0;0;.00nan;0;0
1466;3533;57;80;25;1;24;.960;3552000;0
1466;3847;38;0;0;0;0;.00nan;0;0
1466;26865;57;0;0;0;0;.00nan;0;0
1466;31021;38;87;16;0;16;1.000;3600000;0
1467;2796;59;58;30;4;26;.867;3571000;0
1467;19640;41;0;0;0;0;.00nan;0;0
1467;23075;41;58;29;3;26;.897;3600000;0
1467;34819;59;0;0;0;0;.00nan;0;0
1468;5137;58;0;0;0;0;.00nan;0;0
1468;14321;58;78;33;3;30;.909;3600000;0
1468;28772;53;75;45;4;41;.911;3569000;0
1468;31156;53;0;0;0;0;.00nan;0;0
1469;1486;43;51;16;2;14;.875;3600000;0
1469;2163;39;0;0;0;0;.00nan;0;0
1469;3625;43;0;0;0;0;.00nan;0;0
1469;9238;39;94;28;1;27;.964;3600000;0
1470;5146;64;66;26;2;24;.923;3900000;0
1470;14323;64;0;0;0;0;.00nan;0;0
1470;34788;42;71;31;2;29;.935;3900000;0
1470;37416;42;0;0;0;0;.00nan;0;0
1471;2198;45;60;29;4;25;.862;3900000;0
1471;4716;4619;0;0;0;0;.00nan;0;0
1471;35210;4619;78;47;4;43;.915;3900000;0
1471;36703;45;0;0;0;0;.00nan;0;0
1472;1051;44;0;0;0;0;.00nan;0;0
1472;2152;49;86;30;1;29;.967;3600000;0
1472;3281;44;78;30;2;28;.933;3568000;0
1472;4435;49;0;0;0;0;.00nan;0;0
1473;6572;62;77;21;1;20;.952;3600000;0
1473;7049;47;72;31;2;29;.935;3599000;0
1473;33438;62;0;0;0;0;.00nan;0;0
1473;33654;47;0;0;0;0;.00nan;0;0
1474;3626;48;0;0;0;0;.00nan;0;0
1474;14351;40;80;35;2;33;.943;3578000;0
1474;26840;40;0;0;0;0;.00nan;0;0
1474;38547;48;100;38;1;37;.974;3600000;0
1475;2016;61;0;0;0;0;.00nan;0;0
1475;20717;60;0;0;0;0;.00nan;0;0
1475;30971;61;80;30;3;27;.900;3900000;0
1475;35536;60;92;42;3;39;.929;3900000;0
1476;5298;55;0;0;0;0;.00nan;0;0
1476;23493;51;59;27;3;24;.889;3543000;0
1476;31408;51;0;0;0;0;.00nan;0;0
1476;34770;55;87;31;2;29;.935;3600000;0
1477;2796;59;0;0;0;0;.00nan;0;0
1477;19640;41;47;22;3;19;.864;3514000;0
1477;23075;41;0;0;0;0;.00nan;0;0
1477;34819;59;91;37;1;36;.973;3600000;0
1478;1486;43;0;0;0;0;.00nan;0;0
1478;2163;39;66;30;3;27;.900;3600000;0
1478;3625;43;62;38;4;34;.895;3593000;0
1478;9238;39;0;0;0;0;.00nan;0;0
1479;2900;36;74;31;2;29;.935;3600000;0
1479;4338;65;44;38;6;32;.842;3600000;0
1479;4987;65;0;0;0;0;.00nan;0;0
1479;14874;36;0;0;0;0;.00nan;0;0
1480;780;52;0;0;0;0;.00nan;0;0
1480;6081;56;64;43;5;38;.884;3600000;0
1480;26824;56;0;0;0;0;.00nan;0;0
1480;32146;52;69;23;2;21;.913;3600000;0
1481;323;46;0;0;0;0;.00nan;0;0
1481;2553;46;84;27;1;26;.963;3600000;0
1481;5883;37;0;0;0;0;.00nan;0;0
1481;23043;37;55;24;3;21;.875;3588000;0
1482;3;50;0;0;0;0;.00nan;0;0
1482;4447;54;0;0;0;0;.00nan;0;0
1482;5048;50;68;32;3;29;.906;3569000;0
1482;31643;54;76;33;2;31;.939;3600000;0
1483;3847;38;0;0;0;0;.00nan;0;0
1483;28772;53;0;0;0;0;.00nan;0;0
1483;31021;38;68;43;5;38;.884;3600000;0
1483;31156;53;28;29;6;23;.793;3581000;0
1484;3533;57;0;0;0;0;.00nan;0;0
1484;5137;58;84;36;2;34;.944;3900000;0
1484;14321;58;0;0;0;0;.00nan;0;0
1484;26865;57;96;35;2;33;.943;3900000;0
1485;1592;63;46;43;6;37;.860;3600000;0
1485;5146;64;0;0;0;0;.00nan;0;0
1485;14323;64;24;34;7;27;.794;3574000;0
1485;34814;63;0;0;0;0;.00nan;0;0
1486;2198;45;0;0;0;0;.00nan;0;0
1486;4716;4619;66;33;4;29;.879;3553000;0
1486;10698;4619;0;0;0;0;.00nan;0;0
1486;36703;45;100;40;2;38;.950;3600000;0
1487;3626;48;96;39;3;36;.923;3600000;0
1487;14351;40;0;0;0;0;.00nan;0;0
1487;26840;40;48;26;4;22;.846;3569000;0
1487;38547;48;0;0;0;0;.00nan;0;0
1488;1051;44;24;5;3;2;.400;504000;0
1488;2152;49;0;0;0;0;.00nan;0;0
1488;3281;44;51;22;3;19;.864;3042000;0
1488;4435;49;55;32;4;28;.875;3600000;0
1489;6572;62;0;0;0;0;.00nan;0;0
1489;7049;47;0;0;0;0;.00nan;0;0
1489;33438;62;96;44;3;41;.932;3858000;0
1489;33654;47;82;38;3;35;.921;3900000;0
1490;5298;55;89;32;2;30;.938;3599000;0
1490;6081;56;0;0;0;0;.00nan;0;0
1490;26824;56;88;28;1;27;.964;3600000;0
1490;34770;55;0;0;0;0;.00nan;0;0
1491;1592;63;0;0;0;0;.00nan;0;0
1491;5146;64;91;33;1;32;.970;3600000;0
1491;14323;64;0;0;0;0;.00nan;0;0
1491;34814;63;87;48;4;44;.917;3600000;0
1492;3;50;51;26;4;22;.846;3600000;0
1492;4447;54;18;16;5;11;.688;3600000;0
1492;5048;50;0;0;0;0;.00nan;0;0
1492;31643;54;0;0;0;0;.00nan;0;0
1493;4338;65;0;0;0;0;.00nan;0;0
1493;4987;65;56;40;6;34;.850;3600000;0
1493;19640;41;0;0;0;0;.00nan;0;0
1493;23075;41;88;27;1;26;.963;3600000;0
1494;2016;61;86;40;2;38;.950;3600000;0
1494;20717;60;0;0;0;0;.00nan;0;0
1494;30971;61;0;0;0;0;.00nan;0;0
1494;35536;60;68;29;3;26;.897;3555000;0
1495;323;46;0;0;0;0;.00nan;0;0
1495;2553;46;82;47;3;44;.936;3514000;0
1495;5146;64;75;22;1;21;.955;3600000;0
1495;14323;64;0;0;0;0;.00nan;0;0
1496;780;52;0;0;0;0;.00nan;0;0
1496;28772;53;84;36;2;34;.944;3547000;0
1496;31156;53;0;0;0;0;.00nan;0;0
1496;32146;52;81;30;1;29;.967;3600000;0
1497;1592;63;82;36;2;34;.944;3600000;0
1497;23493;51;0;0;0;0;.00nan;0;0
1497;31408;51;59;28;3;25;.893;3596000;0
1497;34814;63;0;0;0;0;.00nan;0;0
1498;1486;43;76;29;2;27;.931;3600000;0
1498;2900;36;60;26;3;23;.885;3551000;0
1498;3625;43;0;0;0;0;.00nan;0;0
1498;14874;36;0;0;0;0;.00nan;0;0
1499;3533;57;49;6;1;5;.833;595000;0
1499;19640;41;0;0;0;0;.00nan;0;0
1499;23075;41;57;27;3;24;.889;3600000;0
1499;26865;57;34;31;6;25;.806;3005000;0
1500;2163;39;0;0;0;0;.00nan;0;0
1500;5298;55;0;0;0;0;.00nan;0;0
1500;9238;39;93;42;2;40;.952;3900000;0
1500;34770;55;92;33;2;31;.939;3900000;0
1501;7049;47;87;40;2;38;.950;3900000;0
1501;20717;60;80;36;2;34;.944;3900000;0
1501;33654;47;0;0;0;0;.00nan;0;0
1501;35536;60;0;0;0;0;.00nan;0;0
1502;4447;54;85;35;2;33;.943;3600000;0
1502;5883;37;71;33;4;29;.879;3587000;0
1502;23043;37;0;0;0;0;.00nan;0;0
1502;31643;54;0;0;0;0;.00nan;0;0
1503;1486;43;64;37;3;34;.919;3900000;0
1503;2900;36;98;45;3;42;.933;3900000;0
1503;3625;43;0;0;0;0;.00nan;0;0
1503;14874;36;0;0;0;0;.00nan;0;0
1504;5298;55;0;0;0;0;.00nan;0;0
1504;19640;41;64;21;2;19;.905;3900000;0
1504;23075;41;0;0;0;0;.00nan;0;0
1504;34770;55;77;30;2;28;.933;3900000;0
1505;3847;38;0;0;0;0;.00nan;0;0
1505;28772;53;73;33;3;30;.909;3549000;0
1505;31021;38;93;32;1;31;.969;3600000;0
1505;31156;53;0;0;0;0;.00nan;0;0
1506;2796;59;0;0;0;0;.00nan;0;0
1506;5137;58;0;0;0;0;.00nan;0;0
1506;14321;58;72;42;4;38;.905;3550000;0
1506;34819;59;53;17;2;15;.882;3600000;0
1507;2163;39;42;24;4;20;.833;3551000;0
1507;3533;57;56;28;3;25;.893;3600000;0
1507;9238;39;0;0;0;0;.00nan;0;0
1507;26865;57;0;0;0;0;.00nan;0;0
1508;4447;54;0;0;0;0;.00nan;0;0
1508;5883;37;79;25;2;23;.920;3556000;0
1508;23043;37;0;0;0;0;.00nan;0;0
1508;31643;54;100;25;0;25;1.000;3600000;0
1509;5146;64;100;21;0;21;1.000;3600000;0
1509;14323;64;0;0;0;0;.00nan;0;0
1509;34788;42;0;0;0;0;.00nan;0;0
1509;37416;42;97;47;1;46;.979;3545000;0
1510;323;46;71;28;3;25;.893;3900000;0
1510;2198;45;59;30;3;27;.900;3900000;0
1510;2553;46;0;0;0;0;.00nan;0;0
1510;36703;45;0;0;0;0;.00nan;0;0
1511;3;50;0;0;0;0;.00nan;0;0
1511;1051;44;0;0;0;0;.00nan;0;0
1511;3281;44;75;20;1;19;.950;3600000;0
1511;5048;50;59;23;3;20;.870;3558000;0
1512;3626;48;100;38;1;37;.974;3600000;0
1512;4716;4619;78;51;5;46;.902;3600000;0
1512;10698;4619;0;0;0;0;.00nan;0;0
1512;38547;48;0;0;0;0;.00nan;0;0
1513;6572;62;78;43;3;40;.930;3610000;0
1513;20717;60;0;0;0;0;.00nan;0;0
1513;33438;62;0;0;0;0;.00nan;0;0
1513;35536;60;80;30;2;28;.933;3610000;0
1514;2016;61;0;0;0;0;.00nan;0;0
1514;7049;47;0;0;0;0;.00nan;0;0
1514;30971;61;73;23;1;22;.957;3600000;0
1514;33654;47;58;30;3;27;.900;3577000;0
1515;1592;63;64;20;2;18;.900;3547000;0
1515;3533;57;0;0;0;0;.00nan;0;0
1515;26865;57;100;23;0;23;1.000;3600000;0
1515;34814;63;0;0;0;0;.00nan;0;0
1516;6572;62;0;0;0;0;.00nan;0;0
1516;20717;60;83;26;1;25;.962;3600000;0
1516;33438;62;68;30;3;27;.900;3558000;0
1516;35536;60;0;0;0;0;.00nan;0;0
1517;4338;65;0;0;0;0;.00nan;0;0
1517;4987;65;90;27;1;26;.963;3600000;0
1517;28772;53;0;0;0;0;.00nan;0;0
1517;31156;53;74;38;3;35;.921;3582000;0
1518;2163;39;0;0;0;0;.00nan;0;0
1518;5298;55;70;25;2;23;.920;3600000;0
1518;9238;39;68;33;3;30;.909;3575000;0
1518;34770;55;0;0;0;0;.00nan;0;0
1519;6081;56;23;12;4;8;.667;1078000;0
1519;23493;51;0;0;0;0;.00nan;0;0
1519;26824;56;66;15;0;15;1.000;2822000;0
1519;31408;51;54;24;4;20;.833;3900000;0
1520;2796;59;62;24;2;22;.917;3900000;0
1520;3847;38;100;46;2;44;.957;3891000;0
1520;31021;38;0;0;0;0;.00nan;0;0
1520;34819;59;0;0;0;0;.00nan;0;0
1521;780;52;0;0;0;0;.00nan;0;0
1521;5137;58;88;36;2;34;.944;3900000;0
1521;14321;58;0;0;0;0;.00nan;0;0
1521;32146;52;90;37;2;35;.946;3900000;0
1522;5146;64;34;34;6;28;.824;3195000;0
1522;14323;64;47;6;1;5;.833;405000;0
1522;34788;42;54;28;4;24;.857;3600000;0
1522;37416;42;0;0;0;0;.00nan;0;0
1523;323;46;0;0;0;0;.00nan;0;0
1523;2198;45;0;0;0;0;.00nan;0;0
1523;2553;46;76;32;2;30;.938;3900000;0
1523;36703;45;71;24;2;22;.917;3900000;0
1524;3626;48;0;0;0;0;.00nan;0;0
1524;4716;4619;0;0;0;0;.00nan;0;0
1524;10698;4619;64;16;2;14;.875;3600000;0
1524;38547;48;83;46;4;42;.913;3600000;0
1525;3;50;99;45;2;43;.956;3600000;0
1525;1051;44;55;4;0;4;1.000;375000;0
1525;3281;44;33;31;6;25;.806;3225000;0
1525;5048;50;0;0;0;0;.00nan;0;0
1526;780;52;77;20;1;19;.950;3600000;0
1526;5137;58;0;0;0;0;.00nan;0;0
1526;14321;58;96;50;3;47;.940;3558000;0
1526;32146;52;0;0;0;0;.00nan;0;0
1527;4447;54;0;0;0;0;.00nan;0;0
1527;5883;37;0;0;0;0;.00nan;0;0
1527;23043;37;65;35;4;31;.886;3544000;0
1527;31643;54;61;22;3;19;.864;3600000;0
1528;1486;43;0;0;0;0;.00nan;0;0
1528;3625;43;78;31;2;29;.935;3600000;0
1528;26967;63;0;0;0;0;.00nan;0;0
1528;34814;63;67;39;4;35;.897;3518000;0
1529;4338;65;63;35;4;31;.886;3600000;0
1529;4987;65;0;0;0;0;.00nan;0;0
1529;19640;41;35;29;5;24;.828;3585000;0
1529;23075;41;0;0;0;0;.00nan;0;0
1530;2152;49;44;19;3;16;.842;3554000;0
1530;4435;49;0;0;0;0;.00nan;0;0
1530;14351;40;0;0;0;0;.00nan;0;0
1530;26840;40;89;42;2;40;.952;3600000;0
1531;2016;61;0;0;0;0;.00nan;0;0
1531;7049;47;44;36;5;31;.861;3600000;0
1531;30971;61;100;35;0;35;1.000;3600000;0
1531;33654;47;0;0;0;0;.00nan;0;0
1532;2152;49;0;0;0;0;.00nan;0;0
1532;4435;49;78;30;2;28;.933;3600000;0
1532;14351;40;45;28;4;24;.857;3511000;0
1532;26840;40;0;0;0;0;.00nan;0;0
1533;2796;59;0;0;0;0;.00nan;0;0
1533;19640;41;95;21;0;21;1.000;3600000;0
1533;23075;41;0;0;0;0;.00nan;0;0
1533;34819;59;98;61;1;60;.984;3600000;0
1534;780;52;0;0;0;0;.00nan;0;0
1534;5137;58;0;0;0;0;.00nan;0;0
1534;14321;58;68;35;3;32;.914;3570000;0
1534;32146;52;75;22;1;21;.955;3600000;0
1535;3847;38;0;0;0;0;.00nan;0;0
1535;4338;65;83;29;1;28;.966;3600000;0
1535;4987;65;0;0;0;0;.00nan;0;0
1535;31021;38;97;38;2;36;.947;3600000;0
1536;2796;59;0;0;0;0;.00nan;0;0
1536;19640;41;28;24;5;19;.792;3562000;0
1536;23075;41;0;0;0;0;.00nan;0;0
1536;34819;59;71;38;4;34;.895;3600000;0
1537;2900;36;0;0;0;0;.00nan;0;0
1537;6081;56;0;0;0;0;.00nan;0;0
1537;14874;36;47;20;3;17;.850;3600000;0
1537;26824;56;40;36;6;30;.833;3600000;0
1538;2163;39;67;25;2;23;.920;3543000;0
1538;5298;55;0;0;0;0;.00nan;0;0
1538;9238;39;0;0;0;0;.00nan;0;0
1538;34770;55;89;29;1;28;.966;3600000;0
1539;323;46;93;35;2;33;.943;3900000;0
1539;2553;46;0;0;0;0;.00nan;0;0
1539;4447;54;54;24;2;22;.917;3900000;0
1539;31643;54;0;0;0;0;.00nan;0;0
1540;6572;62;85;32;2;30;.938;3544000;0
1540;20717;60;86;30;1;29;.967;3600000;0
1540;33438;62;0;0;0;0;.00nan;0;0
1540;35536;60;0;0;0;0;.00nan;0;0
1541;5137;58;0;0;0;0;.00nan;0;0
1541;14321;58;79;33;2;31;.939;3542000;0
1541;28772;53;77;22;1;21;.955;3600000;0
1541;31156;53;0;0;0;0;.00nan;0;0
1542;780;52;0;0;0;0;.00nan;0;0
1542;3847;38;0;0;0;0;.00nan;0;0
1542;31021;38;44;28;5;23;.821;3600000;0
1542;32146;52;100;34;0;34;1.000;3600000;0
1543;2900;36;65;15;1;14;.933;3600000;0
1543;3533;57;0;0;0;0;.00nan;0;0
1543;14874;36;0;0;0;0;.00nan;0;0
1543;26865;57;77;33;2;31;.939;3561000;0
1544;1486;43;71;30;2;28;.933;3600000;0
1544;3625;43;0;0;0;0;.00nan;0;0
1544;26967;63;45;34;5;29;.853;3600000;0
1544;34814;63;0;0;0;0;.00nan;0;0
1545;6081;56;0;0;0;0;.00nan;0;0
1545;23493;51;0;0;0;0;.00nan;0;0
1545;26824;56;74;31;3;28;.903;3600000;0
1545;31408;51;30;18;4;14;.778;3546000;0
1546;323;46;80;27;2;25;.926;3900000;0
1546;2553;46;0;0;0;0;.00nan;0;0
1546;5146;64;0;0;0;0;.00nan;0;0
1546;14323;64;71;26;2;24;.923;3900000;0
1547;2163;39;96;18;0;18;1.000;3600000;0
1547;4338;65;78;43;4;39;.907;3600000;0
1547;4987;65;0;0;0;0;.00nan;0;0
1547;9238;39;0;0;0;0;.00nan;0;0
1548;4447;54;0;0;0;0;.00nan;0;0
1548;31643;54;53;25;3;22;.880;3600000;0
1548;34788;42;67;37;4;33;.892;3600000;0
1548;37416;42;0;0;0;0;.00nan;0;0
1549;6572;62;94;30;1;29;.967;3600000;0
1549;20717;60;63;28;3;25;.893;3574000;0
1549;26919;62;0;0;0;0;.00nan;0;0
1549;35536;60;0;0;0;0;.00nan;0;0
1550;1051;44;56;33;5;28;.848;3600000;0
1550;2016;61;0;0;0;0;.00nan;0;0
1550;3281;44;0;0;0;0;.00nan;0;0
1550;30971;61;42;41;8;33;.805;3600000;0
1551;4716;4619;79;28;2;26;.929;3600000;0
1551;10698;4619;0;0;0;0;.00nan;0;0
1551;14351;40;0;0;0;0;.00nan;0;0
1551;26840;40;40;31;5;26;.839;3600000;0
1552;2152;49;46;24;4;20;.833;3678000;0
1552;4435;49;0;0;0;0;.00nan;0;0
1552;7049;47;86;35;3;32;.914;3678000;0
1552;33654;47;0;0;0;0;.00nan;0;0
1553;5137;58;100;32;1;31;.969;3600000;0
1553;14321;58;0;0;0;0;.00nan;0;0
1553;28772;53;0;0;0;0;.00nan;0;0
1553;31156;53;64;39;4;35;.897;3600000;0
1554;2198;45;0;0;0;0;.00nan;0;0
1554;5883;37;82;29;1;28;.966;3600000;0
1554;23043;37;0;0;0;0;.00nan;0;0
1554;36703;45;100;27;0;27;1.000;3600000;0
1555;1486;43;0;0;0;0;.00nan;0;0
1555;3625;43;97;34;1;33;.971;3600000;0
1555;26967;63;0;0;0;0;.00nan;0;0
1555;34814;63;60;32;3;29;.906;3515000;0
1556;3;50;0;0;0;0;.00nan;0;0
1556;3626;48;0;0;0;0;.00nan;0;0
1556;5048;50;73;34;4;30;.882;3610000;0
1556;38547;48;37;25;5;20;.800;3610000;0
1557;4716;4619;0;0;0;0;.00nan;0;0
1557;10698;4619;88;41;2;39;.951;3600000;0
1557;14351;40;59;34;4;30;.882;3514000;0
1557;26840;40;0;0;0;0;.00nan;0;0
1558;5298;55;0;0;0;0;.00nan;0;0
1558;19640;41;79;32;2;30;.938;3900000;0
1558;23075;41;0;0;0;0;.00nan;0;0
1558;34770;55;80;31;2;29;.935;3900000;0
1559;2796;59;0;0;0;0;.00nan;0;0
1559;3847;38;93;45;3;42;.933;3900000;0
1559;31021;38;0;0;0;0;.00nan;0;0
1559;34819;59;61;26;3;23;.885;3900000;0
1560;2163;39;41;34;6;28;.824;3036000;0
1560;9238;39;50;1;0;1;1.000;564000;0
1560;14874;36;81;40;3;37;.925;3600000;0
1560;42825;36;0;0;0;0;.00nan;0;0
1561;6081;56;80;32;2;30;.938;3600000;0
1561;23493;51;0;0;0;0;.00nan;0;0
1561;26824;56;0;0;0;0;.00nan;0;0
1561;31408;51;36;26;5;21;.808;3600000;0
1562;780;52;55;3;0;3;1.000;422000;0
1562;3533;57;82;32;2;30;.938;3600000;0
1562;26865;57;0;0;0;0;.00nan;0;0
1562;32146;52;47;32;5;27;.844;3178000;0
1563;5146;64;61;39;4;35;.897;3563000;0
1563;14323;64;0;0;0;0;.00nan;0;0
1563;34788;42;0;0;0;0;.00nan;0;0
1563;37416;42;80;39;3;36;.923;3600000;0
1564;2152;49;0;0;0;0;.00nan;0;0
1564;4435;49;43;24;4;20;.833;3564000;0
1564;20717;60;0;0;0;0;.00nan;0;0
1564;35536;60;71;27;2;25;.926;3600000;0
1565;1051;44;0;0;0;0;.00nan;0;0
1565;2016;61;78;32;2;30;.938;3596000;0
1565;3281;44;81;27;1;26;.963;3600000;0
1565;30971;61;0;0;0;0;.00nan;0;0
1566;6572;62;0;0;0;0;.00nan;0;0
1566;7049;47;0;0;0;0;.00nan;0;0
1566;26919;62;81;36;3;33;.917;3600000;0
1566;33654;47;100;29;0;29;1.000;3600000;0
1567;5298;55;26;34;7;27;.794;3170000;0
1567;19640;41;0;0;0;0;.00nan;0;0
1567;23075;41;69;24;3;21;.875;3600000;0
1567;34770;55;56;4;0;4;1.000;430000;0
1568;2198;45;0;0;0;0;.00nan;0;0
1568;5883;37;0;0;0;0;.00nan;0;0
1568;23043;37;56;19;2;17;.895;3600000;0
1568;36703;45;70;28;3;25;.893;3585000;0
1569;323;46;0;0;0;0;.00nan;0;0
1569;2553;46;59;37;5;32;.865;3600000;0
1569;5146;64;0;0;0;0;.00nan;0;0
1569;14323;64;90;29;1;28;.966;3600000;0
1570;3;50;41;23;4;19;.826;3600000;0
1570;3626;48;67;45;5;40;.889;3589000;0
1570;5048;50;0;0;0;0;.00nan;0;0
1570;38547;48;0;0;0;0;.00nan;0;0
1571;3533;57;0;0;0;0;.00nan;0;0
1571;4338;65;79;27;2;25;.926;3600000;0
1571;4987;65;0;0;0;0;.00nan;0;0
1571;26865;57;61;27;3;24;.889;3557000;0
1572;4447;54;0;0;0;0;.00nan;0;0
1572;31643;54;68;24;2;22;.917;3600000;0
1572;34788;42;38;33;6;27;.818;3600000;0
1572;37416;42;0;0;0;0;.00nan;0;0
1573;2016;61;0;0;0;0;.00nan;0;0
1573;2152;49;48;36;6;30;.833;3600000;0
1573;4435;49;0;0;0;0;.00nan;0;0
1573;30971;61;83;41;3;38;.927;3600000;0
1574;5137;58;78;17;0;17;1.000;2426000;0
1574;14321;58;24;14;4;10;.714;1174000;0
1574;28772;53;91;34;1;33;.971;3600000;0
1574;31156;53;0;0;0;0;.00nan;0;0
1575;5298;55;0;0;0;0;.00nan;0;0
1575;6081;56;48;25;4;21;.840;3590000;0
1575;26824;56;0;0;0;0;.00nan;0;0
1575;34770;55;56;25;3;22;.880;3600000;0
1576;3533;57;0;0;0;0;.00nan;0;0
1576;4338;65;0;0;0;0;.00nan;0;0
1576;4987;65;99;52;3;49;.942;3718000;0
1576;26865;57;59;27;4;23;.852;3718000;0
1577;2163;39;0;0;0;0;.00nan;0;0
1577;9238;39;71;34;3;31;.912;3600000;0
1577;14874;36;40;27;5;22;.815;3583000;0
1577;42825;36;0;0;0;0;.00nan;0;0
1578;2198;45;0;0;0;0;.00nan;0;0
1578;23493;51;0;0;0;0;.00nan;0;0
1578;31408;51;74;43;4;39;.907;3600000;0
1578;36703;45;78;26;2;24;.923;3600000;0
1579;4447;54;54;21;2;19;.905;3600000;0
1579;31643;54;0;0;0;0;.00nan;0;0
1579;34788;42;0;0;0;0;.00nan;0;0
1579;37416;42;40;40;6;34;.850;3600000;0
1580;7049;47;0;0;0;0;.00nan;0;0
1580;14351;40;0;0;0;0;.00nan;0;0
1580;26840;40;61;30;5;25;.833;3600000;0
1580;33654;47;96;32;1;31;.969;3600000;0
1581;2016;61;58;33;4;29;.879;3516000;0
1581;2152;49;0;0;0;0;.00nan;0;0
1581;4435;49;63;21;2;19;.905;3600000;0
1581;30971;61;0;0;0;0;.00nan;0;0
1582;3;50;100;42;2;40;.952;3900000;0
1582;5048;50;0;0;0;0;.00nan;0;0
1582;5146;64;49;19;2;17;.895;3900000;0
1582;14323;64;0;0;0;0;.00nan;0;0
1583;2796;59;0;0;0;0;.00nan;0;0
1583;2900;36;84;40;3;37;.925;3900000;0
1583;14874;36;0;0;0;0;.00nan;0;0
1583;34819;59;77;34;3;31;.912;3900000;0
1584;1486;43;62;27;2;25;.926;3900000;0
1584;3625;43;0;0;0;0;.00nan;0;0
1584;4447;54;0;0;0;0;.00nan;0;0
1584;31643;54;84;29;2;27;.931;3900000;0
1585;2198;45;0;0;0;0;.00nan;0;0
1585;23493;51;0;0;0;0;.00nan;0;0
1585;31408;51;89;28;1;27;.964;3600000;0
1585;36703;45;66;23;2;21;.913;3593000;0
1586;323;46;74;37;3;34;.919;3573000;0
1586;2553;46;0;0;0;0;.00nan;0;0
1586;34788;42;0;0;0;0;.00nan;0;0
1586;37416;42;64;22;2;20;.909;3600000;0
1587;3847;38;0;0;0;0;.00nan;0;0
1587;28772;53;0;0;0;0;.00nan;0;0
1587;31021;38;35;29;5;24;.828;3600000;0
1587;31156;53;100;43;0;43;1.000;3600000;0
1588;3533;57;0;0;0;0;.00nan;0;0
1588;19640;41;0;0;0;0;.00nan;0;0
1588;23075;41;57;40;5;35;.875;3600000;0
1588;26865;57;74;25;1;24;.960;3600000;0
1589;2163;39;0;0;0;0;.00nan;0;0
1589;5137;58;78;37;3;34;.919;3596000;0
1589;9238;39;73;21;2;19;.905;3600000;0
1589;14321;58;0;0;0;0;.00nan;0;0
1590;1051;44;43;35;5;30;.857;3600000;0
1590;3281;44;0;0;0;0;.00nan;0;0
1590;4716;4619;100;56;1;55;.982;3600000;0
1590;10698;4619;0;0;0;0;.00nan;0;0
1591;3626;48;100;38;1;37;.974;3900000;0
1591;7049;47;93;30;1;29;.967;3900000;0
1591;33654;47;0;0;0;0;.00nan;0;0
1591;38547;48;0;0;0;0;.00nan;0;0
1592;6572;62;0;0;0;0;.00nan;0;0
1592;14351;40;0;0;0;0;.00nan;0;0
1592;26840;40;41;37;6;31;.838;3553000;0
1592;26919;62;47;26;4;22;.846;3600000;0
1593;5137;58;0;0;0;0;.00nan;0;0
1593;14321;58;68;22;3;19;.864;3900000;0
1593;26967;63;88;42;3;39;.929;3900000;0
1593;34814;63;0;0;0;0;.00nan;0;0
1594;2796;59;100;40;0;40;1.000;3600000;0
1594;19640;41;77;21;1;20;.952;3582000;0
1594;23075;41;0;0;0;0;.00nan;0;0
1594;34819;59;0;0;0;0;.00nan;0;0
1595;780;52;0;0;0;0;.00nan;0;0
1595;3847;38;0;0;0;0;.00nan;0;0
1595;31021;38;66;32;3;29;.906;3600000;0
1595;32146;52;32;18;4;14;.778;3547000;0
1596;2163;39;59;35;5;30;.857;3557000;0
1596;2900;36;0;0;0;0;.00nan;0;0
1596;9238;39;0;0;0;0;.00nan;0;0
1596;14874;36;56;19;3;16;.842;3600000;0
1597;1486;43;80;43;3;40;.930;3900000;0
1597;3625;43;0;0;0;0;.00nan;0;0
1597;4447;54;55;31;3;28;.903;3900000;0
1597;31643;54;0;0;0;0;.00nan;0;0
1598;5883;37;82;39;3;36;.923;3900000;0
1598;6081;56;57;26;3;23;.885;3900000;0
1598;23043;37;0;0;0;0;.00nan;0;0
1598;26824;56;0;0;0;0;.00nan;0;0
1599;323;46;0;0;0;0;.00nan;0;0
1599;2553;46;47;31;5;26;.839;3600000;0
1599;34788;42;74;25;1;24;.960;3600000;0
1599;37416;42;0;0;0;0;.00nan;0;0
1600;3;50;72;24;1;23;.958;3600000;0
1600;5048;50;0;0;0;0;.00nan;0;0
1600;5146;64;62;25;3;22;.880;3600000;0
1600;14323;64;0;0;0;0;.00nan;0;0
1601;3533;57;76;23;1;22;.957;3600000;0
1601;4338;65;0;0;0;0;.00nan;0;0
1601;4987;65;83;36;2;34;.944;3580000;0
1601;26865;57;0;0;0;0;.00nan;0;0
1602;5298;55;0;0;0;0;.00nan;0;0
1602;28772;53;0;0;0;0;.00nan;0;0
1602;31156;53;70;33;3;30;.909;3600000;0
1602;34770;55;54;26;4;22;.846;3542000;0
1603;6572;62;46;21;4;17;.810;3531000;0
1603;14351;40;70;30;2;28;.933;3600000;0
1603;26840;40;0;0;0;0;.00nan;0;0
1603;26919;62;0;0;0;0;.00nan;0;0
1604;1051;44;57;24;3;21;.875;3584000;0
1604;3281;44;0;0;0;0;.00nan;0;0
1604;4716;4619;0;0;0;0;.00nan;0;0
1604;10698;4619;83;34;2;32;.941;3600000;0
1605;2152;49;53;12;1;11;.917;940000;0
1605;4435;49;12;17;6;11;.647;2630000;0
1605;7049;47;0;0;0;0;.00nan;0;0
1605;33654;47;54;37;5;32;.865;3600000;0
1606;2016;61;0;0;0;0;.00nan;0;0
1606;20717;60;0;0;0;0;.00nan;0;0
1606;30971;61;70;19;1;18;.947;3600000;0
1606;35536;60;59;33;5;28;.848;3600000;0
1607;780;52;99;39;1;38;.974;3600000;0
1607;19640;41;0;0;0;0;.00nan;0;0
1607;23075;41;82;40;3;37;.925;3532000;0
1607;32146;52;0;0;0;0;.00nan;0;0
1608;2796;59;23;27;6;21;.778;3113000;0
1608;4338;65;80;29;1;28;.966;3600000;0
1608;4987;65;0;0;0;0;.00nan;0;0
1608;34819;59;48;0;0;0;.00nan;487000;0
1609;5883;37;0;0;0;0;.00nan;0;0
1609;6081;56;0;0;0;0;.00nan;0;0
1609;23043;37;47;32;5;27;.844;3600000;0
1609;26824;56;93;34;1;33;.971;3600000;0
1610;3847;38;0;0;0;0;.00nan;0;0
1610;5298;55;41;25;4;21;.840;3584000;0
1610;31021;38;69;27;3;24;.889;3600000;0
1610;34770;55;0;0;0;0;.00nan;0;0
1611;714;51;0;0;0;0;.00nan;0;0
1611;23493;51;42;35;6;29;.829;3543000;0
1611;26967;63;0;0;0;0;.00nan;0;0
1611;34814;63;60;30;4;26;.867;3600000;0
1612;3;50;0;0;0;0;.00nan;0;0
1612;5048;50;54;30;3;27;.900;3600000;0
1612;5146;64;0;0;0;0;.00nan;0;0
1612;14323;64;42;30;5;25;.833;3519000;0
1613;2016;61;90;31;1;30;.968;3600000;0
1613;20717;60;0;0;0;0;.00nan;0;0
1613;30971;61;0;0;0;0;.00nan;0;0
1613;35536;60;68;40;4;36;.900;3600000;0
1614;323;46;83;28;1;27;.964;3600000;0
1614;1486;43;63;42;5;37;.881;3600000;0
1614;2553;46;0;0;0;0;.00nan;0;0
1614;3625;43;0;0;0;0;.00nan;0;0
1615;2152;49;0;0;0;0;.00nan;0;0
1615;4435;49;48;11;2;9;.818;3600000;0
1615;7049;47;86;54;5;49;.907;3600000;0
1615;33654;47;0;0;0;0;.00nan;0;0
1616;6081;56;0;0;0;0;.00nan;0;0
1616;26824;56;72;34;4;30;.882;3532000;0
1616;28772;53;94;38;2;36;.947;3600000;0
1616;31156;53;0;0;0;0;.00nan;0;0
1617;1486;43;25;36;7;29;.806;3600000;0
1617;2900;36;0;0;0;0;.00nan;0;0
1617;3625;43;0;0;0;0;.00nan;0;0
1617;14874;36;99;20;0;20;1.000;3600000;0
1618;2796;59;0;0;0;0;.00nan;0;0
1618;4338;65;0;0;0;0;.00nan;0;0
1618;4987;65;73;20;1;19;.950;3600000;0
1618;34819;59;33;33;6;27;.818;3600000;0
1619;2163;39;0;0;0;0;.00nan;0;0
1619;5298;55;0;0;0;0;.00nan;0;0
1619;9238;39;89;28;1;27;.964;3600000;0
1619;34770;55;57;27;3;24;.889;3600000;0
1620;714;51;0;0;0;0;.00nan;0;0
1620;5883;37;91;30;1;29;.967;3600000;0
1620;23043;37;0;0;0;0;.00nan;0;0
1620;23493;51;40;21;4;17;.810;3600000;0
1621;3;50;58;40;5;35;.875;3600000;0
1621;5048;50;0;0;0;0;.00nan;0;0
1621;34788;42;0;0;0;0;.00nan;0;0
1621;37416;42;74;27;2;25;.926;3600000;0
1622;2198;45;0;0;0;0;.00nan;0;0
1622;5146;64;58;27;3;24;.889;3542000;0
1622;14323;64;0;0;0;0;.00nan;0;0
1622;36703;45;95;41;1;40;.976;3600000;0
1623;3533;57;0;0;0;0;.00nan;0;0
1623;26865;57;85;37;2;35;.946;3900000;0
1623;28772;53;91;37;2;35;.946;3900000;0
1623;31156;53;0;0;0;0;.00nan;0;0
1624;2900;36;0;0;0;0;.00nan;0;0
1624;14874;36;95;32;1;31;.969;3600000;0
1624;19640;41;71;31;3;28;.903;3550000;0
1624;23075;41;0;0;0;0;.00nan;0;0
1625;1486;43;67;24;2;22;.917;3600000;0
1625;3625;43;0;0;0;0;.00nan;0;0
1625;5298;55;0;0;0;0;.00nan;0;0
1625;34770;55;64;31;3;28;.903;3586000;0
1626;3847;38;0;0;0;0;.00nan;0;0
1626;6081;56;0;0;0;0;.00nan;0;0
1626;26824;56;81;28;1;27;.964;3600000;0
1626;31021;38;51;31;4;27;.871;3600000;0
1627;5137;58;0;0;0;0;.00nan;0;0
1627;14321;58;100;29;0;29;1.000;3600000;0
1627;26967;63;0;0;0;0;.00nan;0;0
1627;34814;63;61;30;3;27;.900;3600000;0
1628;714;51;92;22;0;22;1.000;3600000;0
1628;2163;39;0;0;0;0;.00nan;0;0
1628;9238;39;64;24;2;22;.917;3512000;0
1628;23493;51;0;0;0;0;.00nan;0;0
1629;323;46;87;24;1;23;.958;3600000;0
1629;2553;46;0;0;0;0;.00nan;0;0
1629;5883;37;65;35;3;32;.914;3528000;0
1629;23043;37;0;0;0;0;.00nan;0;0
1630;3;50;76;29;2;27;.931;3600000;0
1630;4447;54;0;0;0;0;.00nan;0;0
1630;5048;50;0;0;0;0;.00nan;0;0
1630;31643;54;41;29;5;24;.828;3600000;0
1631;3626;48;79;20;1;19;.950;3600000;0
1631;34788;42;41;22;4;18;.818;3600000;0
1631;37416;42;0;0;0;0;.00nan;0;0
1631;38547;48;0;0;0;0;.00nan;0;0
1632;1051;44;0;0;0;0;.00nan;0;0
1632;3281;44;75;25;2;23;.920;3600000;0
1632;14351;40;38;7;2;5;.714;646000;0
1632;26840;40;21;24;6;18;.750;2954000;0
1633;4716;4619;49;20;3;17;.850;3551000;0
1633;7049;47;90;29;1;28;.966;3600000;0
1633;10698;4619;0;0;0;0;.00nan;0;0
1633;33654;47;0;0;0;0;.00nan;0;0
1634;2152;49;74;35;3;32;.914;3600000;0
1634;4435;49;0;0;0;0;.00nan;0;0
1634;6572;62;0;0;0;0;.00nan;0;0
1634;26919;62;67;41;4;37;.902;3550000;0
1635;2016;61;0;0;0;0;.00nan;0;0
1635;20717;60;0;0;0;0;.00nan;0;0
1635;30971;61;69;36;4;32;.889;3600000;0
1635;35536;60;100;42;0;42;1.000;3600000;0
1636;2900;36;74;29;2;27;.931;3600000;0
1636;14874;36;0;0;0;0;.00nan;0;0
1636;19640;41;0;0;0;0;.00nan;0;0
1636;23075;41;72;33;3;30;.909;3545000;0
1637;2796;59;82;18;0;18;1.000;1223000;0
1637;4338;65;0;0;0;0;.00nan;0;0
1637;4987;65;66;25;2;23;.920;3600000;0
1637;34819;59;28;29;6;23;.793;2377000;0
1638;780;52;0;0;0;0;.00nan;0;0
1638;26967;63;100;47;1;46;.979;3600000;0
1638;32146;52;60;26;3;23;.885;3595000;0
1638;34814;63;0;0;0;0;.00nan;0;0
1639;323;46;0;0;0;0;.00nan;0;0
1639;2553;46;71;40;3;37;.925;3600000;0
1639;5883;37;0;0;0;0;.00nan;0;0
1639;23043;37;49;33;5;28;.848;3581000;0
1640;3;50;0;0;0;0;.00nan;0;0
1640;4447;54;39;20;4;16;.800;3600000;0
1640;5048;50;60;18;2;16;.889;3600000;0
1640;31643;54;0;0;0;0;.00nan;0;0
1641;3626;48;69;35;3;32;.914;3044000;0
1641;34788;42;0;0;0;0;.00nan;0;0
1641;37416;42;52;34;4;30;.882;3600000;0
1641;38547;48;18;9;4;5;.556;556000;0
1642;1486;43;0;0;0;0;.00nan;0;0
1642;3533;57;84;28;1;27;.964;3600000;0
1642;3625;43;76;33;2;31;.939;3556000;0
1642;26865;57;0;0;0;0;.00nan;0;0
1643;3847;38;0;0;0;0;.00nan;0;0
1643;5137;58;0;0;0;0;.00nan;0;0
1643;14321;58;80;35;3;32;.914;3800000;0
1643;31021;38;81;32;2;30;.938;3800000;0
1644;2198;45;0;0;0;0;.00nan;0;0
1644;5146;64;83;28;1;27;.964;3600000;0
1644;14323;64;0;0;0;0;.00nan;0;0
1644;36703;45;75;35;3;32;.914;3600000;0
1645;1051;44;72;30;2;28;.933;3600000;0
1645;3281;44;0;0;0;0;.00nan;0;0
1645;14351;40;0;0;0;0;.00nan;0;0
1645;26840;40;44;36;6;30;.833;3600000;0
1646;4716;4619;0;0;0;0;.00nan;0;0
1646;7049;47;0;0;0;0;.00nan;0;0
1646;10698;4619;91;29;1;28;.966;3600000;0
1646;33654;47;87;48;3;45;.938;3576000;0
1647;2152;49;0;0;0;0;.00nan;0;0
1647;4435;49;64;52;5;47;.904;3600000;0
1647;6572;62;27;7;3;4;.571;485000;0
1647;26919;62;55;30;3;27;.900;3115000;0
1648;780;52;69;27;3;24;.889;3900000;0
1648;6081;56;0;0;0;0;.00nan;0;0
1648;26824;56;70;23;3;20;.870;3900000;0
1648;32146;52;0;0;0;0;.00nan;0;0
1649;3847;38;0;0;0;0;.00nan;0;0
1649;26967;63;0;0;0;0;.00nan;0;0
1649;31021;38;70;37;4;33;.892;3600000;0
1649;34814;63;76;20;1;19;.950;3600000;0
1650;3533;57;0;0;0;0;.00nan;0;0
1650;26865;57;87;31;2;29;.935;3522000;0
1650;28772;53;100;24;0;24;1.000;3600000;0
1650;31156;53;0;0;0;0;.00nan;0;0
1651;2796;59;0;0;0;0;.00nan;0;0
1651;5137;58;87;52;3;49;.942;3552000;0
1651;14321;58;0;0;0;0;.00nan;0;0
1651;34819;59;54;15;2;13;.867;3600000;0
1652;714;51;43;31;5;26;.839;3673000;0
1652;4338;65;27;24;6;18;.750;3680000;0
1652;4987;65;0;0;0;0;.00nan;0;0
1652;23493;51;0;0;0;0;.00nan;0;0
1653;2198;45;24;29;7;22;.759;3232000;0
1653;5146;64;0;0;0;0;.00nan;0;0
1653;14323;64;58;25;3;22;.880;3600000;0
1653;36703;45;56;5;0;5;1.000;368000;0
1654;2016;61;77;25;1;24;.960;3600000;0
1654;20717;60;0;0;0;0;.00nan;0;0
1654;30971;61;0;0;0;0;.00nan;0;0
1654;35536;60;34;30;5;25;.833;3600000;0
1655;2163;39;61;22;2;20;.909;3600000;0
1655;9238;39;0;0;0;0;.00nan;0;0
1655;19640;41;96;48;3;45;.938;3555000;0
1655;23075;41;0;0;0;0;.00nan;0;0
1656;3;50;53;36;5;31;.861;3524000;0
1656;4447;54;0;0;0;0;.00nan;0;0
1656;5048;50;0;0;0;0;.00nan;0;0
1656;31643;54;50;23;3;20;.870;3600000;0
1657;1051;44;0;0;0;0;.00nan;0;0
1657;3281;44;76;25;1;24;.960;3600000;0
1657;3626;48;65;38;4;34;.895;3600000;0
1657;38547;48;0;0;0;0;.00nan;0;0
1658;2163;39;0;0;0;0;.00nan;0;0
1658;9238;39;58;22;2;20;.909;3600000;0
1658;19640;41;0;0;0;0;.00nan;0;0
1658;23075;41;58;39;5;34;.872;3600000;0
1659;2900;36;77;36;3;33;.917;3546000;0
1659;14874;36;0;0;0;0;.00nan;0;0
1659;26967;63;100;33;1;32;.970;3600000;0
1659;34814;63;0;0;0;0;.00nan;0;0
1660;3533;57;0;0;0;0;.00nan;0;0
1660;6081;56;0;0;0;0;.00nan;0;0
1660;26824;56;85;43;3;40;.930;3520000;0
1660;26865;57;73;21;1;20;.952;3600000;0
1661;1051;44;61;16;1;15;.938;3600000;0
1661;3281;44;0;0;0;0;.00nan;0;0
1661;3626;48;0;0;0;0;.00nan;0;0
1661;38547;48;75;38;3;35;.921;3572000;0
1662;7049;47;0;0;0;0;.00nan;0;0
1662;14351;40;89;36;1;35;.972;3600000;0
1662;26840;40;0;0;0;0;.00nan;0;0
1662;33654;47;67;24;2;22;.917;3560000;0
1663;2016;61;0;0;0;0;.00nan;0;0
1663;6572;62;0;0;0;0;.00nan;0;0
1663;26919;62;66;35;4;31;.886;3600000;0
1663;30971;61;99;44;1;43;.977;3600000;0
1664;4716;4619;72;25;2;23;.920;3900000;0
1664;10698;4619;0;0;0;0;.00nan;0;0
1664;20717;60;0;0;0;0;.00nan;0;0
1664;35536;60;78;29;2;27;.931;3900000;0
1665;5146;64;0;0;0;0;.00nan;0;0
1665;5883;37;40;32;6;26;.813;3600000;0
1665;14323;64;45;31;5;26;.839;3600000;0
1665;23043;37;0;0;0;0;.00nan;0;0
1666;1486;43;76;36;3;33;.917;3600000;0
1666;3625;43;0;0;0;0;.00nan;0;0
1666;5298;55;0;0;0;0;.00nan;0;0
1666;34770;55;60;37;4;33;.892;3547000;0
1667;3533;57;0;0;0;0;.00nan;0;0
1667;26865;57;48;29;5;24;.828;3860000;0
1667;28772;53;66;33;4;29;.879;3860000;0
1667;31156;53;0;0;0;0;.00nan;0;0
1668;2900;36;0;0;0;0;.00nan;0;0
1668;6081;56;42;31;5;26;.839;3600000;0
1668;14874;36;71;27;2;25;.926;3600000;0
1668;26824;56;0;0;0;0;.00nan;0;0
1669;1486;43;100;48;1;47;.979;3600000;0
1669;3625;43;0;0;0;0;.00nan;0;0
1669;5298;55;0;0;0;0;.00nan;0;0
1669;34770;55;39;20;4;16;.800;3600000;0
1670;3847;38;0;0;0;0;.00nan;0;0
1670;23493;51;0;0;0;0;.00nan;0;0
1670;31021;38;99;46;2;44;.957;3600000;0
1670;31408;51;23;28;6;22;.786;3600000;0
1671;4338;65;0;0;0;0;.00nan;0;0
1671;4987;65;82;26;1;25;.962;3600000;0
1671;5137;58;0;0;0;0;.00nan;0;0
1671;14321;58;87;31;2;29;.935;3585000;0
1672;4447;54;0;0;0;0;.00nan;0;0
1672;5146;64;46;34;5;29;.853;3600000;0
1672;14323;64;0;0;0;0;.00nan;0;0
1672;31643;54;81;23;1;22;.957;3600000;0
1673;2198;45;0;0;0;0;.00nan;0;0
1673;34788;42;0;0;0;0;.00nan;0;0
1673;36703;45;72;39;3;36;.923;3600000;0
1673;37416;42;80;27;1;26;.963;3600000;0
1674;3;50;67;41;4;37;.902;3535000;0
1674;5048;50;0;0;0;0;.00nan;0;0
1674;5883;37;0;0;0;0;.00nan;0;0
1674;23043;37;80;35;2;33;.943;3600000;0
1675;2152;49;0;0;0;0;.00nan;0;0
1675;4435;49;61;21;3;18;.857;3860000;0
1675;20717;60;0;0;0;0;.00nan;0;0
1675;35536;60;70;28;2;26;.929;3860000;0
1676;6572;62;68;23;3;20;.870;3754000;0
1676;7049;47;45;26;4;22;.846;3754000;0
1676;26919;62;0;0;0;0;.00nan;0;0
1676;33654;47;0;0;0;0;.00nan;0;0
1677;4716;4619;71;36;3;33;.917;3600000;0
1677;10698;4619;0;0;0;0;.00nan;0;0
1677;14351;40;0;0;0;0;.00nan;0;0
1677;26840;40;100;33;0;33;1.000;3600000;0
1678;780;52;0;0;0;0;.00nan;0;0
1678;19640;41;76;22;2;20;.909;3600000;0
1678;23075;41;0;0;0;0;.00nan;0;0
1678;32146;52;64;28;4;24;.857;3548000;0
1679;2796;59;0;0;0;0;.00nan;0;0
1679;4338;65;58;39;5;34;.872;3598000;0
1679;4987;65;0;0;0;0;.00nan;0;0
1679;34819;59;77;35;3;32;.914;3600000;0
1680;2900;36;93;21;0;21;1.000;3600000;0
1680;14874;36;0;0;0;0;.00nan;0;0
1680;23493;51;52;29;4;25;.862;3600000;0
1680;31408;51;0;0;0;0;.00nan;0;0
1681;3847;38;0;0;0;0;.00nan;0;0
1681;6081;56;0;0;0;0;.00nan;0;0
1681;26824;56;54;27;3;24;.889;3600000;0
1681;31021;38;35;23;5;18;.783;3589000;0
1682;323;46;54;25;3;22;.880;3554000;0
1682;26967;63;0;0;0;0;.00nan;0;0
1682;34814;63;88;39;2;37;.949;3600000;0
1682;35622;46;0;0;0;0;.00nan;0;0
1683;3;50;50;1;0;1;1.000;866000;0
1683;5048;50;22;26;6;20;.769;2734000;0
1683;5883;37;63;26;3;23;.885;3600000;0
1683;23043;37;0;0;0;0;.00nan;0;0
1684;2163;39;100;27;0;27;1.000;3600000;0
1684;3533;57;59;39;5;34;.872;3600000;0
1684;9238;39;0;0;0;0;.00nan;0;0
1684;26865;57;0;0;0;0;.00nan;0;0
1685;5137;58;46;25;4;21;.840;3539000;0
1685;14321;58;0;0;0;0;.00nan;0;0
1685;28772;53;0;0;0;0;.00nan;0;0
1685;31156;53;80;30;2;28;.933;3600000;0
1686;4447;54;60;23;2;21;.913;3600000;0
1686;5146;64;0;0;0;0;.00nan;0;0
1686;14323;64;45;37;5;32;.865;3600000;0
1686;31643;54;0;0;0;0;.00nan;0;0
1687;2198;45;41;34;5;29;.853;3600000;0
1687;34788;42;77;28;2;26;.929;3600000;0
1687;36703;45;0;0;0;0;.00nan;0;0
1687;37416;42;0;0;0;0;.00nan;0;0
1688;1051;44;40;36;6;30;.833;3600000;0
1688;2152;49;41;26;5;21;.808;3600000;0
1688;3281;44;0;0;0;0;.00nan;0;0
1688;4435;49;0;0;0;0;.00nan;0;0
1689;4716;4619;0;0;0;0;.00nan;0;0
1689;10698;4619;100;24;0;24;1.000;3600000;0
1689;14351;40;0;0;0;0;.00nan;0;0
1689;26840;40;87;34;1;33;.971;3570000;0
1690;6572;62;0;0;0;0;.00nan;0;0
1690;20717;60;47;28;4;24;.857;3583000;0
1690;26919;62;73;34;2;32;.941;3600000;0
1690;35536;60;0;0;0;0;.00nan;0;0
1691;2016;61;65;38;4;34;.895;3600000;0
1691;3626;48;69;44;5;39;.886;3556000;0
1691;30971;61;0;0;0;0;.00nan;0;0
1691;38547;48;0;0;0;0;.00nan;0;0
1692;780;52;80;24;1;23;.958;3600000;0
1692;19640;41;0;0;0;0;.00nan;0;0
1692;23075;41;63;30;3;27;.900;3521000;0
1692;32146;52;0;0;0;0;.00nan;0;0
1693;5137;58;0;0;0;0;.00nan;0;0
1693;14321;58;65;23;2;21;.913;3600000;0
1693;28772;53;61;32;4;28;.875;3535000;0
1693;31156;53;0;0;0;0;.00nan;0;0
1694;323;46;0;0;0;0;.00nan;0;0
1694;26967;63;71;24;2;22;.917;3553000;0
1694;34814;63;0;0;0;0;.00nan;0;0
1694;35622;46;94;16;0;16;1.000;3600000;0
1695;2163;39;41;16;3;13;.813;3600000;0
1695;4338;65;0;0;0;0;.00nan;0;0
1695;4987;65;96;24;0;24;1.000;3600000;0
1695;9238;39;0;0;0;0;.00nan;0;0
1696;2016;61;0;0;0;0;.00nan;0;0
1696;3626;48;54;9;1;8;.889;782000;0
1696;30971;61;76;22;1;21;.955;3600000;0
1696;38547;48;24;31;6;25;.806;2818000;0
1697;2796;59;0;0;0;0;.00nan;0;0
1697;26967;63;63;26;3;23;.885;3588000;0
1697;34814;63;0;0;0;0;.00nan;0;0
1697;34819;59;69;23;2;21;.913;3600000;0
1698;5298;55;0;0;0;0;.00nan;0;0
1698;6081;56;0;0;0;0;.00nan;0;0
1698;26824;56;77;24;1;23;.958;3600000;0
1698;34770;55;87;37;2;35;.946;3544000;0
1699;4447;54;93;29;1;28;.966;3600000;0
1699;31643;54;0;0;0;0;.00nan;0;0
1699;34788;42;0;0;0;0;.00nan;0;0
1699;37416;42;89;33;2;31;.939;3575000;0
1700;2198;45;0;0;0;0;.00nan;0;0
1700;5883;37;83;38;3;35;.921;3600000;0
1700;23043;37;0;0;0;0;.00nan;0;0
1700;36703;45;23;18;5;13;.722;3579000;0
1701;4716;4619;0;0;0;0;.00nan;0;0
1701;10698;4619;94;39;3;36;.923;3583000;0
1701;20717;60;0;0;0;0;.00nan;0;0
1701;35536;60;73;21;1;20;.952;3600000;0
1702;2198;45;86;35;2;33;.943;3900000;0
1702;5883;37;0;0;0;0;.00nan;0;0
1702;23043;37;72;23;2;21;.913;3900000;0
1702;36703;45;0;0;0;0;.00nan;0;0
1703;780;52;0;0;0;0;.00nan;0;0
1703;28772;53;61;44;6;38;.864;3600000;0
1703;31156;53;0;0;0;0;.00nan;0;0
1703;32146;52;91;29;1;28;.966;3600000;0
1704;3533;57;77;32;2;30;.938;3579000;0
1704;4338;65;0;0;0;0;.00nan;0;0
1704;4987;65;76;22;1;21;.955;3600000;0
1704;26865;57;0;0;0;0;.00nan;0;0
1705;2900;36;66;33;4;29;.879;3900000;0
1705;3847;38;0;0;0;0;.00nan;0;0
1705;14874;36;0;0;0;0;.00nan;0;0
1705;31021;38;47;24;4;20;.833;3900000;0
1706;1486;43;75;37;3;34;.919;3610000;0
1706;3625;43;0;0;0;0;.00nan;0;0
1706;5146;64;0;0;0;0;.00nan;0;0
1706;14323;64;63;24;2;22;.917;3610000;0
1707;323;46;0;0;0;0;.00nan;0;0
1707;4447;54;0;0;0;0;.00nan;0;0
1707;31643;54;39;22;4;18;.818;3578000;0
1707;35622;46;60;28;3;25;.893;3600000;0
1708;2163;39;0;0;0;0;.00nan;0;0
1708;2796;59;74;32;3;29;.906;3515000;0
1708;9238;39;89;34;1;33;.971;3600000;0
1708;34819;59;0;0;0;0;.00nan;0;0
1709;4716;4619;50;38;6;32;.842;3600000;0
1709;10698;4619;0;0;0;0;.00nan;0;0
1709;20717;60;66;10;0;10;1.000;3100000;0
1709;35536;60;29;6;3;3;.500;500000;0
1710;6572;62;0;0;0;0;.00nan;0;0
1710;14351;40;0;0;0;0;.00nan;0;0
1710;26840;40;100;30;0;30;1.000;3600000;0
1710;26919;62;46;29;5;24;.828;3600000;0
1711;2152;49;0;0;0;0;.00nan;0;0
1711;3626;48;0;0;0;0;.00nan;0;0
1711;4435;49;79;25;1;24;.960;3600000;0
1711;38547;48;71;25;2;23;.920;3600000;0
1712;1051;44;71;16;1;15;.938;3600000;0
1712;2016;61;0;0;0;0;.00nan;0;0
1712;3281;44;0;0;0;0;.00nan;0;0
1712;30971;61;71;30;3;27;.900;3538000;0
1713;1486;43;57;31;4;27;.871;3600000;0
1713;3625;43;0;0;0;0;.00nan;0;0
1713;5146;64;92;31;1;30;.968;3600000;0
1713;14323;64;0;0;0;0;.00nan;0;0
1714;1051;44;0;0;0;0;.00nan;0;0
1714;2016;61;77;37;3;34;.919;3600000;0
1714;3281;44;60;22;2;20;.909;3600000;0
1714;30971;61;0;0;0;0;.00nan;0;0
1715;6081;56;0;0;0;0;.00nan;0;0
1715;26824;56;80;25;1;24;.960;3600000;0
1715;26967;63;56;27;3;24;.889;3547000;0
1715;34814;63;0;0;0;0;.00nan;0;0
1716;323;46;78;32;2;30;.938;3600000;0
1716;1486;43;81;37;3;34;.919;3559000;0
1716;3625;43;0;0;0;0;.00nan;0;0
1716;35622;46;0;0;0;0;.00nan;0;0
1717;3;50;65;27;3;24;.889;3550000;0
1717;5048;50;0;0;0;0;.00nan;0;0
1717;34788;42;0;0;0;0;.00nan;0;0
1717;37416;42;95;48;1;47;.979;3600000;0
1718;2796;59;0;0;0;0;.00nan;0;0
1718;4338;65;0;0;0;0;.00nan;0;0
1718;4987;65;52;24;3;21;.875;3825000;0
1718;34819;59;85;49;4;45;.918;3825000;0
1719;2163;39;0;0;0;0;.00nan;0;0
1719;5298;55;0;0;0;0;.00nan;0;0
1719;9238;39;69;26;2;24;.923;3600000;0
1719;34770;55;67;36;4;32;.889;3512000;0
1720;2152;49;0;0;0;0;.00nan;0;0
1720;4435;49;47;29;5;24;.828;3600000;0
1720;6572;62;71;24;2;22;.917;3600000;0
1720;26919;62;0;0;0;0;.00nan;0;0
1721;7049;47;42;36;6;30;.833;3600000;0
1721;20717;60;0;0;0;0;.00nan;0;0
1721;33654;47;0;0;0;0;.00nan;0;0
1721;35536;60;91;39;2;37;.949;3600000;0
1722;780;52;0;0;0;0;.00nan;0;0
1722;5137;58;98;45;3;42;.933;3600000;0
1722;14321;58;0;0;0;0;.00nan;0;0
1722;32146;52;68;20;1;19;.950;3600000;0
1723;3847;38;0;0;0;0;.00nan;0;0
1723;26967;63;0;0;0;0;.00nan;0;0
1723;31021;38;79;36;3;33;.917;3600000;0
1723;34814;63;49;32;4;28;.875;3600000;0
1724;2900;36;0;0;0;0;.00nan;0;0
1724;6081;56;52;35;5;30;.857;3600000;0
1724;14874;36;81;30;2;28;.933;3600000;0
1724;26824;56;0;0;0;0;.00nan;0;0
1725;5137;58;0;0;0;0;.00nan;0;0
1725;5298;55;89;17;0;17;1.000;3600000;0
1725;14321;58;75;27;2;25;.926;3532000;0
1725;34770;55;0;0;0;0;.00nan;0;0
1726;780;52;80;23;1;22;.957;3600000;0
1726;28772;53;57;37;4;33;.892;3600000;0
1726;31156;53;0;0;0;0;.00nan;0;0
1726;32146;52;0;0;0;0;.00nan;0;0
1727;2796;59;0;0;0;0;.00nan;0;0
1727;4338;65;0;0;0;0;.00nan;0;0
1727;4987;65;52;32;5;27;.844;3737000;0
1727;34819;59;53;37;6;31;.838;3710000;0
1728;3;50;52;29;4;25;.862;3600000;0
1728;5048;50;0;0;0;0;.00nan;0;0
1728;10698;4619;0;0;0;0;.00nan;0;0
1728;35210;4619;16;24;6;18;.750;3534000;0
1729;1486;43;35;34;6;28;.824;2922000;0
1729;3533;57;0;0;0;0;.00nan;0;0
1729;3625;43;60;8;0;8;1.000;678000;0
1729;26865;57;69;19;1;18;.947;3600000;0
1730;2163;39;0;0;0;0;.00nan;0;0
1730;3847;38;0;0;0;0;.00nan;0;0
1730;9238;39;87;34;2;32;.941;3600000;0
1730;31021;38;68;36;3;33;.917;3580000;0
1731;2900;36;42;32;6;26;.813;2996000;0
1731;14874;36;40;8;2;6;.750;604000;0
1731;23493;51;0;0;0;0;.00nan;0;0
1731;31408;51;51;23;3;20;.870;3600000;0
1732;2152;49;0;0;0;0;.00nan;0;0
1732;4435;49;59;26;3;23;.885;3600000;0
1732;7049;47;46;38;6;32;.842;2620000;0
1732;33654;47;63;18;1;17;.944;980000;0
1733;3626;48;68;34;4;30;.882;3555000;0
1733;6572;62;75;28;2;26;.929;3600000;0
1733;26919;62;0;0;0;0;.00nan;0;0
1733;38547;48;0;0;0;0;.00nan;0;0
1734;14351;40;0;0;0;0;.00nan;0;0
1734;20717;60;63;12;0;12;1.000;1539000;0
1734;26840;40;92;43;2;41;.953;3600000;0
1734;35536;60;15;18;6;12;.667;2061000;0
1735;6081;56;0;0;0;0;.00nan;0;0
1735;26824;56;91;30;1;29;.967;3600000;0
1735;26967;63;65;12;0;12;1.000;1325000;0
1735;34814;63;19;25;6;19;.760;2275000;0
1736;4447;54;65;28;3;25;.893;3600000;0
1736;31643;54;0;0;0;0;.00nan;0;0
1736;34788;42;90;31;1;30;.968;3600000;0
1736;37416;42;0;0;0;0;.00nan;0;0
1737;2016;61;0;0;0;0;.00nan;0;0
1737;5883;37;64;27;3;24;.889;3600000;0
1737;23043;37;0;0;0;0;.00nan;0;0
1737;30971;61;52;40;6;34;.850;3600000;0
1738;3847;38;0;0;0;0;.00nan;0;0
1738;28772;53;67;46;4;42;.913;3577000;0
1738;31021;38;69;23;2;21;.913;3600000;0
1738;31156;53;0;0;0;0;.00nan;0;0
1739;3;50;86;49;4;45;.918;3900000;0
1739;5048;50;0;0;0;0;.00nan;0;0
1739;10698;4619;0;0;0;0;.00nan;0;0
1739;35210;4619;58;29;4;25;.862;3900000;0
1740;14351;40;0;0;0;0;.00nan;0;0
1740;20717;60;0;0;0;0;.00nan;0;0
1740;26840;40;91;41;2;39;.951;3600000;0
1740;35536;60;42;28;5;23;.821;3600000;0
1741;3533;57;54;30;4;26;.867;3555000;0
1741;26865;57;0;0;0;0;.00nan;0;0
1741;32340;55;0;0;0;0;.00nan;0;0
1741;34770;55;89;35;2;33;.943;3600000;0
1742;2016;61;76;26;1;25;.962;3600000;0
1742;5883;37;0;0;0;0;.00nan;0;0
1742;23043;37;79;38;2;36;.947;3591000;0
1742;30971;61;0;0;0;0;.00nan;0;0
1743;1486;43;59;27;3;24;.889;3600000;0
1743;2796;59;0;0;0;0;.00nan;0;0
1743;3625;43;0;0;0;0;.00nan;0;0
1743;34819;59;99;27;0;27;1.000;3600000;0
1744;323;46;0;0;0;0;.00nan;0;0
1744;4447;54;0;0;0;0;.00nan;0;0
1744;31643;54;83;33;1;32;.970;3600000;0
1744;35622;46;100;38;0;38;1.000;3600000;0
1745;5146;64;0;0;0;0;.00nan;0;0
1745;14323;64;59;39;5;34;.872;3600000;0
1745;34788;42;0;0;0;0;.00nan;0;0
1745;37416;42;94;23;0;23;1.000;3600000;0
1746;2198;45;0;0;0;0;.00nan;0;0
1746;19640;41;66;27;4;23;.852;3900000;0
1746;23075;41;0;0;0;0;.00nan;0;0
1746;36703;45;53;28;4;24;.857;3900000;0
1747;1051;44;0;0;0;0;.00nan;0;0
1747;3281;44;100;39;0;39;1.000;3600000;0
1747;6572;62;90;36;1;35;.972;3554000;0
1747;26919;62;0;0;0;0;.00nan;0;0
1748;2152;49;29;22;5;17;.773;3536000;0
1748;3626;48;0;0;0;0;.00nan;0;0
1748;4435;49;0;0;0;0;.00nan;0;0
1748;38547;48;88;37;3;34;.919;3600000;0
1749;2163;39;64;21;2;19;.905;3600000;0
1749;5137;58;0;0;0;0;.00nan;0;0
1749;9238;39;0;0;0;0;.00nan;0;0
1749;14321;58;55;28;4;24;.857;3520000;0
1750;6081;56;0;0;0;0;.00nan;0;0
1750;26824;56;46;19;3;16;.842;3845000;0
1750;26967;63;90;39;2;37;.949;3845000;0
1750;34814;63;0;0;0;0;.00nan;0;0
1751;1486;43;88;39;3;36;.923;3900000;0
1751;2796;59;0;0;0;0;.00nan;0;0
1751;3625;43;0;0;0;0;.00nan;0;0
1751;34819;59;60;27;3;24;.889;3900000;0
1752;323;46;0;0;0;0;.00nan;0;0
1752;4447;54;53;24;3;21;.875;3597000;0
1752;31643;54;0;0;0;0;.00nan;0;0
1752;35622;46;99;40;2;38;.950;3600000;0
1753;5146;64;26;17;5;12;.706;2618000;0
1753;14323;64;22;12;4;8;.667;982000;0
1753;34788;42;0;0;0;0;.00nan;0;0
1753;37416;42;70;47;5;42;.894;3600000;0
1754;2198;45;88;38;2;36;.947;3600000;0
1754;19640;41;0;0;0;0;.00nan;0;0
1754;23075;41;40;22;4;18;.818;3593000;0
1754;36703;45;0;0;0;0;.00nan;0;0
1755;3626;48;53;39;5;34;.872;3600000;0
1755;7049;47;0;0;0;0;.00nan;0;0
1755;33654;47;76;22;1;21;.955;3600000;0
1755;38547;48;0;0;0;0;.00nan;0;0
1756;2163;39;0;0;0;0;.00nan;0;0
1756;9238;39;59;30;3;27;.900;3600000;0
1756;28772;53;58;38;6;32;.842;3087000;0
1756;31156;53;53;11;1;10;.909;513000;0
1757;780;52;66;34;3;31;.912;3562000;0
1757;4338;65;0;0;0;0;.00nan;0;0
1757;4987;65;58;15;1;14;.933;3600000;0
1757;32146;52;0;0;0;0;.00nan;0;0
1758;3;50;0;0;0;0;.00nan;0;0
1758;5048;50;67;28;3;25;.893;3600000;0
1758;5883;37;100;34;0;34;1.000;3600000;0
1758;23043;37;0;0;0;0;.00nan;0;0
1759;3847;38;0;0;0;0;.00nan;0;0
1759;5137;58;0;0;0;0;.00nan;0;0
1759;14321;58;90;23;0;23;1.000;3600000;0
1759;31021;38;54;16;2;14;.875;3584000;0
1760;323;46;58;17;2;15;.882;3600000;0
1760;5146;64;0;0;0;0;.00nan;0;0
1760;14323;64;38;35;6;29;.829;3600000;0
1760;35622;46;0;0;0;0;.00nan;0;0
1761;14351;40;0;0;0;0;.00nan;0;0
1761;20717;60;0;0;0;0;.00nan;0;0
1761;26840;40;84;32;1;31;.969;3600000;0
1761;35536;60;53;22;3;19;.864;3519000;0
1762;1051;44;0;0;0;0;.00nan;0;0
1762;3281;44;58;24;3;21;.875;3552000;0
1762;6572;62;0;0;0;0;.00nan;0;0
1762;26919;62;84;35;2;33;.943;3600000;0
1763;2152;49;54;26;3;23;.885;3553000;0
1763;4435;49;0;0;0;0;.00nan;0;0
1763;7049;47;76;28;2;26;.929;3600000;0
1763;33654;47;0;0;0;0;.00nan;0;0
1764;3;50;0;0;0;0;.00nan;0;0
1764;5048;50;48;37;5;32;.865;3600000;0
1764;5883;37;70;16;1;15;.938;3600000;0
1764;23043;37;0;0;0;0;.00nan;0;0
1765;1051;44;80;22;1;21;.955;3600000;0
1765;3281;44;0;0;0;0;.00nan;0;0
1765;14351;40;0;0;0;0;.00nan;0;0
1765;26840;40;65;37;4;33;.892;3600000;0
1766;780;52;69;23;1;22;.957;3600000;0
1766;3847;38;0;0;0;0;.00nan;0;0
1766;31021;38;63;34;4;30;.882;3600000;0
1766;32146;52;0;0;0;0;.00nan;0;0
1767;26967;63;100;34;0;34;1.000;3600000;0
1767;32340;55;0;0;0;0;.00nan;0;0
1767;34770;55;76;21;1;20;.952;3600000;0
1767;34814;63;0;0;0;0;.00nan;0;0
1768;323;46;0;0;0;0;.00nan;0;0
1768;4447;54;0;0;0;0;.00nan;0;0
1768;31643;54;67;28;3;25;.893;3600000;0
1768;35622;46;82;32;2;30;.938;3600000;0
1769;2163;39;0;0;0;0;.00nan;0;0
1769;6081;56;88;35;3;32;.914;3900000;0
1769;9238;39;67;25;3;22;.880;3900000;0
1769;26824;56;0;0;0;0;.00nan;0;0
1770;5137;58;0;0;0;0;.00nan;0;0
1770;14321;58;70;30;3;27;.900;3600000;0
1770;23493;51;0;0;0;0;.00nan;0;0
1770;31408;51;75;29;2;27;.931;3600000;0
1771;1051;44;0;0;0;0;.00nan;0;0
1771;3281;44;64;25;2;23;.920;3600000;0
1771;14351;40;0;0;0;0;.00nan;0;0
1771;26840;40;87;28;1;27;.964;3600000;0
1772;3626;48;0;0;0;0;.00nan;0;0
1772;6572;62;0;0;0;0;.00nan;0;0
1772;26919;62;80;27;2;25;.926;3600000;0
1772;38547;48;62;30;3;27;.900;3560000;0
1773;2900;36;0;0;0;0;.00nan;0;0
1773;4338;65;0;0;0;0;.00nan;0;0
1773;4987;65;59;19;2;17;.895;3545000;0
1773;14874;36;81;31;1;30;.968;3600000;0
1774;2796;59;0;0;0;0;.00nan;0;0
1774;32340;55;0;0;0;0;.00nan;0;0
1774;34770;55;58;21;2;19;.905;3600000;0
1774;34819;59;58;31;4;27;.871;3587000;0
1775;5137;58;0;0;0;0;.00nan;0;0
1775;6081;56;53;26;3;23;.885;3600000;0
1775;14321;58;56;27;4;23;.852;3600000;0
1775;26824;56;0;0;0;0;.00nan;0;0
1776;23493;51;0;0;0;0;.00nan;0;0
1776;26967;63;50;33;5;28;.848;3600000;0
1776;31408;51;55;25;3;22;.880;3600000;0
1776;34814;63;0;0;0;0;.00nan;0;0
1777;3;50;78;30;2;28;.933;3541000;0
1777;323;46;0;0;0;0;.00nan;0;0
1777;5048;50;0;0;0;0;.00nan;0;0
1777;35622;46;78;26;1;25;.962;3600000;0
1778;3533;57;0;0;0;0;.00nan;0;0
1778;3847;38;77;17;0;17;1.000;1254000;0
1778;26865;57;55;27;3;24;.889;3600000;0
1778;31021;38;33;33;6;27;.818;2346000;0
1779;2163;39;0;0;0;0;.00nan;0;0
1779;9238;39;98;45;3;42;.933;3872000;0
1779;28772;53;79;42;3;39;.929;3900000;0
1779;31156;53;0;0;0;0;.00nan;0;0
1780;1486;43;84;34;3;31;.912;3900000;0
1780;3625;43;0;0;0;0;.00nan;0;0
1780;4447;54;54;26;3;23;.885;3900000;0
1780;31643;54;0;0;0;0;.00nan;0;0
1781;5146;64;100;38;0;38;1.000;3600000;0
1781;14323;64;0;0;0;0;.00nan;0;0
1781;34788;42;39;21;4;17;.810;3600000;0
1781;37416;42;0;0;0;0;.00nan;0;0
1782;2198;45;45;4;1;3;.750;625000;0
1782;5883;37;58;19;3;16;.842;3600000;0
1782;23043;37;0;0;0;0;.00nan;0;0
1782;36703;45;31;32;6;26;.813;2975000;0
1783;6572;62;0;0;0;0;.00nan;0;0
1783;14351;40;0;0;0;0;.00nan;0;0
1783;26840;40;76;25;2;23;.920;3900000;0
1783;26919;62;58;21;2;19;.905;3900000;0
1784;3626;48;0;0;0;0;.00nan;0;0
1784;20717;60;0;0;0;0;.00nan;0;0
1784;35536;60;45;26;4;22;.846;3876000;0
1784;38547;48;63;30;3;27;.900;3876000;0
1785;2016;61;0;0;0;0;.00nan;0;0
1785;7049;47;62;31;3;28;.903;3600000;0
1785;30971;61;33;15;4;11;.733;3561000;0
1785;33654;47;0;0;0;0;.00nan;0;0
1786;23493;51;50;28;4;24;.857;3600000;0
1786;26967;63;0;0;0;0;.00nan;0;0
1786;31408;51;0;0;0;0;.00nan;0;0
1786;34814;63;74;20;1;19;.950;3600000;0
1787;780;52;55;25;4;21;.840;3600000;0
1787;19640;41;96;25;0;25;1.000;3600000;0
1787;23075;41;0;0;0;0;.00nan;0;0
1787;32146;52;0;0;0;0;.00nan;0;0
1788;2796;59;65;26;3;23;.885;3900000;0
1788;4338;65;74;43;3;40;.930;3900000;0
1788;4987;65;0;0;0;0;.00nan;0;0
1788;34819;59;0;0;0;0;.00nan;0;0
1789;2163;39;0;0;0;0;.00nan;0;0
1789;2900;36;78;34;3;31;.912;3900000;0
1789;9238;39;73;25;3;22;.880;3900000;0
1789;14874;36;0;0;0;0;.00nan;0;0
1790;28772;53;0;0;0;0;.00nan;0;0
1790;31156;53;48;29;5;24;.828;3600000;0
1790;32340;55;0;0;0;0;.00nan;0;0
1790;34770;55;30;30;6;24;.800;3560000;0
1791;5137;58;0;0;0;0;.00nan;0;0
1791;6081;56;0;0;0;0;.00nan;0;0
1791;14321;58;100;34;0;34;1.000;3600000;0
1791;26824;56;72;31;3;28;.903;3600000;0
1792;4447;54;0;0;0;0;.00nan;0;0
1792;31643;54;97;21;0;21;1.000;3600000;0
1792;34788;42;0;0;0;0;.00nan;0;0
1792;37416;42;40;29;5;24;.828;3600000;0
1793;323;46;77;34;3;31;.912;3544000;0
1793;1486;43;0;0;0;0;.00nan;0;0
1793;3625;43;76;24;1;23;.958;3600000;0
1793;35622;46;0;0;0;0;.00nan;0;0
1794;3;50;0;0;0;0;.00nan;0;0
1794;5048;50;63;33;4;29;.879;3618000;0
1794;5146;64;66;30;3;27;.900;3618000;0
1794;14323;64;0;0;0;0;.00nan;0;0
1795;2198;45;72;29;2;27;.931;3600000;0
1795;5883;37;0;0;0;0;.00nan;0;0
1795;23043;37;53;25;3;22;.880;3577000;0
1795;36703;45;0;0;0;0;.00nan;0;0
1796;2152;49;65;22;3;19;.864;3900000;0
1796;4435;49;0;0;0;0;.00nan;0;0
1796;6572;62;82;43;3;40;.930;3900000;0
1796;26919;62;0;0;0;0;.00nan;0;0
1797;1051;44;61;33;4;29;.879;3520000;0
1797;3281;44;0;0;0;0;.00nan;0;0
1797;10698;4619;0;0;0;0;.00nan;0;0
1797;35210;4619;65;20;2;18;.900;3600000;0
1798;3626;48;100;29;0;29;1.000;3600000;0
1798;20717;60;0;0;0;0;.00nan;0;0
1798;35536;60;57;17;2;15;.882;3513000;0
1798;38547;48;0;0;0;0;.00nan;0;0
1799;780;52;0;0;0;0;.00nan;0;0
1799;19640;41;0;0;0;0;.00nan;0;0
1799;23075;41;69;19;1;18;.947;3600000;0
1799;32146;52;98;43;2;41;.953;3600000;0
1800;3533;57;0;0;0;0;.00nan;0;0
1800;3847;38;0;0;0;0;.00nan;0;0
1800;26865;57;71;24;2;22;.917;3805000;0
1800;31021;38;71;20;1;19;.950;3805000;0
1801;1486;43;88;29;1;28;.966;3600000;0
1801;3625;43;0;0;0;0;.00nan;0;0
1801;5146;64;0;0;0;0;.00nan;0;0
1801;14323;64;72;39;4;35;.897;3600000;0
1802;2796;59;0;0;0;0;.00nan;0;0
1802;4338;65;0;0;0;0;.00nan;0;0
1802;4987;65;59;38;5;33;.868;3600000;0
1802;34819;59;67;28;3;25;.893;3600000;0
1803;2152;49;0;0;0;0;.00nan;0;0
1803;4435;49;72;25;3;22;.880;3900000;0
1803;14351;40;0;0;0;0;.00nan;0;0
1803;26840;40;95;41;3;38;.927;3900000;0
1804;1051;44;0;0;0;0;.00nan;0;0
1804;3281;44;78;21;1;20;.952;3600000;0
1804;10698;4619;95;41;2;39;.951;3600000;0
1804;35210;4619;0;0;0;0;.00nan;0;0
1805;2016;61;0;0;0;0;.00nan;0;0
1805;7049;47;56;37;4;33;.892;3573000;0
1805;30971;61;99;34;2;32;.941;3600000;0
1805;33654;47;0;0;0;0;.00nan;0;0
1806;3;50;0;0;0;0;.00nan;0;0
1806;5048;50;80;21;1;20;.952;3600000;0
1806;34788;42;50;35;5;30;.857;3600000;0
1806;37416;42;0;0;0;0;.00nan;0;0
1807;19640;41;72;22;2;20;.909;3600000;0
1807;23075;41;0;0;0;0;.00nan;0;0
1807;28772;53;80;40;3;37;.925;3575000;0
1807;31156;53;0;0;0;0;.00nan;0;0
1808;780;52;92;37;3;34;.919;3631000;0
1808;4338;65;60;29;4;25;.862;3631000;0
1808;4987;65;0;0;0;0;.00nan;0;0
1808;32146;52;0;0;0;0;.00nan;0;0
1809;6081;56;59;29;3;26;.897;3600000;0
1809;26824;56;0;0;0;0;.00nan;0;0
1809;26967;63;78;25;1;24;.960;3600000;0
1809;34814;63;0;0;0;0;.00nan;0;0
1810;2163;39;0;0;0;0;.00nan;0;0
1810;9238;39;94;23;0;23;1.000;3600000;0
1810;32340;55;0;0;0;0;.00nan;0;0
1810;34770;55;51;21;3;18;.857;3600000;0
1811;2900;36;0;0;0;0;.00nan;0;0
1811;14874;36;43;24;4;20;.833;3600000;0
1811;23493;51;0;0;0;0;.00nan;0;0
1811;31408;51;88;25;1;24;.960;3600000;0
1812;4447;54;0;0;0;0;.00nan;0;0
1812;5883;37;78;24;1;23;.958;3600000;0
1812;23043;37;0;0;0;0;.00nan;0;0
1812;31643;54;83;31;2;29;.935;3600000;0
1813;323;46;0;0;0;0;.00nan;0;0
1813;5146;64;78;32;2;30;.938;3600000;0
1813;14323;64;0;0;0;0;.00nan;0;0
1813;35622;46;48;22;3;19;.864;3579000;0
1814;1051;44;60;29;3;26;.897;3557000;0
1814;3281;44;0;0;0;0;.00nan;0;0
1814;20717;60;0;0;0;0;.00nan;0;0
1814;35536;60;84;35;2;33;.943;3600000;0
1815;3626;48;82;34;3;31;.912;3595000;0
1815;14351;40;0;0;0;0;.00nan;0;0
1815;26840;40;80;31;2;29;.935;3600000;0
1815;38547;48;0;0;0;0;.00nan;0;0
1816;2900;36;0;0;0;0;.00nan;0;0
1816;5298;55;0;0;0;0;.00nan;0;0
1816;14874;36;83;27;2;25;.926;3584000;0
1816;34770;55;100;26;0;26;1.000;3600000;0
1817;323;46;0;0;0;0;.00nan;0;0
1817;5883;37;69;23;1;22;.957;3600000;0
1817;23043;37;0;0;0;0;.00nan;0;0
1817;35622;46;85;31;2;29;.935;3583000;0
1818;3;50;80;25;1;24;.960;3600000;0
1818;5048;50;0;0;0;0;.00nan;0;0
1818;5146;64;0;0;0;0;.00nan;0;0
1818;14323;64;49;34;5;29;.853;3600000;0
1819;3847;38;0;0;0;0;.00nan;0;0
1819;28772;53;44;33;5;28;.848;3589000;0
1819;31021;38;89;39;3;36;.923;3600000;0
1819;31156;53;0;0;0;0;.00nan;0;0
1820;2796;59;0;0;0;0;.00nan;0;0
1820;3533;57;0;0;0;0;.00nan;0;0
1820;26865;57;52;43;6;37;.860;3600000;0
1820;34819;59;99;23;0;23;1.000;3600000;0
1821;5137;58;0;0;0;0;.00nan;0;0
1821;14321;58;73;31;2;29;.935;3600000;0
1821;23493;51;0;0;0;0;.00nan;0;0
1821;31408;51;100;34;0;34;1.000;3600000;0
1822;2163;39;0;0;0;0;.00nan;0;0
1822;6081;56;82;29;1;28;.966;3600000;0
1822;9238;39;68;26;2;24;.923;3593000;0
1822;26824;56;0;0;0;0;.00nan;0;0
1823;1486;43;20;17;5;12;.706;2285000;0
1823;3625;43;63;18;1;17;.944;1315000;0
1823;34788;42;0;0;0;0;.00nan;0;0
1823;37416;42;70;26;3;23;.885;3600000;0
1824;4447;54;90;37;2;35;.946;3600000;0
1824;4716;4619;25;21;5;16;.762;3600000;0
1824;10698;4619;0;0;0;0;.00nan;0;0
1824;31643;54;0;0;0;0;.00nan;0;0
1825;7049;47;63;21;3;18;.857;3576000;0
1825;14351;40;0;0;0;0;.00nan;0;0
1825;26840;40;71;23;2;21;.913;3600000;0
1825;33654;47;0;0;0;0;.00nan;0;0
1826;2152;49;73;25;1;24;.960;3600000;0
1826;3626;48;77;40;3;37;.925;3595000;0
1826;4435;49;0;0;0;0;.00nan;0;0
1826;38547;48;0;0;0;0;.00nan;0;0
1827;2016;61;0;0;0;0;.00nan;0;0
1827;6572;62;0;0;0;0;.00nan;0;0
1827;26919;62;100;35;0;35;1.000;3600000;0
1827;30971;61;62;29;3;26;.897;3600000;0
1828;1051;44;54;39;6;33;.846;3707000;0
1828;3281;44;0;0;0;0;.00nan;0;0
1828;20717;60;0;0;0;0;.00nan;0;0
1828;35536;60;53;35;5;30;.857;3707000;0
1829;3;50;0;0;0;0;.00nan;0;0
1829;5048;50;78;18;1;17;.944;3600000;0
1829;5146;64;83;45;3;42;.933;3546000;0
1829;38651;64;0;0;0;0;.00nan;0;0
1830;2198;45;0;0;0;0;.00nan;0;0
1830;19640;41;70;24;2;22;.917;3600000;0
1830;23075;41;0;0;0;0;.00nan;0;0
1830;36703;45;76;44;4;40;.909;3547000;0
1831;2163;39;0;0;0;0;.00nan;0;0
1831;6081;56;0;0;0;0;.00nan;0;0
1831;9238;39;77;29;2;27;.931;3600000;0
1831;26824;56;54;29;4;25;.862;3511000;0
1832;23493;51;0;0;0;0;.00nan;0;0
1832;28772;53;0;0;0;0;.00nan;0;0
1832;31156;53;88;44;3;41;.932;3600000;0
1832;31408;51;54;26;4;22;.846;3581000;0
1833;4338;65;35;36;7;29;.806;3600000;0
1833;4987;65;0;0;0;0;.00nan;0;0
1833;26967;63;72;31;3;28;.903;3600000;0
1833;34814;63;0;0;0;0;.00nan;0;0
1834;2900;36;82;41;4;37;.902;3600000;0
1834;5298;55;0;0;0;0;.00nan;0;0
1834;14874;36;0;0;0;0;.00nan;0;0
1834;34770;55;80;26;1;25;.962;3600000;0
1835;323;46;64;28;3;25;.893;3600000;0
1835;5883;37;0;0;0;0;.00nan;0;0
1835;23043;37;66;37;4;33;.892;3566000;0
1835;35622;46;0;0;0;0;.00nan;0;0
1836;1486;43;0;0;0;0;.00nan;0;0
1836;3625;43;76;30;2;28;.933;3600000;0
1836;34788;42;88;27;1;26;.963;3600000;0
1836;37416;42;0;0;0;0;.00nan;0;0
1837;2796;59;0;0;0;0;.00nan;0;0
1837;3533;57;75;28;2;26;.929;3559000;0
1837;26865;57;0;0;0;0;.00nan;0;0
1837;34819;59;87;31;1;30;.968;3600000;0
1838;3847;38;25;24;6;18;.750;3600000;0
1838;5137;58;100;26;0;26;1.000;3600000;0
1838;14321;58;0;0;0;0;.00nan;0;0
1838;31021;38;0;0;0;0;.00nan;0;0
1839;4447;54;0;0;0;0;.00nan;0;0
1839;4716;4619;0;0;0;0;.00nan;0;0
1839;10698;4619;97;26;0;26;1.000;3600000;0
1839;31643;54;87;31;1;30;.968;3541000;0
1840;7049;47;0;0;0;0;.00nan;0;0
1840;20717;60;56;24;3;21;.875;3900000;0
1840;33654;47;92;48;3;45;.938;3900000;0
1840;35536;60;0;0;0;0;.00nan;0;0
1841;2016;61;30;30;6;24;.800;3600000;0
1841;6572;62;0;0;0;0;.00nan;0;0
1841;26919;62;84;34;2;32;.941;3600000;0
1841;30971;61;0;0;0;0;.00nan;0;0
1842;1051;44;0;0;0;0;.00nan;0;0
1842;3281;44;43;25;4;21;.840;3573000;0
1842;14351;40;80;39;3;36;.923;3600000;0
1842;26840;40;0;0;0;0;.00nan;0;0
1843;2152;49;0;0;0;0;.00nan;0;0
1843;3626;48;0;0;0;0;.00nan;0;0
1843;4435;49;36;32;6;26;.813;3600000;0
1843;38547;48;68;41;4;37;.902;3600000;0
1844;2198;45;74;26;2;24;.923;3600000;0
1844;19640;41;0;0;0;0;.00nan;0;0
1844;23075;41;80;21;1;20;.952;3600000;0
1844;36703;45;0;0;0;0;.00nan;0;0
1845;780;52;0;0;0;0;.00nan;0;0
1845;3847;38;0;0;0;0;.00nan;0;0
1845;31021;38;75;33;2;31;.939;3600000;0
1845;32146;52;41;29;5;24;.828;3598000;0
1846;3533;57;0;0;0;0;.00nan;0;0
1846;26865;57;80;29;1;28;.966;3600000;0
1846;26967;63;0;0;0;0;.00nan;0;0
1846;34814;63;63;33;4;29;.879;3600000;0
1847;2796;59;38;26;5;21;.808;3600000;0
1847;4338;65;0;0;0;0;.00nan;0;0
1847;4987;65;92;40;2;38;.950;3600000;0
1847;34819;59;0;0;0;0;.00nan;0;0
1848;2900;36;0;0;0;0;.00nan;0;0
1848;6081;56;67;34;3;31;.912;3600000;0
1848;14874;36;67;33;4;29;.879;3549000;0
1848;26824;56;0;0;0;0;.00nan;0;0
1849;5146;64;33;34;6;28;.824;2930000;0
1849;34788;42;66;24;2;22;.917;3600000;0
1849;37416;42;0;0;0;0;.00nan;0;0
1849;38651;64;67;12;0;12;1.000;670000;0
1850;3;50;82;41;3;38;.927;3900000;0
1850;4447;54;77;32;3;29;.906;3900000;0
1850;5048;50;0;0;0;0;.00nan;0;0
1850;31643;54;0;0;0;0;.00nan;0;0
1851;2016;61;0;0;0;0;.00nan;0;0
1851;2152;49;0;0;0;0;.00nan;0;0
1851;4435;49;62;32;4;28;.875;3600000;0
1851;30971;61;69;41;5;36;.878;3598000;0
1852;5137;58;77;23;1;22;.957;3600000;0
1852;14321;58;0;0;0;0;.00nan;0;0
1852;19640;41;61;25;2;23;.920;3572000;0
1852;23075;41;0;0;0;0;.00nan;0;0
1853;1486;43;0;0;0;0;.00nan;0;0
1853;3625;43;55;40;6;34;.850;3600000;0
1853;5571;46;0;0;0;0;.00nan;0;0
1853;35622;46;63;26;3;23;.885;3600000;0
1854;6572;62;0;0;0;0;.00nan;0;0
1854;20717;60;0;0;0;0;.00nan;0;0
1854;26919;62;56;23;3;20;.870;3559000;0
1854;35536;60;88;26;1;25;.962;3600000;0
1855;26967;63;87;39;2;37;.949;3600000;0
1855;28772;53;45;21;4;17;.810;3600000;0
1855;31156;53;0;0;0;0;.00nan;0;0
1855;34814;63;0;0;0;0;.00nan;0;0
1856;2796;59;0;0;0;0;.00nan;0;0
1856;3533;57;0;0;0;0;.00nan;0;0
1856;26865;57;85;30;2;28;.933;3600000;0
1856;34819;59;64;35;4;31;.886;3525000;0
1857;2163;39;0;0;0;0;.00nan;0;0
1857;2900;36;0;0;0;0;.00nan;0;0
1857;9238;39;72;39;3;36;.923;3900000;0
1857;14874;36;85;37;3;34;.919;3900000;0
1858;5298;55;0;0;0;0;.00nan;0;0
1858;23493;51;0;0;0;0;.00nan;0;0
1858;31408;51;41;31;5;26;.839;3600000;0
1858;34770;55;30;29;6;23;.793;3573000;0
1859;2198;45;0;0;0;0;.00nan;0;0
1859;4447;54;50;1;0;1;1.000;437000;0
1859;31643;54;30;27;7;20;.741;3163000;0
1859;36703;45;64;26;3;23;.885;3600000;0
1860;1051;44;0;0;0;0;.00nan;0;0
1860;3281;44;36;24;4;20;.833;3900000;0
1860;7049;47;71;37;4;33;.892;3900000;0
1860;33654;47;0;0;0;0;.00nan;0;0
1861;6572;62;57;30;4;26;.867;3567000;0
1861;14351;40;0;0;0;0;.00nan;0;0
1861;26840;40;69;35;3;32;.914;3600000;0
1861;26919;62;0;0;0;0;.00nan;0;0
1862;5137;58;0;0;0;0;.00nan;0;0
1862;14321;58;55;33;5;28;.848;3528000;0
1862;19640;41;60;22;3;19;.864;3600000;0
1862;23075;41;0;0;0;0;.00nan;0;0
1863;2900;36;0;0;0;0;.00nan;0;0
1863;5298;55;0;0;0;0;.00nan;0;0
1863;14874;36;94;21;0;21;1.000;3600000;0
1863;34770;55;41;33;6;27;.818;3600000;0
1864;1486;43;72;28;2;26;.929;3600000;0
1864;2163;39;0;0;0;0;.00nan;0;0
1864;3625;43;0;0;0;0;.00nan;0;0
1864;9238;39;65;32;4;28;.875;3570000;0
1865;6081;56;69;26;2;24;.923;3564000;0
1865;23493;51;0;0;0;0;.00nan;0;0
1865;26824;56;0;0;0;0;.00nan;0;0
1865;31408;51;78;22;1;21;.955;3600000;0
1866;780;52;0;0;0;0;.00nan;0;0
1866;3847;38;0;0;0;0;.00nan;0;0
1866;31021;38;65;39;4;35;.897;3555000;0
1866;32146;52;71;28;2;26;.929;3600000;0
1867;2796;59;0;0;0;0;.00nan;0;0
1867;26967;63;98;38;2;36;.947;3600000;0
1867;34814;63;0;0;0;0;.00nan;0;0
1867;34819;59;56;26;3;23;.885;3557000;0
1868;2198;45;0;0;0;0;.00nan;0;0
1868;34788;42;0;0;0;0;.00nan;0;0
1868;36703;45;45;44;7;37;.841;3526000;0
1868;37416;42;48;36;5;31;.861;3600000;0
1869;3;50;57;26;4;22;.846;3550000;0
1869;4716;4619;0;0;0;0;.00nan;0;0
1869;5048;50;0;0;0;0;.00nan;0;0
1869;10698;4619;85;38;3;35;.921;3600000;0
1870;3626;48;68;30;3;27;.900;3600000;0
1870;14351;40;0;0;0;0;.00nan;0;0
1870;26840;40;43;21;4;17;.810;3559000;0
1870;38547;48;0;0;0;0;.00nan;0;0
1871;1486;43;0;0;0;0;.00nan;0;0
1871;2163;39;0;0;0;0;.00nan;0;0
1871;3625;43;92;43;3;40;.930;3600000;0
1871;9238;39;46;26;4;22;.846;3544000;0
1872;5146;64;58;38;5;33;.868;3521000;0
1872;5883;37;56;24;3;21;.875;3600000;0
1872;23043;37;0;0;0;0;.00nan;0;0
1872;38651;64;0;0;0;0;.00nan;0;0
1873;3533;57;0;0;0;0;.00nan;0;0
1873;19640;41;68;39;4;35;.897;3600000;0
1873;23075;41;0;0;0;0;.00nan;0;0
1873;26865;57;99;39;1;38;.974;3600000;0
1874;2796;59;0;0;0;0;.00nan;0;0
1874;26967;63;75;29;2;27;.931;3600000;0
1874;34814;63;0;0;0;0;.00nan;0;0
1874;34819;59;77;20;1;19;.950;3600000;0
1875;780;52;92;40;1;39;.975;3600000;0
1875;3847;38;78;31;2;29;.935;3553000;0
1875;31021;38;0;0;0;0;.00nan;0;0
1875;32146;52;0;0;0;0;.00nan;0;0
1876;4338;65;0;0;0;0;.00nan;0;0
1876;4987;65;88;27;1;26;.963;3600000;0
1876;28772;53;49;20;3;17;.850;3573000;0
1876;31156;53;0;0;0;0;.00nan;0;0
1877;2900;36;0;0;0;0;.00nan;0;0
1877;5298;55;77;43;4;39;.907;3559000;0
1877;14874;36;78;27;2;25;.926;3600000;0
1877;34770;55;0;0;0;0;.00nan;0;0
1878;6081;56;0;0;0;0;.00nan;0;0
1878;23493;51;0;0;0;0;.00nan;0;0
1878;26824;56;100;26;0;26;1.000;3600000;0
1878;31408;51;81;31;2;29;.935;3578000;0
1879;323;46;86;24;1;23;.958;3900000;0
1879;4447;54;0;0;0;0;.00nan;0;0
1879;31643;54;80;22;1;21;.955;3900000;0
1879;35622;46;0;0;0;0;.00nan;0;0
1880;2198;45;63;17;2;15;.882;3600000;0
1880;34788;42;47;26;4;22;.846;3515000;0
1880;36703;45;0;0;0;0;.00nan;0;0
1880;37416;42;0;0;0;0;.00nan;0;0
1881;1051;44;0;0;0;0;.00nan;0;0
1881;2152;49;100;32;0;32;1.000;3600000;0
1881;3281;44;81;25;1;24;.960;3545000;0
1881;4435;49;0;0;0;0;.00nan;0;0
1882;3626;48;0;0;0;0;.00nan;0;0
1882;14351;40;0;0;0;0;.00nan;0;0
1882;26840;40;62;22;2;20;.909;3600000;0
1882;38547;48;93;39;1;38;.974;3600000;0
1883;3;50;0;0;0;0;.00nan;0;0
1883;4716;4619;50;22;3;19;.864;3600000;0
1883;5048;50;35;23;4;19;.826;3545000;0
1883;10698;4619;0;0;0;0;.00nan;0;0
1884;7049;47;100;41;0;41;1.000;3600000;0
1884;20717;60;0;0;0;0;.00nan;0;0
1884;33654;47;0;0;0;0;.00nan;0;0
1884;35536;60;71;34;3;31;.912;3549000;0
1885;2016;61;0;0;0;0;.00nan;0;0
1885;6572;62;0;0;0;0;.00nan;0;0
1885;26919;62;82;49;4;45;.918;3600000;0
1885;30971;61;100;23;0;23;1.000;3600000;0
1886;3533;57;0;0;0;0;.00nan;0;0
1886;19640;41;0;0;0;0;.00nan;0;0
1886;23075;41;44;26;4;22;.846;3600000;0
1886;26865;57;50;39;6;33;.846;3527000;0
1887;780;52;0;0;0;0;.00nan;0;0
1887;5137;58;0;0;0;0;.00nan;0;0
1887;14321;58;80;30;2;28;.933;3600000;0
1887;32146;52;35;28;5;23;.821;3600000;0
1888;4338;65;65;37;4;33;.892;3600000;0
1888;4987;65;0;0;0;0;.00nan;0;0
1888;28772;53;0;0;0;0;.00nan;0;0
1888;31156;53;100;24;0;24;1.000;3600000;0
1889;5146;64;0;0;0;0;.00nan;0;0
1889;5883;37;0;0;0;0;.00nan;0;0
1889;23043;37;57;38;5;33;.868;3600000;0
1889;38651;64;85;28;1;27;.964;3600000;0
1890;1051;44;91;31;1;30;.968;3900000;0
1890;2152;49;89;32;1;31;.969;3900000;0
1890;3281;44;0;0;0;0;.00nan;0;0
1890;4435;49;0;0;0;0;.00nan;0;0
1891;2016;61;0;0;0;0;.00nan;0;0
1891;6572;62;47;27;4;23;.852;3600000;0
1891;26919;62;0;0;0;0;.00nan;0;0
1891;30971;61;94;34;1;33;.971;3600000;0
1892;7049;47;67;29;2;27;.931;3544000;0
1892;20717;60;0;0;0;0;.00nan;0;0
1892;33654;47;0;0;0;0;.00nan;0;0
1892;35536;60;99;41;1;40;.976;3600000;0
1893;2796;59;0;0;0;0;.00nan;0;0
1893;4338;65;0;0;0;0;.00nan;0;0
1893;4987;65;55;38;5;33;.868;3900000;0
1893;34819;59;53;37;5;32;.865;3900000;0
1894;2152;49;96;30;1;29;.967;3600000;0
1894;4435;49;0;0;0;0;.00nan;0;0
1894;20717;60;0;0;0;0;.00nan;0;0
1894;35536;60;74;39;3;36;.923;3553000;0
1895;1486;43;72;34;3;31;.912;3600000;0
1895;2900;36;0;0;0;0;.00nan;0;0
1895;3625;43;0;0;0;0;.00nan;0;0
1895;14874;36;90;20;0;20;1.000;3600000;0
1896;3847;38;0;0;0;0;.00nan;0;0
1896;5298;55;0;0;0;0;.00nan;0;0
1896;31021;38;48;24;4;20;.833;3552000;0
1896;34770;55;83;39;2;37;.949;3600000;0
1897;323;46;0;0;0;0;.00nan;0;0
1897;4447;54;60;22;2;20;.909;3552000;0
1897;31643;54;0;0;0;0;.00nan;0;0
1897;35622;46;82;21;1;20;.952;3600000;0
1898;2198;45;0;0;0;0;.00nan;0;0
1898;5146;64;66;38;4;34;.895;3600000;0
1898;36703;45;80;29;1;28;.966;3600000;0
1898;38651;64;0;0;0;0;.00nan;0;0
1899;3;50;0;0;0;0;.00nan;0;0
1899;5048;50;58;34;4;30;.882;3600000;0
1899;34788;42;0;0;0;0;.00nan;0;0
1899;37416;42;47;13;2;11;.846;3600000;0
1900;1051;44;0;0;0;0;.00nan;0;0
1900;3281;44;99;39;1;38;.974;3600000;0
1900;7049;47;17;17;5;12;.706;2292000;0
1900;33654;47;46;5;1;4;.800;1308000;0
1901;4716;4619;32;23;5;18;.783;3600000;0
1901;6572;62;0;0;0;0;.00nan;0;0
1901;10698;4619;0;0;0;0;.00nan;0;0
1901;26919;62;99;35;2;33;.943;3600000;0
1902;3847;38;0;0;0;0;.00nan;0;0
1902;28772;53;0;0;0;0;.00nan;0;0
1902;31021;38;93;41;2;39;.951;3600000;0
1902;31156;53;78;37;3;34;.919;3580000;0
1903;1486;43;0;0;0;0;.00nan;0;0
1903;2796;59;0;0;0;0;.00nan;0;0
1903;3625;43;59;37;4;33;.892;3600000;0
1903;34819;59;73;21;1;20;.952;3600000;0
1904;5298;55;0;0;0;0;.00nan;0;0
1904;19640;41;62;41;6;35;.854;3874000;0
1904;23075;41;0;0;0;0;.00nan;0;0
1904;34770;55;82;54;5;49;.907;3876000;0
1905;6081;56;52;25;3;22;.880;2486000;0
1905;26824;56;25;15;4;11;.733;1114000;0
1905;26967;63;65;34;4;30;.882;3600000;0
1905;34814;63;0;0;0;0;.00nan;0;0
1906;3533;57;0;0;0;0;.00nan;0;0
1906;5137;58;0;0;0;0;.00nan;0;0
1906;14321;58;59;33;4;29;.879;3600000;0
1906;26865;57;74;17;1;16;.941;3600000;0
1907;2163;39;0;0;0;0;.00nan;0;0
1907;2900;36;0;0;0;0;.00nan;0;0
1907;9238;39;92;42;3;39;.929;3886000;0
1907;14874;36;43;26;4;22;.846;3886000;0
1908;4447;54;0;0;0;0;.00nan;0;0
1908;31643;54;51;21;3;18;.857;3600000;0
1908;34788;42;0;0;0;0;.00nan;0;0
1908;37416;42;89;31;2;29;.935;3600000;0
1909;323;46;72;29;3;26;.897;3600000;0
1909;5146;64;55;6;0;6;1.000;615000;0
1909;14323;64;34;30;6;24;.800;2985000;0
1909;35622;46;0;0;0;0;.00nan;0;0
1910;2198;45;0;0;0;0;.00nan;0;0
1910;23493;51;74;38;4;34;.895;2648000;0
1910;31408;51;28;14;4;10;.714;952000;0
1910;36703;45;68;29;3;26;.897;3600000;0
1911;3;50;67;17;1;16;.941;3600000;0
1911;5048;50;0;0;0;0;.00nan;0;0
1911;6572;62;0;0;0;0;.00nan;0;0
1911;26919;62;64;27;3;24;.889;3590000;0
1912;1051;44;0;0;0;0;.00nan;0;0
1912;3281;44;67;14;1;13;.929;3600000;0
1912;7049;47;83;45;3;42;.933;3562000;0
1912;33654;47;0;0;0;0;.00nan;0;0
1913;2152;49;58;40;5;35;.875;3600000;0
1913;4435;49;0;0;0;0;.00nan;0;0
1913;20717;60;0;0;0;0;.00nan;0;0
1913;35536;60;68;38;4;34;.895;3600000;0
1914;3626;48;72;31;3;28;.903;3567000;0
1914;4716;4619;0;0;0;0;.00nan;0;0
1914;10698;4619;84;35;2;33;.943;3600000;0
1914;38547;48;0;0;0;0;.00nan;0;0
1915;2016;61;0;0;0;0;.00nan;0;0
1915;5883;37;46;24;4;20;.833;3773000;0
1915;23043;37;0;0;0;0;.00nan;0;0
1915;30971;61;49;33;5;28;.848;3773000;0
1916;2163;39;0;0;0;0;.00nan;0;0
1916;5298;55;88;41;3;38;.927;3600000;0
1916;9238;39;77;21;1;20;.952;3600000;0
1916;34770;55;0;0;0;0;.00nan;0;0
1917;3533;57;0;0;0;0;.00nan;0;0
1917;26865;57;49;38;6;32;.842;3600000;0
1917;28772;53;90;41;3;38;.927;3600000;0
1917;31156;53;0;0;0;0;.00nan;0;0
1918;780;52;78;34;2;32;.941;3800000;0
1918;4338;65;0;0;0;0;.00nan;0;0
1918;4987;65;68;25;3;22;.880;3800000;0
1918;32146;52;0;0;0;0;.00nan;0;0
1919;2900;36;54;32;4;28;.875;3600000;0
1919;14874;36;0;0;0;0;.00nan;0;0
1919;19640;41;0;0;0;0;.00nan;0;0
1919;23075;41;70;16;1;15;.938;3600000;0
1920;1486;43;86;38;3;35;.921;3600000;0
1920;2796;59;0;0;0;0;.00nan;0;0
1920;3625;43;0;0;0;0;.00nan;0;0
1920;34819;59;44;23;4;19;.826;3565000;0
1921;6081;56;0;0;0;0;.00nan;0;0
1921;26824;56;77;28;2;26;.929;3600000;0
1921;26967;63;53;30;4;26;.867;3538000;0
1921;34814;63;0;0;0;0;.00nan;0;0
1922;323;46;0;0;0;0;.00nan;0;0
1922;4447;54;67;34;4;30;.882;3900000;0
1922;31643;54;0;0;0;0;.00nan;0;0
1922;35622;46;47;27;4;23;.852;3900000;0
1923;3;50;0;0;0;0;.00nan;0;0
1923;5048;50;75;34;2;32;.941;3600000;0
1923;6572;62;58;26;3;23;.885;3565000;0
1923;26919;62;0;0;0;0;.00nan;0;0
1924;3847;38;54;20;3;17;.850;3600000;0
1924;5137;58;0;0;0;0;.00nan;0;0
1924;14321;58;57;37;5;32;.865;3579000;0
1924;31021;38;0;0;0;0;.00nan;0;0
1925;5146;64;47;27;3;24;.889;3900000;0
1925;14323;64;0;0;0;0;.00nan;0;0
1925;34788;42;69;30;3;27;.900;3900000;0
1925;37416;42;0;0;0;0;.00nan;0;0
1926;2198;45;77;35;2;33;.943;3600000;0
1926;23493;51;0;0;0;0;.00nan;0;0
1926;31408;51;57;25;3;22;.880;3578000;0
1926;36703;45;0;0;0;0;.00nan;0;0
1927;2152;49;0;0;0;0;.00nan;0;0
1927;4435;49;89;32;2;30;.938;3600000;0
1927;14351;40;0;0;0;0;.00nan;0;0
1927;26840;40;24;23;6;17;.739;3600000;0
1928;1051;44;74;21;1;20;.952;3600000;0
1928;3281;44;0;0;0;0;.00nan;0;0
1928;7049;47;0;0;0;0;.00nan;0;0
1928;33654;47;54;38;5;33;.868;3600000;0
1929;3626;48;0;0;0;0;.00nan;0;0
1929;4716;4619;58;22;2;20;.909;3722000;0
1929;10698;4619;0;0;0;0;.00nan;0;0
1929;38547;48;90;51;3;48;.941;3722000;0
1930;2016;61;0;0;0;0;.00nan;0;0
1930;5883;37;0;0;0;0;.00nan;0;0
1930;23043;37;48;27;4;23;.852;3570000;0
1930;30971;61;94;34;2;32;.941;3600000;0
1931;3533;57;86;35;2;33;.943;3600000;0
1931;4338;65;46;27;4;23;.852;3558000;0
1931;4987;65;0;0;0;0;.00nan;0;0
1931;26865;57;0;0;0;0;.00nan;0;0
1932;780;52;0;0;0;0;.00nan;0;0
1932;3533;57;28;25;6;19;.760;2694000;0
1932;26865;57;51;2;0;2;1.000;906000;0
1932;32146;52;85;28;1;27;.964;3600000;0
1933;4338;65;0;0;0;0;.00nan;0;0
1933;4987;65;68;31;3;28;.903;3600000;0
1933;28772;53;0;0;0;0;.00nan;0;0
1933;31156;53;89;17;0;17;1.000;3600000;0
1934;5298;55;0;0;0;0;.00nan;0;0
1934;23493;51;0;0;0;0;.00nan;0;0
1934;31408;51;69;43;5;38;.884;3545000;0
1934;34770;55;69;33;3;30;.909;3600000;0
1935;2900;36;0;0;0;0;.00nan;0;0
1935;6081;56;86;38;2;36;.947;3600000;0
1935;14874;36;60;26;3;23;.885;3560000;0
1935;26824;56;0;0;0;0;.00nan;0;0
1936;2796;59;57;22;3;19;.864;3050000;0
1936;5137;58;0;0;0;0;.00nan;0;0
1936;14321;58;80;25;1;24;.960;3600000;0
1936;34819;59;33;7;3;4;.571;550000;0
1937;2163;39;0;0;0;0;.00nan;0;0
1937;9238;39;66;22;2;20;.909;3600000;0
1937;19640;41;56;46;6;40;.870;3600000;0
1937;23075;41;0;0;0;0;.00nan;0;0
1938;1098;42;0;0;0;0;.00nan;0;0
1938;4447;54;0;0;0;0;.00nan;0;0
1938;31643;54;100;46;1;45;.978;3600000;0
1938;37416;42;78;29;2;27;.931;3600000;0
1939;4716;4619;41;20;4;16;.800;3546000;0
1939;6572;62;0;0;0;0;.00nan;0;0
1939;10698;4619;0;0;0;0;.00nan;0;0
1939;26919;62;72;36;3;33;.917;3600000;0
1940;3626;48;91;20;0;20;1.000;3600000;0
1940;20717;60;0;0;0;0;.00nan;0;0
1940;35536;60;80;34;2;32;.941;3600000;0
1940;38547;48;0;0;0;0;.00nan;0;0
1941;1486;43;54;31;4;27;.871;3794000;0
1941;3625;43;0;0;0;0;.00nan;0;0
1941;26967;63;61;27;3;24;.889;3794000;0
1941;34814;63;0;0;0;0;.00nan;0;0
1942;3626;48;73;42;4;38;.905;3600000;0
1942;20717;60;71;21;1;20;.952;3600000;0
1942;35536;60;0;0;0;0;.00nan;0;0
1942;38547;48;0;0;0;0;.00nan;0;0
1943;2016;61;0;0;0;0;.00nan;0;0
1943;14351;40;52;3;0;3;1.000;573000;0
1943;26840;40;39;33;6;27;.818;3027000;0
1943;30971;61;97;41;2;39;.951;3600000;0
1944;1486;43;0;0;0;0;.00nan;0;0
1944;3625;43;81;30;2;28;.933;3900000;0
1944;4338;65;0;0;0;0;.00nan;0;0
1944;4987;65;81;25;2;23;.920;3900000;0
1945;5298;55;79;27;2;25;.926;3600000;0
1945;23493;51;0;0;0;0;.00nan;0;0
1945;31408;51;71;44;4;40;.909;3570000;0
1945;34770;55;0;0;0;0;.00nan;0;0
1946;2900;36;0;0;0;0;.00nan;0;0
1946;6081;56;0;0;0;0;.00nan;0;0
1946;14874;36;51;42;6;36;.857;3600000;0
1946;26824;56;87;33;2;31;.939;3600000;0
1947;323;46;86;33;1;32;.970;3900000;0
1947;2152;49;0;0;0;0;.00nan;0;0
1947;4435;49;100;40;1;39;.975;3900000;0
1947;35622;46;0;0;0;0;.00nan;0;0
1948;3533;57;0;0;0;0;.00nan;0;0
1948;3847;38;0;0;0;0;.00nan;0;0
1948;26865;57;50;39;5;34;.872;3590000;0
1948;31021;38;59;22;3;19;.864;3600000;0
1949;780;52;0;0;0;0;.00nan;0;0
1949;2796;59;0;0;0;0;.00nan;0;0
1949;32146;52;85;26;1;25;.962;3871000;0
1949;34819;59;93;29;1;28;.966;3900000;0
1950;5137;58;0;0;0;0;.00nan;0;0
1950;14321;58;83;32;2;30;.938;3900000;0
1950;28772;53;0;0;0;0;.00nan;0;0
1950;31156;53;83;34;2;32;.941;3900000;0
1951;2163;39;0;0;0;0;.00nan;0;0
1951;9238;39;57;40;5;35;.875;3600000;0
1951;19640;41;86;30;2;28;.933;3600000;0
1951;23075;41;0;0;0;0;.00nan;0;0
1952;2198;45;49;7;1;6;.857;1231000;0
1952;5883;37;64;32;4;28;.875;3600000;0
1952;23043;37;0;0;0;0;.00nan;0;0
1952;36703;45;43;24;4;20;.833;2306000;0
1953;4447;54;0;0;0;0;.00nan;0;0
1953;5146;64;63;39;4;35;.897;3600000;0
1953;14323;64;0;0;0;0;.00nan;0;0
1953;31643;54;80;22;1;21;.955;3600000;0
1954;3;50;78;25;1;24;.960;3600000;0
1954;1098;42;0;0;0;0;.00nan;0;0
1954;9439;50;0;0;0;0;.00nan;0;0
1954;37416;42;74;32;2;30;.938;3545000;0
1955;4716;4619;0;0;0;0;.00nan;0;0
1955;7049;47;70;38;3;35;.921;3600000;0
1955;10698;4619;75;22;2;20;.909;3600000;0
1955;33654;47;0;0;0;0;.00nan;0;0
1956;1051;44;0;0;0;0;.00nan;0;0
1956;3281;44;51;28;3;25;.893;3512000;0
1956;6572;62;0;0;0;0;.00nan;0;0
1956;26919;62;91;40;1;39;.975;3600000;0
1957;2016;61;0;0;0;0;.00nan;0;0
1957;14351;40;54;26;3;23;.885;3584000;0
1957;26840;40;0;0;0;0;.00nan;0;0
1957;30971;61;73;25;2;23;.920;3600000;0
1958;1486;43;76;26;2;24;.923;3600000;0
1958;3625;43;0;0;0;0;.00nan;0;0
1958;4338;65;53;33;5;28;.848;3600000;0
1958;4987;65;0;0;0;0;.00nan;0;0
1959;2163;39;0;0;0;0;.00nan;0;0
1959;9238;39;63;29;3;26;.897;3900000;0
1959;26967;63;87;39;3;36;.923;3900000;0
1959;34814;63;0;0;0;0;.00nan;0;0
1960;2796;59;0;0;0;0;.00nan;0;0
1960;3847;38;72;33;3;30;.909;3600000;0
1960;31021;38;0;0;0;0;.00nan;0;0
1960;34819;59;100;40;1;39;.975;3600000;0
1961;2900;36;19;34;8;26;.765;3600000;0
1961;14874;36;0;0;0;0;.00nan;0;0
1961;19640;41;0;0;0;0;.00nan;0;0
1961;23075;41;43;29;5;24;.828;3600000;0
1962;5137;58;40;32;5;27;.844;3600000;0
1962;5298;55;0;0;0;0;.00nan;0;0
1962;14321;58;0;0;0;0;.00nan;0;0
1962;34770;55;99;35;1;34;.971;3600000;0
1963;6081;56;82;33;2;31;.939;3600000;0
1963;23493;51;60;36;4;32;.889;3565000;0
1963;26824;56;0;0;0;0;.00nan;0;0
1963;31408;51;0;0;0;0;.00nan;0;0
1964;2198;45;0;0;0;0;.00nan;0;0
1964;5883;37;0;0;0;0;.00nan;0;0
1964;23043;37;100;38;0;38;1.000;3600000;0
1964;36703;45;39;25;5;20;.800;3600000;0
1965;4447;54;92;32;1;31;.969;3600000;0
1965;5146;64;0;0;0;0;.00nan;0;0
1965;14323;64;85;54;5;49;.907;3600000;0
1965;31643;54;0;0;0;0;.00nan;0;0
1966;323;46;0;0;0;0;.00nan;0;0
1966;2152;49;67;34;3;31;.912;3600000;0
1966;4435;49;0;0;0;0;.00nan;0;0
1966;35622;46;52;27;4;23;.852;3543000;0
1967;3;50;43;30;6;24;.800;3804000;0
1967;1098;42;41;30;5;25;.833;3804000;0
1967;9439;50;0;0;0;0;.00nan;0;0
1967;37416;42;0;0;0;0;.00nan;0;0
1968;780;52;68;30;3;27;.900;3600000;0
1968;3533;57;7;27;7;20;.741;2598000;0
1968;26865;57;66;10;0;10;1.000;1002000;0
1968;32146;52;0;0;0;0;.00nan;0;0
1969;4716;4619;51;28;4;24;.857;3563000;0
1969;7049;47;0;0;0;0;.00nan;0;0
1969;10698;4619;0;0;0;0;.00nan;0;0
1969;33654;47;96;39;2;37;.949;3600000;0
1970;1051;44;0;0;0;0;.00nan;0;0
1970;3281;44;56;21;3;18;.857;3900000;0
1970;6572;62;81;42;3;39;.929;3900000;0
1970;26919;62;0;0;0;0;.00nan;0;0
1971;3;50;51;37;5;32;.865;3548000;0
1971;5048;50;0;0;0;0;.00nan;0;0
1971;5571;46;0;0;0;0;.00nan;0;0
1971;35622;46;68;30;4;26;.867;3600000;0
1972;5137;58;0;0;0;0;.00nan;0;0
1972;14321;58;71;38;4;34;.895;3600000;0
1972;28772;53;59;17;1;16;.941;3600000;0
1972;31156;53;0;0;0;0;.00nan;0;0
1973;780;52;0;0;0;0;.00nan;0;0
1973;19640;41;68;29;3;26;.897;3580000;0
1973;23075;41;0;0;0;0;.00nan;0;0
1973;32146;52;77;27;2;25;.926;3600000;0
1974;1486;43;41;34;5;29;.853;3570000;0
1974;3625;43;0;0;0;0;.00nan;0;0
1974;5298;55;69;31;3;28;.903;3600000;0
1974;34770;55;0;0;0;0;.00nan;0;0
1975;2900;36;0;0;0;0;.00nan;0;0
1975;14874;36;74;40;4;36;.900;3577000;0
1975;23493;51;0;0;0;0;.00nan;0;0
1975;31408;51;65;30;3;27;.900;3600000;0
1976;2163;39;76;43;4;39;.907;3600000;0
1976;3847;38;0;0;0;0;.00nan;0;0
1976;9238;39;0;0;0;0;.00nan;0;0
1976;31021;38;99;36;1;35;.972;3600000;0
1977;3533;57;0;0;0;0;.00nan;0;0
1977;4338;65;0;0;0;0;.00nan;0;0
1977;4987;65;95;31;1;30;.968;3600000;0
1977;26865;57;68;34;3;31;.912;3549000;0
1978;2796;59;0;0;0;0;.00nan;0;0
1978;6081;56;88;38;3;35;.921;3600000;0
1978;26824;56;0;0;0;0;.00nan;0;0
1978;34819;59;41;19;4;15;.789;3600000;0
1979;1098;42;0;0;0;0;.00nan;0;0
1979;5146;64;75;34;2;32;.941;3600000;0
1979;14323;64;0;0;0;0;.00nan;0;0
1979;37416;42;57;22;3;19;.864;3559000;0
1980;2198;45;0;0;0;0;.00nan;0;0
1980;4447;54;0;0;0;0;.00nan;0;0
1980;31643;54;62;29;3;26;.897;3658000;0
1980;36703;45;77;28;2;26;.929;3658000;0
1981;3;50;0;0;0;0;.00nan;0;0
1981;5048;50;62;15;1;14;.933;3600000;0
1981;5571;46;0;0;0;0;.00nan;0;0
1981;35622;46;73;27;2;25;.926;3582000;0
1982;1051;44;0;0;0;0;.00nan;0;0
1982;3281;44;68;28;2;26;.929;3563000;0
1982;4716;4619;0;0;0;0;.00nan;0;0
1982;10698;4619;79;20;1;19;.950;3600000;0
1983;3626;48;0;0;0;0;.00nan;0;0
1983;7049;47;86;21;0;21;1.000;3600000;0
1983;33654;47;0;0;0;0;.00nan;0;0
1983;38547;48;76;34;2;32;.941;3560000;0
1984;6572;62;0;0;0;0;.00nan;0;0
1984;20717;60;0;0;0;0;.00nan;0;0
1984;26919;62;69;30;2;28;.933;3600000;0
1984;35536;60;80;27;1;26;.963;3600000;0
1985;2152;49;0;0;0;0;.00nan;0;0
1985;4435;49;84;36;2;34;.944;3600000;0
1985;14351;40;0;0;0;0;.00nan;0;0
1985;26840;40;38;38;7;31;.816;3600000;0
1986;2016;61;0;0;0;0;.00nan;0;0
1986;5883;37;0;0;0;0;.00nan;0;0
1986;23043;37;76;35;3;32;.914;3544000;0
1986;30971;61;73;27;2;25;.926;3600000;0
1987;2900;36;0;0;0;0;.00nan;0;0
1987;14874;36;57;26;3;23;.885;3600000;0
1987;23493;51;51;35;5;30;.857;3559000;0
1987;31408;51;0;0;0;0;.00nan;0;0
1988;780;52;62;42;6;36;.857;3600000;0
1988;2841;41;0;0;0;0;.00nan;0;0
1988;19640;41;65;28;3;25;.893;3600000;0
1988;32146;52;0;0;0;0;.00nan;0;0
1989;2163;39;0;0;0;0;.00nan;0;0
1989;9238;39;98;25;0;25;1.000;3600000;0
1989;28772;53;0;0;0;0;.00nan;0;0
1989;31156;53;73;39;4;35;.897;3600000;0
1990;4338;65;65;18;1;17;.944;3600000;0
1990;4987;65;0;0;0;0;.00nan;0;0
1990;6081;56;0;0;0;0;.00nan;0;0
1990;26824;56;75;38;4;34;.895;3600000;0
1991;1486;43;52;43;6;37;.860;3600000;0
1991;3625;43;0;0;0;0;.00nan;0;0
1991;5298;55;0;0;0;0;.00nan;0;0
1991;34770;55;45;15;3;12;.800;3600000;0
1992;2796;59;0;0;0;0;.00nan;0;0
1992;3533;57;52;26;4;22;.846;3573000;0
1992;26865;57;0;0;0;0;.00nan;0;0
1992;34819;59;90;29;2;27;.931;3600000;0
1993;3847;38;56;16;2;14;.875;3600000;0
1993;5137;58;0;0;0;0;.00nan;0;0
1993;14321;58;76;38;3;35;.921;3600000;0
1993;31021;38;0;0;0;0;.00nan;0;0
1994;1098;42;80;30;1;29;.967;3600000;0
1994;5146;64;0;0;0;0;.00nan;0;0
1994;14323;64;50;30;4;26;.867;3600000;0
1994;37416;42;0;0;0;0;.00nan;0;0
1995;2198;45;50;26;4;22;.846;3600000;0
1995;4447;54;57;30;5;25;.833;3570000;0
1995;31643;54;0;0;0;0;.00nan;0;0
1995;36703;45;0;0;0;0;.00nan;0;0
1996;2152;49;0;0;0;0;.00nan;0;0
1996;4435;49;72;20;1;19;.950;3560000;0
1996;14351;40;100;37;0;37;1.000;3600000;0
1996;26840;40;0;0;0;0;.00nan;0;0
1997;1051;44;0;0;0;0;.00nan;0;0
1997;3281;44;48;32;4;28;.875;3534000;0
1997;4716;4619;76;30;2;28;.933;3600000;0
1997;10698;4619;0;0;0;0;.00nan;0;0
1998;3626;48;58;26;4;22;.846;3600000;0
1998;7049;47;97;34;1;33;.971;3600000;0
1998;33654;47;0;0;0;0;.00nan;0;0
1998;38547;48;0;0;0;0;.00nan;0;0
1999;2016;61;95;34;1;33;.971;3600000;0
1999;5883;37;100;27;0;27;1.000;3600000;0
1999;23043;37;0;0;0;0;.00nan;0;0
1999;30971;61;0;0;0;0;.00nan;0;0
2000;4447;54;47;28;5;23;.821;3600000;0
2000;14323;64;0;0;0;0;.00nan;0;0
2000;31643;54;0;0;0;0;.00nan;0;0
2000;38651;64;88;35;2;33;.943;3600000;0
2001;780;52;0;0;0;0;.00nan;0;0
2001;2163;39;0;0;0;0;.00nan;0;0
2001;9238;39;65;18;1;17;.944;3600000;0
2001;32146;52;63;30;3;27;.900;3553000;0
2002;2796;59;0;0;0;0;.00nan;0;0
2002;2841;41;0;0;0;0;.00nan;0;0
2002;19640;41;83;28;1;27;.964;3600000;0
2002;34819;59;67;30;3;27;.900;3542000;0
2003;2198;45;0;0;0;0;.00nan;0;0
2003;5571;46;50;1;0;1;1.000;350000;0
2003;35622;46;25;19;5;14;.737;3182000;0
2003;36703;45;53;31;4;27;.871;3600000;0
2004;3626;48;81;34;3;31;.912;3600000;0
2004;4716;4619;0;0;0;0;.00nan;0;0
2004;10698;4619;48;33;5;28;.848;3572000;0
2004;38547;48;0;0;0;0;.00nan;0;0
2005;5298;55;48;22;3;19;.864;3537000;0
2005;26967;63;88;32;1;31;.969;3600000;0
2005;34770;55;0;0;0;0;.00nan;0;0
2005;34814;63;0;0;0;0;.00nan;0;0
2006;2796;59;0;0;0;0;.00nan;0;0
2006;2841;41;53;22;3;19;.864;3549000;0
2006;19640;41;0;0;0;0;.00nan;0;0
2006;34819;59;80;37;2;35;.946;3600000;0
2007;6081;56;75;19;1;18;.947;3600000;0
2007;23493;51;0;0;0;0;.00nan;0;0
2007;26824;56;0;0;0;0;.00nan;0;0
2007;31408;51;47;36;5;31;.861;3600000;0
2008;3533;57;0;0;0;0;.00nan;0;0
2008;5137;58;0;0;0;0;.00nan;0;0
2008;14321;58;72;34;3;31;.912;3546000;0
2008;26865;57;79;24;1;23;.958;3600000;0
2009;1098;42;0;0;0;0;.00nan;0;0
2009;4447;54;0;0;0;0;.00nan;0;0
2009;31643;54;32;27;6;21;.778;3600000;0
2009;37416;42;71;18;1;17;.944;3600000;0
2010;2198;45;60;24;2;22;.917;3600000;0
2010;5571;46;0;0;0;0;.00nan;0;0
2010;35622;46;45;31;6;25;.806;3600000;0
2010;36703;45;0;0;0;0;.00nan;0;0
2011;3626;48;0;0;0;0;.00nan;0;0
2011;4716;4619;69;26;3;23;.885;3592000;0
2011;10698;4619;0;0;0;0;.00nan;0;0
2011;38547;48;83;32;2;30;.938;3600000;0
2012;351;61;0;0;0;0;.00nan;0;0
2012;2016;61;70;36;3;33;.917;3600000;0
2012;7049;47;84;15;0;15;1.000;3600000;0
2012;33654;47;0;0;0;0;.00nan;0;0
2013;6572;62;0;0;0;0;.00nan;0;0
2013;20717;60;0;0;0;0;.00nan;0;0
2013;26919;62;100;45;1;44;.978;3600000;0
2013;35536;60;55;24;3;21;.875;3546000;0
2014;2900;36;0;0;0;0;.00nan;0;0
2014;14874;36;31;26;5;21;.808;3600000;0
2014;23493;51;0;0;0;0;.00nan;0;0
2014;31408;51;93;40;2;38;.950;3600000;0
2015;2163;39;0;0;0;0;.00nan;0;0
2015;5298;55;0;0;0;0;.00nan;0;0
2015;9238;39;55;18;2;16;.889;3569000;0
2015;34770;55;100;38;1;37;.974;3600000;0
2016;6081;56;56;15;1;14;.933;1422000;0
2016;26824;56;41;35;6;29;.829;2399000;0
2016;26967;63;25;30;6;24;.800;3130000;0
2016;34814;63;42;6;2;4;.667;691000;0
2017;4338;65;0;0;0;0;.00nan;0;0
2017;4987;65;100;30;0;30;1.000;3900000;0
2017;31021;38;97;31;0;31;1.000;3900000;0
2017;35508;38;0;0;0;0;.00nan;0;0
2018;1592;63;0;0;0;0;.00nan;0;0
2018;6081;56;79;21;1;20;.952;3900000;0
2018;26824;56;0;0;0;0;.00nan;0;0
2018;34814;63;97;34;1;33;.971;3900000;0
2019;1486;43;93;37;2;35;.946;3900000;0
2019;2841;41;0;0;0;0;.00nan;0;0
2019;3625;43;0;0;0;0;.00nan;0;0
2019;23075;41;94;34;2;32;.941;3900000;0
2020;2796;59;0;0;0;0;.00nan;0;0
2020;5137;58;0;0;0;0;.00nan;0;0
2020;14321;58;65;23;2;21;.913;3544000;0
2020;34819;59;100;36;1;35;.972;3600000;0
2021;904;53;0;0;0;0;.00nan;0;0
2021;28772;53;72;17;1;16;.941;3600000;0
2021;31021;38;90;43;3;40;.930;3582000;0
2021;35508;38;0;0;0;0;.00nan;0;0
2022;780;52;0;0;0;0;.00nan;0;0
2022;4338;65;0;0;0;0;.00nan;0;0
2022;4987;65;70;30;3;27;.900;3600000;0
2022;32146;52;100;33;0;33;1.000;3600000;0
2023;2163;39;0;0;0;0;.00nan;0;0
2023;2900;36;100;35;0;35;1.000;3600000;0
2023;9238;39;44;29;4;25;.862;3600000;0
2023;14874;36;0;0;0;0;.00nan;0;0
2024;1098;42;0;0;0;0;.00nan;0;0
2024;5571;46;0;0;0;0;.00nan;0;0
2024;35622;46;75;26;2;24;.923;3600000;0
2024;37416;42;66;45;4;41;.911;3513000;0
2025;3533;57;0;0;0;0;.00nan;0;0
2025;5298;55;67;30;3;27;.900;3600000;0
2025;26865;57;100;24;0;24;1.000;3600000;0
2025;34770;55;0;0;0;0;.00nan;0;0
2026;3;50;63;23;2;21;.913;3900000;0
2026;9439;50;0;0;0;0;.00nan;0;0
2026;14323;64;90;34;2;32;.941;3900000;0
2026;38651;64;0;0;0;0;.00nan;0;0
2027;2198;45;0;0;0;0;.00nan;0;0
2027;20717;60;0;0;0;0;.00nan;0;0
2027;35536;60;100;30;0;30;1.000;3600000;0
2027;36703;45;85;44;3;41;.932;3600000;0
2028;1051;44;37;20;4;16;.800;3900000;0
2028;3281;44;0;0;0;0;.00nan;0;0
2028;3626;48;0;0;0;0;.00nan;0;0
2028;38547;48;65;37;4;33;.892;3900000;0
2029;2016;61;0;0;0;0;.00nan;0;0
2029;4716;4619;61;21;2;19;.905;3600000;0
2029;10698;4619;0;0;0;0;.00nan;0;0
2029;30971;61;59;38;4;34;.895;3526000;0
2030;7049;47;84;34;2;32;.941;3577000;0
2030;14351;40;90;21;0;21;1.000;3600000;0
2030;25787;47;0;0;0;0;.00nan;0;0
2030;28712;40;0;0;0;0;.00nan;0;0
2031;2152;49;29;26;6;20;.769;2726000;0
2031;6572;62;0;0;0;0;.00nan;0;0
2031;26919;62;52;34;5;29;.853;3600000;0
2031;38817;49;51;2;0;2;1.000;848000;0
2032;1486;43;43;28;5;23;.821;3600000;0
2032;2841;41;77;39;3;36;.923;3600000;0
2032;3625;43;0;0;0;0;.00nan;0;0
2032;23075;41;0;0;0;0;.00nan;0;0
2033;780;52;0;0;0;0;.00nan;0;0
2033;904;53;66;28;2;26;.929;3600000;0
2033;28772;53;0;0;0;0;.00nan;0;0
2033;32146;52;49;22;3;19;.864;3570000;0
2034;4447;54;0;0;0;0;.00nan;0;0
2034;5883;37;90;34;1;33;.971;3600000;0
2034;23043;37;0;0;0;0;.00nan;0;0
2034;31643;54;72;27;2;25;.926;3587000;0
2035;4338;65;99;48;1;47;.979;3600000;0
2035;4987;65;0;0;0;0;.00nan;0;0
2035;31021;38;0;0;0;0;.00nan;0;0
2035;35508;38;54;23;3;20;.870;3539000;0
2036;3533;57;0;0;0;0;.00nan;0;0
2036;5137;58;0;0;0;0;.00nan;0;0
2036;14321;58;96;33;1;32;.970;3600000;0
2036;26865;57;56;26;3;23;.885;3513000;0
2037;2163;39;0;0;0;0;.00nan;0;0
2037;9238;39;46;28;4;24;.857;3555000;0
2037;23493;51;0;0;0;0;.00nan;0;0
2037;31408;51;78;28;2;26;.929;3600000;0
2038;3;50;0;0;0;0;.00nan;0;0
2038;5146;64;91;37;2;35;.946;3807000;0
2038;9439;50;60;24;3;21;.875;3807000;0
2038;14323;64;0;0;0;0;.00nan;0;0
2039;323;46;75;23;1;22;.957;3600000;0
2039;1098;42;56;27;3;24;.889;3528000;0
2039;35622;46;0;0;0;0;.00nan;0;0
2039;37416;42;0;0;0;0;.00nan;0;0
2040;2016;61;0;0;0;0;.00nan;0;0
2040;4716;4619;0;0;0;0;.00nan;0;0
2040;10698;4619;71;35;3;32;.914;3643000;0
2040;30971;61;63;22;2;20;.909;3643000;0
2041;2198;45;48;21;3;18;.857;3600000;0
2041;20717;60;0;0;0;0;.00nan;0;0
2041;35536;60;54;33;4;29;.879;3600000;0
2041;36703;45;0;0;0;0;.00nan;0;0
2042;2152;49;0;0;0;0;.00nan;0;0
2042;6572;62;0;0;0;0;.00nan;0;0
2042;26919;62;79;40;4;36;.900;3900000;0
2042;38817;49;82;44;4;40;.909;3900000;0
2043;7049;47;67;37;5;32;.865;3600000;0
2043;14351;40;84;36;2;34;.944;3600000;0
2043;25787;47;0;0;0;0;.00nan;0;0
2043;28712;40;0;0;0;0;.00nan;0;0
2044;1592;63;59;30;4;26;.867;3900000;0
2044;23493;51;73;40;4;36;.900;3900000;0
2044;31408;51;0;0;0;0;.00nan;0;0
2044;34814;63;0;0;0;0;.00nan;0;0
2045;2900;36;33;29;6;23;.793;2268000;0
2045;6081;56;0;0;0;0;.00nan;0;0
2045;14874;36;58;10;1;9;.900;1332000;0
2045;26824;56;69;34;3;31;.912;3600000;0
2046;4447;54;78;24;2;22;.917;3900000;0
2046;5883;37;0;0;0;0;.00nan;0;0
2046;23043;37;97;43;2;41;.953;3900000;0
2046;31643;54;0;0;0;0;.00nan;0;0
2047;1051;44;0;0;0;0;.00nan;0;0
2047;3281;44;56;18;2;16;.889;3900000;0
2047;3626;48;0;0;0;0;.00nan;0;0
2047;38547;48;97;55;2;53;.964;3900000;0
2048;2198;45;0;0;0;0;.00nan;0;0
2048;9439;50;0;0;0;0;.00nan;0;0
2048;36703;45;100;28;0;28;1.000;3600000;0
2048;40293;50;70;31;3;28;.903;3600000;0
2049;23493;51;0;0;0;0;.00nan;0;0
2049;26967;63;54;26;3;23;.885;3531000;0
2049;31408;51;61;17;1;16;.941;3600000;0
2049;34814;63;0;0;0;0;.00nan;0;0
2050;262;43;0;0;0;0;.00nan;0;0
2050;323;46;86;42;3;39;.929;3600000;0
2050;3625;43;99;34;1;33;.971;3600000;0
2050;35622;46;0;0;0;0;.00nan;0;0
2051;2796;59;60;36;4;32;.889;3568000;0
2051;3533;57;0;0;0;0;.00nan;0;0
2051;26865;57;73;34;3;31;.912;3600000;0
2051;31858;59;0;0;0;0;.00nan;0;0
2052;780;52;0;0;0;0;.00nan;0;0
2052;5137;58;0;0;0;0;.00nan;0;0
2052;14321;58;100;34;0;34;1.000;3600000;0
2052;32146;52;34;31;5;26;.839;3600000;0
2053;4447;54;0;0;0;0;.00nan;0;0
2053;5883;37;29;8;3;5;.625;289000;0
2053;23043;37;65;21;2;19;.905;3311000;0
2053;31643;54;76;25;2;23;.920;3600000;0
2054;7049;47;92;37;1;36;.973;3600000;0
2054;20717;60;0;0;0;0;.00nan;0;0
2054;25787;47;0;0;0;0;.00nan;0;0
2054;35536;60;36;29;5;24;.828;3600000;0
2055;2152;49;0;0;0;0;.00nan;0;0
2055;3626;48;0;0;0;0;.00nan;0;0
2055;4435;49;59;12;1;11;.917;3600000;0
2055;38547;48;98;50;2;48;.960;3600000;0
2056;3;50;100;37;0;37;1.000;3600000;0
2056;2198;45;0;0;0;0;.00nan;0;0
2056;9439;50;0;0;0;0;.00nan;0;0
2056;36703;45;61;30;4;26;.867;3600000;0
2057;907;39;0;0;0;0;.00nan;0;0
2057;6062;36;0;0;0;0;.00nan;0;0
2057;9238;39;75;26;2;24;.923;3600000;0
2057;14874;36;68;30;3;27;.900;3585000;0
2058;262;43;83;34;3;31;.912;3600000;0
2058;3533;57;0;0;0;0;.00nan;0;0
2058;3625;43;0;0;0;0;.00nan;0;0
2058;26865;57;100;47;1;46;.979;3600000;0
2059;4338;65;81;27;1;26;.963;3900000;0
2059;4987;65;0;0;0;0;.00nan;0;0
2059;5298;55;100;39;1;38;.974;3900000;0
2059;34770;55;0;0;0;0;.00nan;0;0
2060;6081;56;0;0;0;0;.00nan;0;0
2060;23493;51;0;0;0;0;.00nan;0;0
2060;26824;56;95;24;0;24;1.000;3600000;0
2060;31408;51;62;32;4;28;.875;3600000;0
2061;323;46;83;23;1;22;.957;3557000;0
2061;7049;47;100;42;0;42;1.000;3600000;0
2061;25787;47;0;0;0;0;.00nan;0;0
2061;35622;46;0;0;0;0;.00nan;0;0
2062;3847;38;0;0;0;0;.00nan;0;0
2062;19640;41;37;35;6;29;.829;3094000;0
2062;23075;41;56;5;0;5;1.000;506000;0
2062;31021;38;62;25;3;22;.880;3600000;0
2063;5137;58;0;0;0;0;.00nan;0;0
2063;14321;58;73;35;3;32;.914;3600000;0
2063;28772;53;0;0;0;0;.00nan;0;0
2063;31156;53;79;28;1;27;.964;3600000;0
2064;3;50;58;26;3;23;.885;3538000;0
2064;1098;42;0;0;0;0;.00nan;0;0
2064;5048;50;0;0;0;0;.00nan;0;0
2064;37416;42;100;46;1;45;.978;3600000;0
2065;3626;48;0;0;0;0;.00nan;0;0
2065;6572;62;0;0;0;0;.00nan;0;0
2065;26919;62;90;29;2;27;.931;3600000;0
2065;38547;48;63;34;4;30;.882;3528000;0
2066;2016;61;0;0;0;0;.00nan;0;0
2066;14351;40;70;35;3;32;.914;3592000;0
2066;28712;40;0;0;0;0;.00nan;0;0
2066;30971;61;80;28;1;27;.964;3600000;0
2067;262;43;0;0;0;0;.00nan;0;0
2067;3533;57;73;24;1;23;.958;3600000;0
2067;3625;43;88;38;2;36;.947;3582000;0
2067;26865;57;0;0;0;0;.00nan;0;0
2068;6081;56;0;0;0;0;.00nan;0;0
2068;23493;51;83;23;1;22;.957;3600000;0
2068;26824;56;70;25;3;22;.880;3512000;0
2068;31408;51;0;0;0;0;.00nan;0;0
2069;5146;64;87;40;3;37;.925;3600000;0
2069;5883;37;61;22;2;20;.909;3600000;0
2069;14323;64;0;0;0;0;.00nan;0;0
2069;23043;37;0;0;0;0;.00nan;0;0
2070;907;39;0;0;0;0;.00nan;0;0
2070;9238;39;98;37;1;36;.973;3600000;0
2070;26967;63;0;0;0;0;.00nan;0;0
2070;34814;63;68;21;2;19;.905;3574000;0
2071;3847;38;83;27;2;25;.926;3900000;0
2071;28772;53;88;39;2;37;.949;3900000;0
2071;31021;38;0;0;0;0;.00nan;0;0
2071;31156;53;0;0;0;0;.00nan;0;0
2072;780;52;0;0;0;0;.00nan;0;0
2072;2796;59;0;0;0;0;.00nan;0;0
2072;32146;52;100;48;3;45;.938;3600000;0
2072;34639;59;51;27;4;23;.852;3595000;0
2073;5298;55;0;0;0;0;.00nan;0;0
2073;6062;36;80;23;1;22;.957;3600000;0
2073;14874;36;0;0;0;0;.00nan;0;0
2073;34770;55;68;37;4;33;.892;3600000;0
2074;2553;4619;89;41;3;38;.927;3600000;0
2074;4447;54;0;0;0;0;.00nan;0;0
2074;4716;4619;0;0;0;0;.00nan;0;0
2074;31643;54;68;26;2;24;.923;3600000;0
2075;323;46;67;27;3;24;.889;3600000;0
2075;7049;47;58;34;4;30;.882;3584000;0
2075;25787;47;0;0;0;0;.00nan;0;0
2075;35622;46;0;0;0;0;.00nan;0;0
2076;1098;42;92;35;1;34;.971;3600000;0
2076;2198;45;0;0;0;0;.00nan;0;0
2076;36703;45;56;33;4;29;.879;3600000;0
2076;37416;42;0;0;0;0;.00nan;0;0
2077;5137;58;77;32;2;30;.938;3600000;0
2077;14321;58;0;0;0;0;.00nan;0;0
2077;19640;41;0;0;0;0;.00nan;0;0
2077;23075;41;44;19;3;16;.842;3600000;0
2078;1051;44;67;32;3;29;.906;3666000;0
2078;2152;49;0;0;0;0;.00nan;0;0
2078;3281;44;0;0;0;0;.00nan;0;0
2078;4435;49;86;34;2;32;.941;3666000;0
2079;3626;48;91;35;2;33;.943;3600000;0
2079;6572;62;61;32;4;28;.875;3585000;0
2079;26919;62;0;0;0;0;.00nan;0;0
2079;38547;48;0;0;0;0;.00nan;0;0
2080;780;52;51;24;3;21;.875;3567000;0
2080;19640;41;84;34;2;32;.941;3600000;0
2080;23075;41;0;0;0;0;.00nan;0;0
2080;32146;52;0;0;0;0;.00nan;0;0
2081;5146;64;86;40;3;37;.925;3600000;0
2081;5883;37;0;0;0;0;.00nan;0;0
2081;14323;64;0;0;0;0;.00nan;0;0
2081;23043;37;63;21;2;19;.905;3600000;0
2082;3847;38;0;0;0;0;.00nan;0;0
2082;28772;53;0;0;0;0;.00nan;0;0
2082;31021;38;84;31;2;29;.935;3600000;0
2082;31156;53;60;22;3;19;.864;3589000;0
2083;2796;59;88;27;1;26;.963;3867000;0
2083;6062;36;0;0;0;0;.00nan;0;0
2083;14874;36;92;46;2;44;.957;3867000;0
2083;34639;59;0;0;0;0;.00nan;0;0
2084;907;39;0;0;0;0;.00nan;0;0
2084;9238;39;61;48;6;42;.875;3600000;0
2084;26967;63;62;24;2;22;.917;3600000;0
2084;34814;63;0;0;0;0;.00nan;0;0
2085;2553;4619;0;0;0;0;.00nan;0;0
2085;4447;54;83;31;1;30;.968;3600000;0
2085;4716;4619;62;22;2;20;.909;3574000;0
2085;31643;54;0;0;0;0;.00nan;0;0
2086;4338;65;0;0;0;0;.00nan;0;0
2086;4987;65;84;34;3;31;.912;3759000;0
2086;5298;55;72;27;2;25;.926;3759000;0
2086;34770;55;0;0;0;0;.00nan;0;0
2087;1098;42;0;0;0;0;.00nan;0;0
2087;2198;45;58;22;2;20;.909;3600000;0
2087;36703;45;0;0;0;0;.00nan;0;0
2087;37416;42;77;36;3;33;.917;3567000;0
2088;1051;44;0;0;0;0;.00nan;0;0
2088;2152;49;79;34;2;32;.941;3600000;0
2088;3281;44;60;25;3;22;.880;3555000;0
2088;4435;49;0;0;0;0;.00nan;0;0
2089;2016;61;0;0;0;0;.00nan;0;0
2089;14351;40;79;33;2;31;.939;3549000;0
2089;28712;40;0;0;0;0;.00nan;0;0
2089;30971;61;100;37;1;36;.973;3600000;0
2090;1486;43;71;27;3;24;.889;3900000;0
2090;3625;43;0;0;0;0;.00nan;0;0
2090;23493;51;0;0;0;0;.00nan;0;0
2090;31408;51;73;30;3;27;.900;3900000;0
2091;4338;65;0;0;0;0;.00nan;0;0
2091;4987;65;54;28;4;24;.857;3587000;0
2091;19640;41;62;28;3;25;.893;3600000;0
2091;23075;41;0;0;0;0;.00nan;0;0
2092;2016;61;0;0;0;0;.00nan;0;0
2092;26967;63;99;41;2;39;.951;3600000;0
2092;30971;61;58;25;3;22;.880;3600000;0
2092;34814;63;0;0;0;0;.00nan;0;0
2093;3533;57;44;5;1;4;.800;732000;0
2093;3847;38;0;0;0;0;.00nan;0;0
2093;26865;57;50;40;6;34;.850;2868000;0
2093;31021;38;50;27;4;23;.852;3600000;0
2094;907;39;89;35;1;34;.971;3600000;0
2094;6062;36;0;0;0;0;.00nan;0;0
2094;9238;39;0;0;0;0;.00nan;0;0
2094;14874;36;42;34;6;28;.824;3600000;0
2095;1486;43;0;0;0;0;.00nan;0;0
2095;3625;43;68;28;3;25;.893;3596000;0
2095;23493;51;0;0;0;0;.00nan;0;0
2095;31408;51;83;34;2;32;.941;3600000;0
2096;2198;45;0;0;0;0;.00nan;0;0
2096;5146;64;0;0;0;0;.00nan;0;0
2096;14323;64;77;36;2;34;.944;3600000;0
2096;36703;45;70;35;3;32;.914;3600000;0
2097;2553;4619;95;34;1;33;.971;3600000;0
2097;4716;4619;0;0;0;0;.00nan;0;0
2097;6572;62;0;0;0;0;.00nan;0;0
2097;26919;62;64;36;6;30;.833;3600000;0
2098;1051;44;74;27;1;26;.963;3600000;0
2098;2152;49;0;0;0;0;.00nan;0;0
2098;3281;44;0;0;0;0;.00nan;0;0
2098;4435;49;77;29;2;27;.931;3545000;0
2099;1098;42;61;31;3;28;.903;3900000;0
2099;5883;37;69;32;3;29;.906;3900000;0
2099;23043;37;0;0;0;0;.00nan;0;0
2099;37416;42;0;0;0;0;.00nan;0;0
2100;780;52;0;0;0;0;.00nan;0;0
2100;2796;59;64;24;2;22;.917;3600000;0
2100;32146;52;88;36;1;35;.972;3600000;0
2100;34639;59;0;0;0;0;.00nan;0;0
2101;5298;55;0;0;0;0;.00nan;0;0
2101;6062;36;0;0;0;0;.00nan;0;0
2101;14874;36;62;34;4;30;.882;3545000;0
2101;34770;55;74;26;2;24;.923;3600000;0
2102;907;39;63;29;4;25;.862;3523000;0
2102;6081;56;79;30;2;28;.933;3600000;0
2102;9238;39;0;0;0;0;.00nan;0;0
2102;26824;56;0;0;0;0;.00nan;0;0
2103;2016;61;0;0;0;0;.00nan;0;0
2103;23493;51;0;0;0;0;.00nan;0;0
2103;30971;61;92;20;0;20;1.000;3600000;0
2103;31408;51;88;42;3;39;.929;3600000;0
2104;3;50;67;25;3;22;.880;3600000;0
2104;323;46;51;26;4;22;.846;3542000;0
2104;5048;50;0;0;0;0;.00nan;0;0
2104;35622;46;0;0;0;0;.00nan;0;0
2105;3533;57;0;0;0;0;.00nan;0;0
2105;19640;41;83;27;1;26;.963;3600000;0
2105;23075;41;0;0;0;0;.00nan;0;0
2105;26865;57;68;34;3;31;.912;3582000;0
2106;4338;65;77;35;4;31;.886;3900000;0
2106;4987;65;0;0;0;0;.00nan;0;0
2106;5137;58;0;0;0;0;.00nan;0;0
2106;14321;58;68;32;4;28;.875;3900000;0
2107;2198;45;0;0;0;0;.00nan;0;0
2107;4447;54;0;0;0;0;.00nan;0;0
2107;31643;54;63;14;1;13;.929;3600000;0
2107;36703;45;69;49;6;43;.878;3600000;0
2108;2553;4619;56;25;3;22;.880;3600000;0
2108;4716;4619;0;0;0;0;.00nan;0;0
2108;6572;62;57;3;0;3;1.000;285000;0
2108;26919;62;41;34;6;28;.824;3315000;0
2109;2152;49;0;0;0;0;.00nan;0;0
2109;3626;48;0;0;0;0;.00nan;0;0
2109;4435;49;94;22;0;22;1.000;3600000;0
2109;38547;48;53;29;4;25;.862;3600000;0
2110;7049;47;77;34;3;31;.912;3900000;0
2110;14351;40;84;38;3;35;.921;3900000;0
2110;25787;47;0;0;0;0;.00nan;0;0
2110;28712;40;0;0;0;0;.00nan;0;0
2111;2016;61;0;0;0;0;.00nan;0;0
2111;23493;51;22;24;6;18;.750;3095000;0
2111;30971;61;73;46;5;41;.891;3600000;0
2111;31408;51;47;5;1;4;.800;453000;0
2112;1098;42;0;0;0;0;.00nan;0;0
2112;5883;37;89;29;1;28;.966;3600000;0
2112;23043;37;0;0;0;0;.00nan;0;0
2112;37416;42;58;40;5;35;.875;3600000;0
2113;780;52;99;34;1;33;.971;3600000;0
2113;2796;59;0;0;0;0;.00nan;0;0
2113;32146;52;0;0;0;0;.00nan;0;0
2113;34639;59;73;35;3;32;.914;3577000;0
2114;5298;55;58;22;2;20;.909;3530000;0
2114;6062;36;100;35;0;35;1.000;3600000;0
2114;14874;36;0;0;0;0;.00nan;0;0
2114;34770;55;0;0;0;0;.00nan;0;0
2115;1486;43;71;25;2;23;.920;3600000;0
2115;3625;43;0;0;0;0;.00nan;0;0
2115;26967;63;78;27;1;26;.963;3600000;0
2115;34814;63;0;0;0;0;.00nan;0;0
2116;907;39;0;0;0;0;.00nan;0;0
2116;6081;56;0;0;0;0;.00nan;0;0
2116;9238;39;63;26;3;23;.885;3539000;0
2116;26824;56;81;25;1;24;.960;3600000;0
2117;3;50;0;0;0;0;.00nan;0;0
2117;323;46;0;0;0;0;.00nan;0;0
2117;5048;50;41;22;4;18;.818;3900000;0
2117;35622;46;58;37;4;33;.892;3900000;0
2118;3533;57;0;0;0;0;.00nan;0;0
2118;19640;41;0;0;0;0;.00nan;0;0
2118;23075;41;97;20;0;20;1.000;3600000;0
2118;26865;57;81;34;2;32;.941;3518000;0
2119;3847;38;0;0;0;0;.00nan;0;0
2119;5137;58;0;0;0;0;.00nan;0;0
2119;14321;58;99;35;1;34;.971;3600000;0
2119;31021;38;51;27;4;23;.852;3600000;0
2120;4338;65;0;0;0;0;.00nan;0;0
2120;4987;65;69;28;2;26;.929;3600000;0
2120;28772;53;0;0;0;0;.00nan;0;0
2120;31156;53;54;21;3;18;.857;3555000;0
2121;2198;45;74;19;1;18;.947;3600000;0
2121;5146;64;0;0;0;0;.00nan;0;0
2121;14323;64;70;33;3;30;.909;3560000;0
2121;36703;45;0;0;0;0;.00nan;0;0
2122;2152;49;0;0;0;0;.00nan;0;0
2122;3626;48;53;38;5;33;.868;3600000;0
2122;4435;49;68;18;1;17;.944;3600000;0
2122;38547;48;0;0;0;0;.00nan;0;0
2123;14351;40;0;0;0;0;.00nan;0;0
2123;20717;60;0;0;0;0;.00nan;0;0
2123;28712;40;31;32;6;26;.813;3600000;0
2123;35536;60;78;15;0;15;1.000;3600000;0
2124;2553;4619;0;0;0;0;.00nan;0;0
2124;4716;4619;48;24;4;20;.833;3561000;0
2124;6572;62;0;0;0;0;.00nan;0;0
2124;26919;62;82;36;3;33;.917;3600000;0
2125;1051;44;96;50;1;49;.980;3900000;0
2125;3281;44;0;0;0;0;.00nan;0;0
2125;7049;47;0;0;0;0;.00nan;0;0
2125;25787;47;100;37;1;36;.973;3900000;0
2126;780;52;0;0;0;0;.00nan;0;0
2126;28772;53;71;15;1;14;.933;3600000;0
2126;31156;53;0;0;0;0;.00nan;0;0
2126;32146;52;86;43;3;40;.930;3579000;0
2127;2796;59;97;32;2;30;.938;3900000;0
2127;3847;38;0;0;0;0;.00nan;0;0
2127;31021;38;79;27;2;25;.926;3900000;0
2127;34639;59;0;0;0;0;.00nan;0;0
2128;3;50;59;37;5;32;.865;3520000;0
2128;5048;50;0;0;0;0;.00nan;0;0
2128;5146;64;80;39;3;36;.923;3600000;0
2128;14323;64;0;0;0;0;.00nan;0;0
2129;323;46;77;27;2;25;.926;3900000;0
2129;4447;54;56;19;2;17;.895;3900000;0
2129;31643;54;0;0;0;0;.00nan;0;0
2129;35622;46;0;0;0;0;.00nan;0;0
2130;1051;44;49;22;3;19;.864;3600000;0
2130;3281;44;0;0;0;0;.00nan;0;0
2130;20717;60;0;0;0;0;.00nan;0;0
2130;35536;60;80;33;3;30;.909;3568000;0
2131;2016;61;0;0;0;0;.00nan;0;0
2131;26967;63;97;42;1;41;.976;3900000;0
2131;30971;61;80;22;1;21;.955;3900000;0
2131;34814;63;0;0;0;0;.00nan;0;0
2132;3;50;69;31;2;29;.935;3558000;0
2132;4447;54;0;0;0;0;.00nan;0;0
2132;5048;50;0;0;0;0;.00nan;0;0
2132;31643;54;92;27;1;26;.963;3600000;0
2133;5298;55;0;0;0;0;.00nan;0;0
2133;6062;36;64;26;3;23;.885;3542000;0
2133;14874;36;0;0;0;0;.00nan;0;0
2133;34770;55;85;32;1;31;.969;3600000;0
2134;323;46;37;20;4;16;.800;3556000;0
2134;5146;64;93;41;3;38;.927;3600000;0
2134;14323;64;0;0;0;0;.00nan;0;0
2134;35622;46;0;0;0;0;.00nan;0;0
2135;3847;38;0;0;0;0;.00nan;0;0
2135;5137;58;73;14;0;14;1.000;1970000;0
2135;14321;58;16;20;6;14;.700;1630000;0
2135;31021;38;70;27;2;25;.926;3600000;0
2136;2796;59;0;0;0;0;.00nan;0;0
2136;4338;65;65;29;3;26;.897;3545000;0
2136;4987;65;0;0;0;0;.00nan;0;0
2136;34639;59;87;33;2;31;.939;3600000;0
2137;907;39;0;0;0;0;.00nan;0;0
2137;9238;39;42;20;4;16;.800;3600000;0
2137;23493;51;47;13;2;11;.846;1904000;0
2137;31408;51;52;21;4;17;.810;1658000;0
2138;6572;62;0;0;0;0;.00nan;0;0
2138;14351;40;98;18;0;18;1.000;3600000;0
2138;26919;62;67;44;5;39;.886;3600000;0
2138;28712;40;0;0;0;0;.00nan;0;0
2139;2152;49;56;33;5;28;.848;3899000;0
2139;4435;49;0;0;0;0;.00nan;0;0
2139;20717;60;0;0;0;0;.00nan;0;0
2139;35536;60;73;48;5;43;.896;3900000;0
2140;780;52;0;0;0;0;.00nan;0;0
2140;4338;65;0;0;0;0;.00nan;0;0
2140;4987;65;80;28;1;27;.964;3600000;0
2140;32146;52;54;29;4;25;.862;3600000;0
2141;5137;58;0;0;0;0;.00nan;0;0
2141;14321;58;89;39;3;36;.923;3600000;0
2141;19640;41;0;0;0;0;.00nan;0;0
2141;23075;41;82;14;0;14;1.000;3600000;0
2142;5298;55;0;0;0;0;.00nan;0;0
2142;26967;63;63;27;3;24;.889;3569000;0
2142;34770;55;92;30;1;29;.967;3600000;0
2142;34814;63;0;0;0;0;.00nan;0;0
2143;262;43;41;25;4;21;.840;1745000;0
2143;323;46;100;29;1;28;.966;3600000;0
2143;3625;43;58;23;3;20;.870;1855000;0
2143;35622;46;0;0;0;0;.00nan;0;0
2144;3533;57;0;0;0;0;.00nan;0;0
2144;23493;51;0;0;0;0;.00nan;0;0
2144;26865;57;56;39;5;34;.872;3546000;0
2144;31408;51;55;29;4;25;.862;3600000;0
2145;907;39;0;0;0;0;.00nan;0;0
2145;6062;36;0;0;0;0;.00nan;0;0
2145;9238;39;100;23;0;23;1.000;3600000;0
2145;14874;36;45;35;5;30;.857;3600000;0
2146;5883;37;80;41;3;38;.927;3596000;0
2146;6081;56;90;31;1;30;.968;3600000;0
2146;23043;37;0;0;0;0;.00nan;0;0
2146;26824;56;0;0;0;0;.00nan;0;0
2147;1098;42;45;37;6;31;.838;3117000;0
2147;4447;54;100;26;0;26;1.000;3600000;0
2147;31643;54;0;0;0;0;.00nan;0;0
2147;37416;42;50;1;0;1;1.000;483000;0
2148;1051;44;0;0;0;0;.00nan;0;0
2148;2198;45;42;26;5;21;.808;3600000;0
2148;3281;44;66;31;2;29;.935;3600000;0
2148;36703;45;0;0;0;0;.00nan;0;0
2149;6572;62;0;0;0;0;.00nan;0;0
2149;7049;47;88;40;3;37;.925;3600000;0
2149;25787;47;0;0;0;0;.00nan;0;0
2149;26919;62;74;21;1;20;.952;3600000;0
2150;14351;40;98;45;1;44;.978;3900000;0
2150;20717;60;0;0;0;0;.00nan;0;0
2150;28712;40;0;0;0;0;.00nan;0;0
2150;35536;60;80;31;1;30;.968;3900000;0
2151;2016;61;0;0;0;0;.00nan;0;0
2151;2553;4619;47;37;5;32;.865;3600000;0
2151;4716;4619;0;0;0;0;.00nan;0;0
2151;30971;61;65;23;2;21;.913;3600000;0
2152;5137;58;0;0;0;0;.00nan;0;0
2152;14321;58;26;21;5;16;.762;3900000;0
2152;19640;41;0;0;0;0;.00nan;0;0
2152;23075;41;31;18;5;13;.722;3900000;0
2153;2796;59;0;0;0;0;.00nan;0;0
2153;23493;51;45;46;7;39;.848;3600000;0
2153;31408;51;0;0;0;0;.00nan;0;0
2153;34639;59;91;27;1;26;.963;3600000;0
2154;6062;36;81;34;2;32;.941;3600000;0
2154;14874;36;0;0;0;0;.00nan;0;0
2154;26967;63;65;26;3;23;.885;3597000;0
2154;34814;63;0;0;0;0;.00nan;0;0
2155;907;39;51;33;4;29;.879;3549000;0
2155;5298;55;76;30;3;27;.900;3600000;0
2155;9238;39;0;0;0;0;.00nan;0;0
2155;34770;55;0;0;0;0;.00nan;0;0
2156;5883;37;0;0;0;0;.00nan;0;0
2156;6081;56;0;0;0;0;.00nan;0;0
2156;23043;37;79;22;1;21;.955;3600000;0
2156;26824;56;46;36;5;31;.861;3600000;0
2157;4447;54;83;28;1;27;.964;3600000;0
2157;5146;64;36;31;6;25;.806;2957000;0
2157;14323;64;39;1;1;0;.000;643000;0
2157;31643;54;0;0;0;0;.00nan;0;0
2158;3;50;19;16;5;11;.688;2204000;0
2158;3626;48;80;24;1;23;.958;2432000;0
2158;5048;50;50;9;1;8;.889;1396000;0
2158;38547;48;24;10;4;6;.600;1168000;0
2159;780;52;0;0;0;0;.00nan;0;0
2159;3847;38;0;0;0;0;.00nan;0;0
2159;31021;38;42;24;4;20;.833;3557000;0
2159;32146;52;87;38;2;36;.947;3600000;0
2160;3533;57;0;0;0;0;.00nan;0;0
2160;26865;57;100;28;0;28;1.000;3600000;0
2160;28772;53;77;38;3;35;.921;3600000;0
2160;31156;53;0;0;0;0;.00nan;0;0
2161;1051;44;68;22;2;20;.909;3600000;0
2161;2198;45;0;0;0;0;.00nan;0;0
2161;3281;44;0;0;0;0;.00nan;0;0
2161;36703;45;60;46;6;40;.870;3600000;0
2162;14351;40;0;0;0;0;.00nan;0;0
2162;20717;60;0;0;0;0;.00nan;0;0
2162;28712;40;99;46;3;43;.935;3900000;0
2162;35536;60;78;27;3;24;.889;3892000;0
2163;2152;49;0;0;0;0;.00nan;0;0
2163;4435;49;79;28;1;27;.964;3600000;0
2163;6572;62;0;0;0;0;.00nan;0;0
2163;26919;62;64;40;5;35;.875;3600000;0
2164;262;43;0;0;0;0;.00nan;0;0
2164;1098;42;0;0;0;0;.00nan;0;0
2164;3625;43;54;17;2;15;.882;3564000;0
2164;37416;42;78;28;1;27;.964;3600000;0
2165;780;52;66;25;3;22;.880;3539000;0
2165;3847;38;0;0;0;0;.00nan;0;0
2165;31021;38;80;22;1;21;.955;3600000;0
2165;32146;52;0;0;0;0;.00nan;0;0
2166;2796;59;79;33;3;30;.909;3600000;0
2166;28772;53;50;46;7;39;.848;3600000;0
2166;31156;53;0;0;0;0;.00nan;0;0
2166;34639;59;0;0;0;0;.00nan;0;0
2167;323;46;87;29;2;27;.931;3600000;0
2167;5146;64;0;0;0;0;.00nan;0;0
2167;14323;64;39;29;5;24;.828;3561000;0
2167;35622;46;0;0;0;0;.00nan;0;0
2168;3;50;0;0;0;0;.00nan;0;0
2168;3626;48;50;2;0;2;1.000;291000;0
2168;5048;50;49;22;3;19;.864;3600000;0
2168;38547;48;39;34;6;28;.824;3309000;0
2169;3533;57;0;0;0;0;.00nan;0;0
2169;4338;65;0;0;0;0;.00nan;0;0
2169;4987;65;87;35;2;33;.943;3595000;0
2169;26865;57;90;31;1;30;.968;3600000;0
2170;2016;61;0;0;0;0;.00nan;0;0
2170;2553;4619;68;40;4;36;.900;3552000;0
2170;4716;4619;0;0;0;0;.00nan;0;0
2170;30971;61;77;33;3;30;.909;3600000;0
2171;262;43;0;0;0;0;.00nan;0;0
2171;1098;42;0;0;0;0;.00nan;0;0
2171;3625;43;96;34;1;33;.971;3600000;0
2171;37416;42;59;41;5;36;.878;3600000;0
2172;2016;61;88;35;2;33;.943;3877000;0
2172;5883;37;99;45;1;44;.978;3877000;0
2172;23043;37;0;0;0;0;.00nan;0;0
2172;30971;61;0;0;0;0;.00nan;0;0
2173;780;52;0;0;0;0;.00nan;0;0
2173;5137;58;0;0;0;0;.00nan;0;0
2173;14321;58;72;25;2;23;.920;3600000;0
2173;32146;52;63;34;3;31;.912;3546000;0
2174;6062;36;56;25;3;22;.880;3583000;0
2174;14874;36;0;0;0;0;.00nan;0;0
2174;28772;53;91;32;2;30;.938;3600000;0
2174;31156;53;0;0;0;0;.00nan;0;0
2175;323;46;83;28;1;27;.964;3600000;0
2175;2198;45;0;0;0;0;.00nan;0;0
2175;35622;46;0;0;0;0;.00nan;0;0
2175;36703;45;62;36;4;32;.889;3600000;0
2176;4447;54;50;31;5;26;.839;3900000;0
2176;5146;64;50;27;4;23;.852;2377000;0
2176;14323;64;56;16;1;15;.938;1523000;0
2176;31643;54;0;0;0;0;.00nan;0;0
2177;7049;47;86;33;2;31;.939;3900000;0
2177;14351;40;91;38;2;36;.947;3900000;0
2177;25787;47;0;0;0;0;.00nan;0;0
2177;28712;40;0;0;0;0;.00nan;0;0
2178;1051;44;64;36;3;33;.917;3899000;0
2178;3281;44;0;0;0;0;.00nan;0;0
2178;20717;60;0;0;0;0;.00nan;0;0
2178;35536;60;80;30;3;27;.900;3900000;0
2179;3626;48;81;27;2;25;.926;3579000;0
2179;6572;62;0;0;0;0;.00nan;0;0
2179;26919;62;99;28;1;27;.964;3600000;0
2179;38547;48;0;0;0;0;.00nan;0;0
2180;2016;61;0;0;0;0;.00nan;0;0
2180;5883;37;100;30;0;30;1.000;3600000;0
2180;23043;37;0;0;0;0;.00nan;0;0
2180;30971;61;52;12;2;10;.833;3600000;0
2181;4338;65;0;0;0;0;.00nan;0;0
2181;4987;65;66;36;4;32;.889;3600000;0
2181;26967;63;40;32;6;26;.813;3539000;0
2181;34814;63;0;0;0;0;.00nan;0;0
2182;3847;38;0;0;0;0;.00nan;0;0
2182;19640;41;78;36;3;33;.917;3600000;0
2182;23075;41;0;0;0;0;.00nan;0;0
2182;31021;38;81;23;2;21;.913;3600000;0
2183;780;52;0;0;0;0;.00nan;0;0
2183;6062;36;26;28;6;22;.786;3304000;0
2183;14874;36;49;1;0;1;1.000;257000;0
2183;32146;52;63;41;5;36;.878;3600000;0
2184;4338;65;76;44;3;41;.932;3555000;0
2184;4987;65;0;0;0;0;.00nan;0;0
2184;6081;56;0;0;0;0;.00nan;0;0
2184;26824;56;59;20;2;18;.900;3600000;0
2185;23493;51;0;0;0;0;.00nan;0;0
2185;28772;53;0;0;0;0;.00nan;0;0
2185;31035;51;59;33;4;29;.879;3600000;0
2185;31156;53;81;22;1;21;.955;3600000;0
2186;323;46;81;26;1;25;.962;3600000;0
2186;2198;45;79;42;3;39;.929;3557000;0
2186;35622;46;0;0;0;0;.00nan;0;0
2186;36703;45;0;0;0;0;.00nan;0;0
2187;2796;59;0;0;0;0;.00nan;0;0
2187;5298;55;0;0;0;0;.00nan;0;0
2187;34639;59;91;36;2;34;.944;3600000;0
2187;34770;55;40;24;4;20;.833;3585000;0
2188;3533;57;0;0;0;0;.00nan;0;0
2188;5137;58;0;0;0;0;.00nan;0;0
2188;14321;58;97;32;1;31;.969;3600000;0
2188;26865;57;42;29;5;24;.828;3600000;0
2189;262;43;0;0;0;0;.00nan;0;0
2189;907;39;0;0;0;0;.00nan;0;0
2189;3625;43;96;58;2;56;.966;3900000;0
2189;9238;39;81;27;2;25;.926;3900000;0
2190;2553;4619;100;26;0;26;1.000;3600000;0
2190;4716;4619;0;0;0;0;.00nan;0;0
2190;14351;40;92;39;2;37;.949;3600000;0
2190;28712;40;0;0;0;0;.00nan;0;0
2191;2152;49;0;0;0;0;.00nan;0;0
2191;4435;49;63;27;3;24;.889;3600000;0
2191;7049;47;48;31;5;26;.839;3538000;0
2191;25787;47;0;0;0;0;.00nan;0;0
2192;3626;48;59;28;3;25;.893;3529000;0
2192;6572;62;0;0;0;0;.00nan;0;0
2192;26919;62;90;27;1;26;.963;3600000;0
2192;38547;48;0;0;0;0;.00nan;0;0
2193;1051;44;61;35;3;32;.914;3600000;0
2193;3281;44;0;0;0;0;.00nan;0;0
2193;20717;60;0;0;0;0;.00nan;0;0
2193;35536;60;78;20;1;19;.950;3600000;0
2194;4338;65;0;0;0;0;.00nan;0;0
2194;4987;65;62;33;4;29;.879;3900000;0
2194;23493;51;51;27;4;23;.852;3900000;0
2194;31035;51;0;0;0;0;.00nan;0;0
2195;5146;64;82;26;2;24;.923;3646000;0
2195;14323;64;0;0;0;0;.00nan;0;0
2195;26967;63;0;0;0;0;.00nan;0;0
2195;34814;63;74;32;3;29;.906;3646000;0
2196;3847;38;0;0;0;0;.00nan;0;0
2196;19640;41;0;0;0;0;.00nan;0;0
2196;23075;41;100;29;0;29;1.000;3600000;0
2196;31021;38;47;27;4;23;.852;3600000;0
2197;2796;59;83;37;3;34;.919;3600000;0
2197;6062;36;0;0;0;0;.00nan;0;0
2197;14874;36;44;21;4;17;.810;3544000;0
2197;34639;59;0;0;0;0;.00nan;0;0
2198;262;43;75;34;4;30;.882;3900000;0
2198;907;39;59;34;4;30;.882;3900000;0
2198;3625;43;0;0;0;0;.00nan;0;0
2198;9238;39;0;0;0;0;.00nan;0;0
2199;780;52;0;0;0;0;.00nan;0;0
2199;5298;55;63;29;3;26;.897;3600000;0
2199;32146;52;70;41;4;37;.902;3569000;0
2199;34770;55;0;0;0;0;.00nan;0;0
2200;6081;56;95;32;2;30;.938;3600000;0
2200;26824;56;0;0;0;0;.00nan;0;0
2200;28772;53;87;39;3;36;.923;3588000;0
2200;31156;53;0;0;0;0;.00nan;0;0
2201;2198;45;0;0;0;0;.00nan;0;0
2201;4447;54;76;30;2;28;.933;3707000;0
2201;31643;54;0;0;0;0;.00nan;0;0
2201;36703;45;78;38;3;35;.921;3707000;0
2202;323;46;0;0;0;0;.00nan;0;0
2202;1098;42;0;0;0;0;.00nan;0;0
2202;35622;46;51;30;4;26;.867;3600000;0
2202;37416;42;72;33;3;30;.909;3600000;0
2203;3;50;100;25;0;25;1.000;3600000;0
2203;5048;50;0;0;0;0;.00nan;0;0
2203;5883;37;22;10;4;6;.600;1153000;0
2203;23043;37;36;19;4;15;.789;2447000;0
2204;3533;57;80;37;3;34;.919;3600000;0
2204;5137;58;0;0;0;0;.00nan;0;0
2204;14321;58;100;26;0;26;1.000;3600000;0
2204;26865;57;0;0;0;0;.00nan;0;0
2205;2553;4619;51;29;4;25;.862;3782000;0
2205;4716;4619;0;0;0;0;.00nan;0;0
2205;14351;40;0;0;0;0;.00nan;0;0
2205;28712;40;85;38;3;35;.921;3782000;0
2206;2016;61;0;0;0;0;.00nan;0;0
2206;7049;47;0;0;0;0;.00nan;0;0
2206;25787;47;48;20;4;16;.800;3541000;0
2206;30971;61;82;32;2;30;.938;3600000;0
2207;1051;44;94;36;1;35;.972;3841000;0
2207;3281;44;0;0;0;0;.00nan;0;0
2207;20717;60;0;0;0;0;.00nan;0;0
2207;35536;60;100;21;0;21;1.000;3841000;0
2208;2267;48;0;0;0;0;.00nan;0;0
2208;6572;62;0;0;0;0;.00nan;0;0
2208;26919;62;66;20;2;18;.900;3600000;0
2208;38547;48;66;44;5;39;.886;3600000;0
2209;3847;38;0;0;0;0;.00nan;0;0
2209;19640;41;0;0;0;0;.00nan;0;0
2209;23075;41;62;37;5;32;.865;3600000;0
2209;31021;38;86;39;2;37;.949;3600000;0
2210;5146;64;0;0;0;0;.00nan;0;0
2210;14323;64;88;36;3;33;.917;3583000;0
2210;26967;63;92;37;1;36;.973;3600000;0
2210;34814;63;0;0;0;0;.00nan;0;0
2211;1098;42;98;51;2;49;.961;3900000;0
2211;4447;54;0;0;0;0;.00nan;0;0
2211;31643;54;78;26;2;24;.923;3900000;0
2211;37416;42;0;0;0;0;.00nan;0;0
2212;2796;59;0;0;0;0;.00nan;0;0
2212;3533;57;0;0;0;0;.00nan;0;0
2212;26865;57;80;37;3;34;.919;3600000;0
2212;34639;59;64;24;2;22;.917;3600000;0
2213;2016;61;0;0;0;0;.00nan;0;0
2213;2152;49;90;18;0;18;1.000;3600000;0
2213;4435;49;0;0;0;0;.00nan;0;0
2213;30971;61;54;38;5;33;.868;3600000;0
2214;262;43;28;31;7;24;.774;3600000;0
2214;3625;43;0;0;0;0;.00nan;0;0
2214;5298;55;0;0;0;0;.00nan;0;0
2214;34770;55;55;28;4;24;.857;3600000;0
2215;3;50;92;30;1;29;.967;3600000;0
2215;5048;50;0;0;0;0;.00nan;0;0
2215;5883;37;51;18;2;16;.889;3578000;0
2215;23043;37;0;0;0;0;.00nan;0;0
2216;2198;45;62;35;4;31;.886;3545000;0
2216;5146;64;90;36;2;34;.944;3600000;0
2216;14323;64;0;0;0;0;.00nan;0;0
2216;36703;45;0;0;0;0;.00nan;0;0
2217;323;46;100;45;1;44;.978;3600000;0
2217;2152;49;61;18;2;16;.889;3544000;0
2217;4435;49;0;0;0;0;.00nan;0;0
2217;35622;46;0;0;0;0;.00nan;0;0
2218;5137;58;0;0;0;0;.00nan;0;0
2218;14321;58;52;26;4;22;.846;3554000;0
2218;28772;53;0;0;0;0;.00nan;0;0
2218;31156;53;81;37;3;34;.919;3600000;0
2219;3533;57;0;0;0;0;.00nan;0;0
2219;4338;65;0;0;0;0;.00nan;0;0
2219;4987;65;83;26;1;25;.962;3600000;0
2219;26865;57;68;37;4;33;.892;3600000;0
2220;262;43;97;43;1;42;.977;3900000;0
2220;3625;43;0;0;0;0;.00nan;0;0
2220;6062;36;0;0;0;0;.00nan;0;0
2220;14874;36;89;20;1;19;.950;3900000;0
2221;2796;59;0;0;0;0;.00nan;0;0
2221;26967;63;72;36;3;33;.917;3593000;0
2221;34814;63;0;0;0;0;.00nan;0;0
2221;34819;59;69;18;1;17;.944;3600000;0
2222;780;52;0;0;0;0;.00nan;0;0
2222;5298;55;0;0;0;0;.00nan;0;0
2222;32146;52;73;36;4;32;.889;3553000;0
2222;34770;55;49;20;3;17;.850;3600000;0
2223;1098;42;0;0;0;0;.00nan;0;0
2223;5883;37;45;25;4;21;.840;3561000;0
2223;23043;37;0;0;0;0;.00nan;0;0
2223;37416;42;87;36;2;34;.944;3600000;0
2224;2553;4619;79;29;2;27;.931;3600000;0
2224;4716;4619;0;0;0;0;.00nan;0;0
2224;7049;47;70;35;4;31;.886;3600000;0
2224;25787;47;0;0;0;0;.00nan;0;0
2225;1051;44;90;35;2;33;.943;3600000;0
2225;3281;44;0;0;0;0;.00nan;0;0
2225;6572;62;0;0;0;0;.00nan;0;0
2225;26919;62;72;36;4;32;.889;3600000;0
2226;2016;61;0;0;0;0;.00nan;0;0
2226;20717;60;0;0;0;0;.00nan;0;0
2226;30971;61;67;33;4;29;.879;3600000;0
2226;35536;60;96;32;1;31;.969;3600000;0
2227;5137;58;0;0;0;0;.00nan;0;0
2227;14321;58;59;41;5;36;.878;3900000;0
2227;28772;53;0;0;0;0;.00nan;0;0
2227;31156;53;45;29;5;24;.828;3900000;0
2228;262;43;0;0;0;0;.00nan;0;0
2228;3625;43;71;41;5;36;.878;3600000;0
2228;19640;41;0;0;0;0;.00nan;0;0
2228;23075;41;84;31;2;29;.935;3600000;0
2229;5298;55;0;0;0;0;.00nan;0;0
2229;6062;36;74;36;3;33;.917;3600000;0
2229;14874;36;0;0;0;0;.00nan;0;0
2229;34770;55;93;18;0;18;1.000;3600000;0
2230;2796;59;0;0;0;0;.00nan;0;0
2230;6081;56;64;43;6;37;.860;3600000;0
2230;26824;56;0;0;0;0;.00nan;0;0
2230;34819;59;63;24;2;22;.917;3600000;0
2231;3533;57;0;0;0;0;.00nan;0;0
2231;23493;51;0;0;0;0;.00nan;0;0
2231;26865;57;57;25;3;22;.880;3712000;0
2231;31035;51;56;33;4;29;.879;3712000;0
2232;3847;38;0;0;0;0;.00nan;0;0
2232;4338;65;0;0;0;0;.00nan;0;0
2232;4987;65;72;34;4;30;.882;3649000;0
2232;31021;38;53;36;5;31;.861;3649000;0
2233;907;39;0;0;0;0;.00nan;0;0
2233;9238;39;77;11;0;11;1.000;3600000;0
2233;26967;63;89;37;3;34;.919;3600000;0
2233;34814;63;0;0;0;0;.00nan;0;0
2234;5146;64;0;0;0;0;.00nan;0;0
2234;5883;37;97;54;2;52;.963;3544000;0
2234;14323;64;78;23;1;22;.957;3600000;0
2234;23043;37;0;0;0;0;.00nan;0;0
2235;2198;45;97;38;2;36;.947;3600000;0
2235;4447;54;48;18;3;15;.833;3544000;0
2235;31643;54;0;0;0;0;.00nan;0;0
2235;36703;45;0;0;0;0;.00nan;0;0
2236;3;50;57;34;4;30;.882;3900000;0
2236;1098;42;71;44;4;40;.909;3900000;0
2236;5048;50;0;0;0;0;.00nan;0;0
2236;37416;42;0;0;0;0;.00nan;0;0
2237;323;46;48;19;3;16;.842;3600000;0
2237;7049;47;73;40;4;36;.900;3550000;0
2237;33654;47;0;0;0;0;.00nan;0;0
2237;35622;46;0;0;0;0;.00nan;0;0
2238;2016;61;0;0;0;0;.00nan;0;0
2238;14351;40;65;27;3;24;.889;3542000;0
2238;28712;40;0;0;0;0;.00nan;0;0
2238;30971;61;99;42;2;40;.952;3600000;0
2239;1051;44;73;33;3;30;.909;3686000;0
2239;2267;48;0;0;0;0;.00nan;0;0
2239;3281;44;0;0;0;0;.00nan;0;0
2239;38547;48;99;38;2;36;.947;3686000;0
2240;2796;59;0;0;0;0;.00nan;0;0
2240;23493;51;85;40;2;38;.950;3600000;0
2240;31035;51;0;0;0;0;.00nan;0;0
2240;34819;59;52;27;3;24;.889;3589000;0
2241;780;52;0;0;0;0;.00nan;0;0
2241;26967;63;59;34;4;30;.882;3586000;0
2241;32146;52;80;31;2;29;.935;3600000;0
2241;34814;63;0;0;0;0;.00nan;0;0
2242;2553;4619;74;43;4;39;.907;3600000;0
2242;4716;4619;0;0;0;0;.00nan;0;0
2242;20717;60;0;0;0;0;.00nan;0;0
2242;35536;60;81;30;1;29;.967;3600000;0
2243;1051;44;94;23;0;23;1.000;3600000;0
2243;2267;48;88;43;3;40;.930;3600000;0
2243;3281;44;0;0;0;0;.00nan;0;0
2243;38547;48;0;0;0;0;.00nan;0;0
2244;4338;65;97;36;1;35;.972;3575000;0
2244;4987;65;0;0;0;0;.00nan;0;0
2244;28772;53;99;22;0;22;1.000;3600000;0
2244;31156;53;0;0;0;0;.00nan;0;0
2245;907;39;0;0;0;0;.00nan;0;0
2245;6062;36;0;0;0;0;.00nan;0;0
2245;9238;39;60;16;1;15;.938;3600000;0
2245;14874;36;98;44;2;42;.955;3587000;0
2246;3533;57;0;0;0;0;.00nan;0;0
2246;6081;56;0;0;0;0;.00nan;0;0
2246;26824;56;45;22;3;19;.864;3511000;0
2246;26865;57;86;29;1;28;.966;3600000;0
2247;1098;42;0;0;0;0;.00nan;0;0
2247;5883;37;0;0;0;0;.00nan;0;0
2247;23043;37;64;30;4;26;.867;3900000;0
2247;37416;42;71;39;4;35;.897;3900000;0
2248;3847;38;0;0;0;0;.00nan;0;0
2248;5137;58;0;0;0;0;.00nan;0;0
2248;14321;58;100;34;0;34;1.000;3600000;0
2248;31021;38;54;28;4;24;.857;3600000;0
2249;2198;45;0;0;0;0;.00nan;0;0
2249;4447;54;0;0;0;0;.00nan;0;0
2249;31643;54;31;25;5;20;.800;3517000;0
2249;36703;45;70;32;3;29;.906;3600000;0
2250;323;46;0;0;0;0;.00nan;0;0
2250;7049;47;0;0;0;0;.00nan;0;0
2250;33654;47;70;53;6;47;.887;3600000;0
2250;35622;46;66;22;2;20;.909;3600000;0
2251;2152;49;0;0;0;0;.00nan;0;0
2251;4435;49;97;24;0;24;1.000;3600000;0
2251;6572;62;0;0;0;0;.00nan;0;0
2251;26919;62;69;33;3;30;.909;3600000;0
2252;262;43;97;43;2;41;.953;3563000;0
2252;3625;43;0;0;0;0;.00nan;0;0
2252;19640;41;0;0;0;0;.00nan;0;0
2252;23075;41;95;21;0;21;1.000;3600000;0
2253;3847;38;83;31;2;29;.935;3600000;0
2253;5298;55;0;0;0;0;.00nan;0;0
2253;31021;38;0;0;0;0;.00nan;0;0
2253;34770;55;38;29;5;24;.828;3600000;0
2254;780;52;63;31;4;27;.871;3571000;0
2254;907;39;81;31;2;29;.935;3600000;0
2254;9238;39;0;0;0;0;.00nan;0;0
2254;32146;52;0;0;0;0;.00nan;0;0
2255;3;50;76;26;2;24;.923;3600000;0
2255;5048;50;0;0;0;0;.00nan;0;0
2255;5146;64;68;46;6;40;.870;3600000;0
2255;14323;64;0;0;0;0;.00nan;0;0
2256;323;46;100;32;0;32;1.000;3600000;0
2256;2152;49;0;0;0;0;.00nan;0;0
2256;4435;49;75;37;3;34;.919;3600000;0
2256;35622;46;0;0;0;0;.00nan;0;0
2257;2553;4619;82;30;2;28;.933;3600000;0
2257;4716;4619;0;0;0;0;.00nan;0;0
2257;20717;60;0;0;0;0;.00nan;0;0
2257;35536;60;59;27;3;24;.889;3543000;0
2258;6572;62;0;0;0;0;.00nan;0;0
2258;14351;40;53;9;1;8;.889;3600000;0
2258;26919;62;72;39;3;36;.923;3530000;0
2258;28712;40;0;0;0;0;.00nan;0;0
2259;5883;37;95;34;1;33;.971;3600000;0
2259;23043;37;0;0;0;0;.00nan;0;0
2259;23493;51;0;0;0;0;.00nan;0;0
2259;31035;51;48;12;2;10;.833;3543000;0
2260;1098;42;0;0;0;0;.00nan;0;0
2260;4447;54;66;28;3;25;.893;3593000;0
2260;31643;54;0;0;0;0;.00nan;0;0
2260;37416;42;87;26;1;25;.962;3600000;0
2261;2016;61;0;0;0;0;.00nan;0;0
2261;26967;63;100;25;0;25;1.000;3600000;0
2261;30971;61;52;26;4;22;.846;3600000;0
2261;34814;63;0;0;0;0;.00nan;0;0
2262;2152;49;0;0;0;0;.00nan;0;0
2262;4435;49;38;18;3;15;.833;3555000;0
2262;20717;60;0;0;0;0;.00nan;0;0
2262;35536;60;100;37;1;36;.973;3600000;0
2263;2796;59;0;0;0;0;.00nan;0;0
2263;28772;53;100;37;0;37;1.000;3600000;0
2263;31156;53;0;0;0;0;.00nan;0;0
2263;34639;59;68;38;4;34;.895;3600000;0
2264;907;39;0;0;0;0;.00nan;0;0
2264;5298;55;0;0;0;0;.00nan;0;0
2264;9238;39;47;18;3;15;.833;3600000;0
2264;34770;55;88;50;4;46;.920;3564000;0
2265;5883;37;0;0;0;0;.00nan;0;0
2265;23043;37;78;30;2;28;.933;3600000;0
2265;23493;51;67;45;5;40;.889;3600000;0
2265;31035;51;0;0;0;0;.00nan;0;0
2266;2553;4619;59;35;4;31;.886;3600000;0
2266;4716;4619;0;0;0;0;.00nan;0;0
2266;14351;40;99;26;0;26;1.000;3600000;0
2266;28712;40;0;0;0;0;.00nan;0;0
2267;2016;61;82;14;0;14;1.000;3600000;0
2267;26967;63;89;39;1;38;.974;3546000;0
2267;30971;61;0;0;0;0;.00nan;0;0
2267;34814;63;0;0;0;0;.00nan;0;0
2268;6081;56;0;0;0;0;.00nan;0;0
2268;26824;56;94;41;2;39;.951;3600000;0
2268;28772;53;74;35;3;32;.914;3550000;0
2268;31156;53;0;0;0;0;.00nan;0;0
2269;4338;65;0;0;0;0;.00nan;0;0
2269;4987;65;60;34;5;29;.853;3576000;0
2269;19640;41;0;0;0;0;.00nan;0;0
2269;23075;41;65;29;3;26;.897;3600000;0
2270;262;43;0;0;0;0;.00nan;0;0
2270;907;39;0;0;0;0;.00nan;0;0
2270;3625;43;74;35;3;32;.914;3600000;0
2270;9238;39;82;26;2;24;.923;3600000;0
2271;5298;55;0;0;0;0;.00nan;0;0
2271;6062;36;62;49;6;43;.878;3600000;0
2271;14874;36;0;0;0;0;.00nan;0;0
2271;34770;55;100;25;0;25;1.000;3600000;0
2272;323;46;70;35;3;32;.914;3600000;0
2272;2198;45;63;33;4;29;.879;3530000;0
2272;35622;46;0;0;0;0;.00nan;0;0
2272;36703;45;0;0;0;0;.00nan;0;0
2273;3847;38;0;0;0;0;.00nan;0;0
2273;5137;58;0;0;0;0;.00nan;0;0
2273;14321;58;79;46;4;42;.913;3600000;0
2273;31021;38;71;19;1;18;.947;3600000;0
2274;2796;59;0;0;0;0;.00nan;0;0
2274;3533;57;0;0;0;0;.00nan;0;0
2274;26865;57;65;44;4;40;.909;3600000;0
2274;34639;59;72;32;3;29;.906;3600000;0
2275;5883;37;51;23;3;20;.870;3600000;0
2275;23043;37;0;0;0;0;.00nan;0;0
2275;26967;63;100;28;0;28;1.000;3600000;0
2275;34814;63;0;0;0;0;.00nan;0;0
2276;4447;54;68;17;1;16;.941;3600000;0
2276;5146;64;89;39;3;36;.923;3581000;0
2276;14323;64;0;0;0;0;.00nan;0;0
2276;31643;54;0;0;0;0;.00nan;0;0
2277;3626;48;5;28;8;20;.714;2466000;0
2277;7049;47;72;27;2;25;.926;3600000;0
2277;33654;47;0;0;0;0;.00nan;0;0
2277;38547;48;55;6;0;6;1.000;1134000;0
2278;2152;49;0;0;0;0;.00nan;0;0
2278;2553;4619;61;30;4;26;.867;3600000;0
2278;4435;49;69;22;1;21;.955;3600000;0
2278;4716;4619;0;0;0;0;.00nan;0;0
2279;3;50;69;30;3;27;.900;3600000;0
2279;5048;50;0;0;0;0;.00nan;0;0
2279;6572;62;0;0;0;0;.00nan;0;0
2279;26919;62;21;32;7;25;.781;3600000;0
2280;1051;44;100;30;0;30;1.000;3600000;0
2280;1098;42;0;0;0;0;.00nan;0;0
2280;3281;44;0;0;0;0;.00nan;0;0
2280;37416;42;82;37;2;35;.946;3600000;0
2281;4338;65;72;25;3;22;.880;3600000;0
2281;4987;65;0;0;0;0;.00nan;0;0
2281;19640;41;53;3;0;3;1.000;654000;0
2281;23075;41;40;30;6;24;.800;2946000;0
2282;780;52;0;0;0;0;.00nan;0;0
2282;2796;59;67;33;3;30;.909;3600000;0
2282;23255;52;62;18;2;16;.889;3600000;0
2282;34639;59;0;0;0;0;.00nan;0;0
2283;5137;58;0;0;0;0;.00nan;0;0
2283;6081;56;64;45;5;40;.889;3536000;0
2283;14321;58;52;21;3;18;.857;3600000;0
2283;26824;56;0;0;0;0;.00nan;0;0
2284;6062;36;0;0;0;0;.00nan;0;0
2284;14874;36;51;35;5;30;.857;3600000;0
2284;28772;53;0;0;0;0;.00nan;0;0
2284;31156;53;88;25;1;24;.960;3600000;0
2285;262;43;65;32;4;28;.875;3600000;0
2285;907;39;64;19;1;18;.947;3600000;0
2285;3625;43;0;0;0;0;.00nan;0;0
2285;9238;39;0;0;0;0;.00nan;0;0
2286;323;46;61;41;6;35;.854;3847000;0
2286;2198;45;0;0;0;0;.00nan;0;0
2286;35622;46;0;0;0;0;.00nan;0;0
2286;36703;45;43;30;5;25;.833;3851000;0
2287;1668;57;0;0;0;0;.00nan;0;0
2287;3533;57;61;38;4;34;.895;3600000;0
2287;5298;55;0;0;0;0;.00nan;0;0
2287;34770;55;74;9;0;9;1.000;3600000;0
2288;4447;54;0;0;0;0;.00nan;0;0
2288;5146;64;0;0;0;0;.00nan;0;0
2288;14323;64;77;39;4;35;.897;3518000;0
2288;31643;54;58;22;2;20;.909;3600000;0
2289;2152;49;59;26;3;23;.885;3600000;0
2289;2553;4619;0;0;0;0;.00nan;0;0
2289;4435;49;0;0;0;0;.00nan;0;0
2289;4716;4619;45;26;4;22;.846;3600000;0
2290;14351;40;79;34;2;32;.941;3600000;0
2290;20717;60;65;10;0;10;1.000;722000;0
2290;28712;40;0;0;0;0;.00nan;0;0
2290;35536;60;14;30;8;22;.733;2878000;0
2291;3;50;0;0;0;0;.00nan;0;0
2291;5048;50;59;28;3;25;.893;3543000;0
2291;6572;62;80;28;2;26;.929;3600000;0
2291;26919;62;0;0;0;0;.00nan;0;0
2292;1051;44;99;32;1;31;.969;3600000;0
2292;1098;42;0;0;0;0;.00nan;0;0
2292;3281;44;0;0;0;0;.00nan;0;0
2292;37416;42;61;32;4;28;.875;3600000;0
2293;3626;48;0;0;0;0;.00nan;0;0
2293;7049;47;0;0;0;0;.00nan;0;0
2293;33654;47;37;26;5;21;.808;3576000;0
2293;38547;48;60;27;3;24;.889;3600000;0
2294;2016;61;34;32;6;26;.813;3600000;0
2294;23493;51;0;0;0;0;.00nan;0;0
2294;30971;61;0;0;0;0;.00nan;0;0
2294;31035;51;48;33;5;28;.848;3600000;0
2295;5137;58;0;0;0;0;.00nan;0;0
2295;6081;56;0;0;0;0;.00nan;0;0
2295;14321;58;90;28;1;27;.964;3600000;0
2295;26824;56;74;30;2;28;.933;3547000;0
2296;780;52;91;19;0;19;1.000;3600000;0
2296;1668;57;36;32;5;27;.844;3600000;0
2296;3533;57;0;0;0;0;.00nan;0;0
2296;23255;52;0;0;0;0;.00nan;0;0
2297;5883;37;53;26;3;23;.885;3600000;0
2297;23043;37;0;0;0;0;.00nan;0;0
2297;26967;63;52;26;4;22;.846;3544000;0
2297;34814;63;0;0;0;0;.00nan;0;0
2298;2198;45;61;21;3;18;.857;3595000;0
2298;5146;64;83;26;1;25;.962;3600000;0
2298;14323;64;0;0;0;0;.00nan;0;0
2298;36703;45;0;0;0;0;.00nan;0;0
2299;3847;38;0;0;0;0;.00nan;0;0
2299;6062;36;100;36;1;35;.972;3600000;0
2299;14874;36;0;0;0;0;.00nan;0;0
2299;31021;38;80;30;2;28;.933;3544000;0
2300;323;46;81;46;2;44;.957;3600000;0
2300;4447;54;80;27;1;26;.963;3600000;0
2300;31643;54;0;0;0;0;.00nan;0;0
2300;35622;46;0;0;0;0;.00nan;0;0
2301;14351;40;0;0;0;0;.00nan;0;0
2301;20717;60;12;18;6;12;.667;3551000;0
2301;28712;40;63;32;5;27;.844;3600000;0
2301;35536;60;0;0;0;0;.00nan;0;0
2302;2016;61;0;0;0;0;.00nan;0;0
2302;23493;51;98;45;1;44;.978;3900000;0
2302;30971;61;86;28;1;27;.964;3900000;0
2302;31035;51;0;0;0;0;.00nan;0;0
2303;1098;42;0;0;0;0;.00nan;0;0
2303;3626;48;0;0;0;0;.00nan;0;0
2303;37416;42;100;26;0;26;1.000;3600000;0
2303;38547;48;88;36;2;34;.944;3574000;0
2304;780;52;0;0;0;0;.00nan;0;0
2304;4338;65;83;31;2;29;.935;3600000;0
2304;4987;65;0;0;0;0;.00nan;0;0
2304;23255;52;36;26;5;21;.808;3600000;0
2305;3;50;0;0;0;0;.00nan;0;0
2305;1051;44;50;35;5;30;.857;3543000;0
2305;3281;44;0;0;0;0;.00nan;0;0
2305;5048;50;60;36;4;32;.889;3600000;0
2306;1098;42;0;0;0;0;.00nan;0;0
2306;3626;48;77;33;2;31;.939;3597000;0
2306;37416;42;81;27;1;26;.963;3600000;0
2306;38547;48;0;0;0;0;.00nan;0;0
2307;6062;36;0;0;0;0;.00nan;0;0
2307;14874;36;83;44;4;40;.909;3900000;0
2307;26967;63;48;27;4;23;.852;3900000;0
2307;34814;63;0;0;0;0;.00nan;0;0
2308;4447;54;0;0;0;0;.00nan;0;0
2308;5883;37;73;32;4;28;.875;3529000;0
2308;23043;37;0;0;0;0;.00nan;0;0
2308;31643;54;83;23;2;21;.913;3600000;0
2309;2198;45;57;26;3;23;.885;3892000;0
2309;5146;64;0;0;0;0;.00nan;0;0
2309;14323;64;68;38;4;34;.895;3892000;0
2309;36703;45;0;0;0;0;.00nan;0;0
2310;5298;55;0;0;0;0;.00nan;0;0
2310;6081;56;0;0;0;0;.00nan;0;0
2310;26824;56;53;30;4;26;.867;3600000;0
2310;34770;55;100;23;0;23;1.000;3600000;0
2311;262;43;74;31;2;29;.935;3595000;0
2311;323;46;87;32;1;31;.969;3600000;0
2311;3625;43;0;0;0;0;.00nan;0;0
2311;35622;46;0;0;0;0;.00nan;0;0
2312;1668;57;80;39;3;36;.923;3600000;0
2312;2796;59;0;0;0;0;.00nan;0;0
2312;3533;57;0;0;0;0;.00nan;0;0
2312;34639;59;40;24;4;20;.833;3581000;0
2313;907;39;0;0;0;0;.00nan;0;0
2313;9238;39;79;25;1;24;.960;3600000;0
2313;23493;51;0;0;0;0;.00nan;0;0
2313;31035;51;62;34;5;29;.853;3600000;0
2314;7049;47;54;37;5;32;.865;3600000;0
2314;20717;60;0;0;0;0;.00nan;0;0
2314;33654;47;0;0;0;0;.00nan;0;0
2314;35536;60;70;19;2;17;.895;3600000;0
2315;3;50;0;0;0;0;.00nan;0;0
2315;1051;44;0;0;0;0;.00nan;0;0
2315;3281;44;78;30;2;28;.933;3600000;0
2315;5048;50;46;28;5;23;.821;3600000;0
2316;19640;41;0;0;0;0;.00nan;0;0
2316;23075;41;69;29;2;27;.931;3600000;0
2316;28772;53;24;11;4;7;.636;908000;0
2316;31156;53;61;24;3;21;.875;2692000;0
2317;780;52;72;16;0;16;1.000;1342000;0
2317;3847;38;0;0;0;0;.00nan;0;0
2317;23255;52;36;35;6;29;.829;2258000;0
2317;31021;38;55;13;1;12;.923;3600000;0
2318;19640;41;0;0;0;0;.00nan;0;0
2318;23075;41;52;29;4;25;.862;3524000;0
2318;28772;53;70;29;3;26;.897;3600000;0
2318;31156;53;0;0;0;0;.00nan;0;0
2319;5137;58;0;0;0;0;.00nan;0;0
2319;6062;36;62;25;2;23;.920;3600000;0
2319;14321;58;91;31;1;30;.968;3600000;0
2319;14874;36;0;0;0;0;.00nan;0;0
2320;5298;55;0;0;0;0;.00nan;0;0
2320;6081;56;95;33;1;32;.970;3900000;0
2320;26824;56;0;0;0;0;.00nan;0;0
2320;34770;55;91;30;1;29;.967;3900000;0
2321;907;39;0;0;0;0;.00nan;0;0
2321;9238;39;74;26;2;24;.923;3900000;0
2321;23493;51;0;0;0;0;.00nan;0;0
2321;31035;51;100;43;2;41;.953;3900000;0
2322;4338;65;55;30;4;26;.867;3513000;0
2322;4987;65;0;0;0;0;.00nan;0;0
2322;8046;57;0;0;0;0;.00nan;0;0
2322;26865;57;66;21;2;19;.905;3600000;0
2323;4447;54;87;36;2;34;.944;3900000;0
2323;5883;37;73;26;2;24;.923;3900000;0
2323;23043;37;0;0;0;0;.00nan;0;0
2323;31643;54;0;0;0;0;.00nan;0;0
2324;2553;4619;67;19;1;18;.947;3600000;0
2324;4716;4619;0;0;0;0;.00nan;0;0
2324;7049;47;25;20;5;15;.750;2280000;0
2324;33654;47;53;13;2;11;.846;1320000;0
2325;2152;49;0;0;0;0;.00nan;0;0
2325;4435;49;49;27;5;22;.815;3600000;0
2325;14351;40;90;32;2;30;.938;3600000;0
2325;28712;40;0;0;0;0;.00nan;0;0
2326;2016;61;0;0;0;0;.00nan;0;0
2326;6572;62;0;0;0;0;.00nan;0;0
2326;26919;62;70;31;3;28;.903;3600000;0
2326;30971;61;67;27;2;25;.926;3600000;0
2327;323;46;48;21;3;18;.857;3600000;0
2327;26967;63;71;39;4;35;.897;3585000;0
2327;34814;63;0;0;0;0;.00nan;0;0
2327;35622;46;0;0;0;0;.00nan;0;0
2328;5298;55;66;26;2;24;.923;3600000;0
2328;23493;51;54;35;5;30;.857;3600000;0
2328;31035;51;0;0;0;0;.00nan;0;0
2328;34770;55;0;0;0;0;.00nan;0;0
2329;4338;65;0;0;0;0;.00nan;0;0
2329;4987;65;73;25;2;23;.920;3900000;0
2329;5137;58;0;0;0;0;.00nan;0;0
2329;14321;58;78;25;2;23;.920;3900000;0
2330;2796;59;0;0;0;0;.00nan;0;0
2330;6062;36;0;0;0;0;.00nan;0;0
2330;14874;36;59;38;6;32;.842;3600000;0
2330;34639;59;64;26;3;23;.885;3600000;0
2331;907;39;99;42;1;41;.976;3600000;0
2331;6081;56;0;0;0;0;.00nan;0;0
2331;9238;39;0;0;0;0;.00nan;0;0
2331;26824;56;68;23;2;21;.913;3569000;0
2332;262;43;61;22;2;20;.909;3600000;0
2332;3625;43;0;0;0;0;.00nan;0;0
2332;4447;54;0;0;0;0;.00nan;0;0
2332;31643;54;72;33;3;30;.909;3600000;0
2333;1051;44;31;24;5;19;.792;3600000;0
2333;1098;42;0;0;0;0;.00nan;0;0
2333;3281;44;0;0;0;0;.00nan;0;0
2333;37416;42;72;29;2;27;.931;3600000;0
2334;780;52;66;25;3;22;.880;3110000;0
2334;3847;38;65;43;5;38;.884;3600000;0
2334;23255;52;13;5;4;1;.200;476000;0
2334;31021;38;0;0;0;0;.00nan;0;0
2335;5146;64;73;40;4;36;.900;3685000;0
2335;5883;37;58;32;5;27;.844;3685000;0
2335;14323;64;0;0;0;0;.00nan;0;0
2335;23043;37;0;0;0;0;.00nan;0;0
2336;3;50;0;0;0;0;.00nan;0;0
2336;2198;45;0;0;0;0;.00nan;0;0
2336;5048;50;72;22;1;21;.955;3900000;0
2336;36703;45;100;37;1;36;.973;3900000;0
2337;2553;4619;0;0;0;0;.00nan;0;0
2337;4716;4619;73;29;2;27;.931;3600000;0
2337;7049;47;58;29;3;26;.897;3571000;0
2337;33654;47;0;0;0;0;.00nan;0;0
2338;3626;48;70;44;4;40;.909;3577000;0
2338;20717;60;0;0;0;0;.00nan;0;0
2338;35536;60;45;16;3;13;.813;3600000;0
2338;38547;48;0;0;0;0;.00nan;0;0
2339;2016;61;100;33;0;33;1.000;3600000;0
2339;6572;62;77;45;4;41;.911;3600000;0
2339;26919;62;0;0;0;0;.00nan;0;0
2339;30971;61;0;0;0;0;.00nan;0;0
2340;19640;41;0;0;0;0;.00nan;0;0
2340;23075;41;64;21;2;19;.905;3600000;0
2340;28772;53;53;29;4;25;.862;3539000;0
2340;31156;53;0;0;0;0;.00nan;0;0
2341;780;52;0;0;0;0;.00nan;0;0
2341;8046;57;0;0;0;0;.00nan;0;0
2341;23255;52;89;46;3;43;.935;3899000;0
2341;26865;57;67;29;3;26;.897;3900000;0
2342;323;46;41;17;3;14;.824;3600000;0
2342;26967;63;0;0;0;0;.00nan;0;0
2342;34814;63;58;43;5;38;.884;3577000;0
2342;35622;46;0;0;0;0;.00nan;0;0
2343;262;43;46;7;1;6;.857;1509000;0
2343;3625;43;27;25;6;19;.760;2339000;0
2343;5146;64;43;13;3;10;.769;1768000;0
2343;14323;64;35;22;5;17;.773;2080000;0
2344;4338;65;61;35;4;31;.886;3886000;0
2344;4987;65;0;0;0;0;.00nan;0;0
2344;5137;58;0;0;0;0;.00nan;0;0
2344;14321;58;64;33;4;29;.879;3900000;0
2345;1051;44;0;0;0;0;.00nan;0;0
2345;1098;42;86;30;2;28;.933;3600000;0
2345;3281;44;99;27;1;26;.963;3600000;0
2345;37416;42;0;0;0;0;.00nan;0;0
2346;3;50;0;0;0;0;.00nan;0;0
2346;2198;45;59;25;3;22;.880;3900000;0
2346;5048;50;88;37;3;34;.919;3900000;0
2346;36703;45;0;0;0;0;.00nan;0;0
2347;2152;49;43;24;4;20;.833;3781000;0
2347;4435;49;0;0;0;0;.00nan;0;0
2347;14351;40;81;49;5;44;.898;3781000;0
2347;28712;40;0;0;0;0;.00nan;0;0
2348;3626;48;0;0;0;0;.00nan;0;0
2348;20717;60;70;21;1;20;.952;3600000;0
2348;35536;60;0;0;0;0;.00nan;0;0
2348;38547;48;71;42;4;38;.905;3600000;0
2349;6081;56;58;29;2;27;.931;3900000;0
2349;26824;56;0;0;0;0;.00nan;0;0
2349;28772;53;72;26;2;24;.923;3900000;0
2349;31156;53;0;0;0;0;.00nan;0;0
2350;262;43;62;31;3;28;.903;3544000;0
2350;323;46;64;23;2;21;.913;3600000;0
2350;3625;43;0;0;0;0;.00nan;0;0
2350;35622;46;0;0;0;0;.00nan;0;0
2351;4338;65;89;47;3;44;.936;3900000;0
2351;4987;65;0;0;0;0;.00nan;0;0
2351;8046;57;0;0;0;0;.00nan;0;0
2351;26865;57;54;25;3;22;.880;3900000;0
2352;5137;58;0;0;0;0;.00nan;0;0
2352;6062;36;0;0;0;0;.00nan;0;0
2352;14321;58;61;27;3;24;.889;3600000;0
2352;14874;36;85;27;1;26;.963;3600000;0
2353;907;39;0;0;0;0;.00nan;0;0
2353;9238;39;80;34;3;31;.912;3547000;0
2353;23493;51;0;0;0;0;.00nan;0;0
2353;31035;51;66;24;2;22;.917;3600000;0
2354;2198;45;66;30;3;27;.900;3600000;0
2354;5146;64;0;0;0;0;.00nan;0;0
2354;14323;64;55;37;5;32;.865;3600000;0
2354;36703;45;0;0;0;0;.00nan;0;0
2355;3;50;0;0;0;0;.00nan;0;0
2355;4447;54;0;0;0;0;.00nan;0;0
2355;5048;50;97;53;3;50;.943;3600000;0
2355;31643;54;81;15;0;15;1.000;3600000;0
2356;7049;47;80;45;4;41;.911;3580000;0
2356;20717;60;0;0;0;0;.00nan;0;0
2356;33654;47;0;0;0;0;.00nan;0;0
2356;35536;60;51;19;3;16;.842;3600000;0
2357;3626;48;0;0;0;0;.00nan;0;0
2357;14351;40;0;0;0;0;.00nan;0;0
2357;28712;40;80;30;2;28;.933;3600000;0
2357;38547;48;15;32;7;25;.781;3600000;0
2358;1098;42;54;10;1;9;.900;637000;0
2358;5883;37;63;20;3;17;.850;3600000;0
2358;23043;37;0;0;0;0;.00nan;0;0
2358;37416;42;50;40;6;34;.850;2963000;0
2359;26967;63;31;29;6;23;.793;3315000;0
2359;28772;53;58;28;3;25;.893;3600000;0
2359;31156;53;0;0;0;0;.00nan;0;0
2359;34814;63;56;4;0;4;1.000;285000;0
2360;262;43;0;0;0;0;.00nan;0;0
2360;3625;43;60;44;6;38;.864;3600000;0
2360;23493;51;0;0;0;0;.00nan;0;0
2360;31035;51;72;35;3;32;.914;3600000;0
2361;5298;55;0;0;0;0;.00nan;0;0
2361;6062;36;52;33;4;29;.879;3600000;0
2361;14874;36;0;0;0;0;.00nan;0;0
2361;34770;55;78;26;1;25;.962;3600000;0
2362;3;50;0;0;0;0;.00nan;0;0
2362;323;46;64;22;2;20;.909;3600000;0
2362;5048;50;77;37;3;34;.919;3573000;0
2362;35622;46;0;0;0;0;.00nan;0;0
2363;6847;52;0;0;0;0;.00nan;0;0
2363;8046;57;0;0;0;0;.00nan;0;0
2363;23255;52;19;24;6;18;.750;3600000;0
2363;26865;57;58;23;3;20;.870;3600000;0
2364;2796;59;0;0;0;0;.00nan;0;0
2364;4338;65;74;30;2;28;.933;3542000;0
2364;4987;65;0;0;0;0;.00nan;0;0
2364;34639;59;91;21;0;21;1.000;3600000;0
2365;5137;58;0;0;0;0;.00nan;0;0
2365;14321;58;91;40;3;37;.925;3900000;0
2365;19640;41;0;0;0;0;.00nan;0;0
2365;23075;41;71;31;3;28;.903;3900000;0
2366;2198;45;85;34;3;31;.912;3900000;0
2366;5146;64;0;0;0;0;.00nan;0;0
2366;14323;64;72;34;3;31;.912;3900000;0
2366;36703;45;0;0;0;0;.00nan;0;0
2367;2152;49;0;0;0;0;.00nan;0;0
2367;4435;49;86;26;1;25;.962;3600000;0
2367;6572;62;0;0;0;0;.00nan;0;0
2367;26919;62;51;34;5;29;.853;3600000;0
2368;2016;61;73;35;3;32;.914;3600000;0
2368;20717;60;0;0;0;0;.00nan;0;0
2368;30971;61;0;0;0;0;.00nan;0;0
2368;35536;60;48;32;5;27;.844;3600000;0
2369;1051;44;71;22;2;20;.909;3560000;0
2369;2553;4619;94;33;1;32;.970;3600000;0
2369;3281;44;0;0;0;0;.00nan;0;0
2369;4716;4619;0;0;0;0;.00nan;0;0
2370;3626;48;0;0;0;0;.00nan;0;0
2370;14351;40;76;19;1;18;.947;3833000;0
2370;28712;40;0;0;0;0;.00nan;0;0
2370;38547;48;93;42;2;40;.952;3833000;0
2371;1098;42;0;0;0;0;.00nan;0;0
2371;5883;37;0;0;0;0;.00nan;0;0
2371;23043;37;42;18;3;15;.833;3600000;0
2371;37416;42;72;44;4;40;.909;3600000;0
2372;2796;59;0;0;0;0;.00nan;0;0
2372;6847;52;75;29;2;27;.931;3600000;0
2372;23255;52;0;0;0;0;.00nan;0;0
2372;34639;59;64;32;3;29;.906;3600000;0
2373;5137;58;0;0;0;0;.00nan;0;0
2373;14321;58;86;30;1;29;.967;3600000;0
2373;19640;41;34;14;3;11;.786;594000;0
2373;23075;41;68;24;2;22;.917;3006000;0
2374;6062;36;0;0;0;0;.00nan;0;0
2374;14874;36;69;23;1;22;.957;3600000;0
2374;26967;63;0;0;0;0;.00nan;0;0
2374;34814;63;82;42;3;39;.929;3523000;0
2375;262;43;100;35;0;35;1.000;3600000;0
2375;3625;43;0;0;0;0;.00nan;0;0
2375;23493;51;80;30;1;29;.967;3543000;0
2375;31035;51;0;0;0;0;.00nan;0;0
2376;5298;55;71;36;3;33;.917;3595000;0
2376;6081;56;74;23;1;22;.957;3600000;0
2376;26824;56;0;0;0;0;.00nan;0;0
2376;34770;55;0;0;0;0;.00nan;0;0
2377;3;50;53;3;0;3;1.000;254000;0
2377;4447;54;0;0;0;0;.00nan;0;0
2377;5048;50;33;25;6;19;.760;3340000;0
2377;31643;54;72;41;5;36;.878;3600000;0
2378;3847;38;0;0;0;0;.00nan;0;0
2378;8046;57;60;31;4;27;.871;3600000;0
2378;26865;57;0;0;0;0;.00nan;0;0
2378;31021;38;94;21;0;21;1.000;3600000;0
2379;907;39;0;0;0;0;.00nan;0;0
2379;9238;39;47;26;4;22;.846;3600000;0
2379;28772;53;100;33;0;33;1.000;3600000;0
2379;31156;53;0;0;0;0;.00nan;0;0
2380;2198;45;0;0;0;0;.00nan;0;0
2380;5146;64;82;35;2;33;.943;3600000;0
2380;14323;64;0;0;0;0;.00nan;0;0
2380;36703;45;67;30;3;27;.900;3600000;0
2381;2016;61;0;0;0;0;.00nan;0;0
2381;7049;47;46;34;5;29;.853;3517000;0
2381;30971;61;79;37;3;34;.919;3600000;0
2381;33654;47;0;0;0;0;.00nan;0;0
2382;2152;49;62;16;2;14;.875;3600000;0
2382;4435;49;0;0;0;0;.00nan;0;0
2382;6572;62;68;37;3;34;.919;3558000;0
2382;26919;62;0;0;0;0;.00nan;0;0
2383;1051;44;0;0;0;0;.00nan;0;0
2383;2553;4619;0;0;0;0;.00nan;0;0
2383;3281;44;74;32;3;29;.906;3600000;0
2383;4716;4619;47;20;4;16;.800;3600000;0
2384;3626;48;73;33;4;29;.879;3600000;0
2384;14351;40;0;0;0;0;.00nan;0;0
2384;28712;40;64;30;3;27;.900;3600000;0
2384;38547;48;0;0;0;0;.00nan;0;0
2385;3847;38;0;0;0;0;.00nan;0;0
2385;4338;65;53;35;4;31;.886;3572000;0
2385;4987;65;0;0;0;0;.00nan;0;0
2385;31021;38;69;33;3;30;.909;3600000;0
2386;262;43;94;31;1;30;.968;3804000;0
2386;3625;43;0;0;0;0;.00nan;0;0
2386;5298;55;0;0;0;0;.00nan;0;0
2386;34770;55;84;35;2;33;.943;3804000;0
2387;3;50;0;0;0;0;.00nan;0;0
2387;323;46;57;22;3;19;.864;3600000;0
2387;5048;50;48;24;4;20;.833;3544000;0
2387;35622;46;0;0;0;0;.00nan;0;0
2388;262;43;0;0;0;0;.00nan;0;0
2388;3625;43;67;33;3;30;.909;3600000;0
2388;5298;55;71;25;1;24;.960;3600000;0
2388;34770;55;0;0;0;0;.00nan;0;0
2389;6081;56;0;0;0;0;.00nan;0;0
2389;26824;56;99;31;1;30;.968;3600000;0
2389;26967;63;83;45;4;41;.911;3600000;0
2389;34814;63;0;0;0;0;.00nan;0;0
2390;2198;45;69;21;1;20;.952;3600000;0
2390;4447;54;0;0;0;0;.00nan;0;0
2390;31643;54;74;41;4;37;.902;3600000;0
2390;36703;45;0;0;0;0;.00nan;0;0
2391;323;46;70;37;4;33;.892;3600000;0
2391;1098;42;0;0;0;0;.00nan;0;0
2391;35622;46;0;0;0;0;.00nan;0;0
2391;37416;42;90;25;1;24;.960;3600000;0
2392;2152;49;0;0;0;0;.00nan;0;0
2392;2553;4619;33;29;5;24;.828;3600000;0
2392;4435;49;99;40;1;39;.975;3600000;0
2392;4716;4619;0;0;0;0;.00nan;0;0
2393;7049;47;61;39;5;34;.872;3600000;0
2393;20717;60;0;0;0;0;.00nan;0;0
2393;33654;47;0;0;0;0;.00nan;0;0
2393;35536;60;45;24;4;20;.833;3600000;0
2394;1051;44;52;33;5;28;.848;3600000;0
2394;3281;44;0;0;0;0;.00nan;0;0
2394;14351;40;100;27;0;27;1.000;3600000;0
2394;28712;40;0;0;0;0;.00nan;0;0
2395;2016;61;0;0;0;0;.00nan;0;0
2395;6572;62;0;0;0;0;.00nan;0;0
2395;26919;62;38;30;6;24;.800;3600000;0
2395;30971;61;84;35;2;33;.943;3600000;0
2396;19640;41;0;0;0;0;.00nan;0;0
2396;23075;41;69;21;2;19;.905;3600000;0
2396;28772;53;84;39;3;36;.923;3600000;0
2396;31156;53;0;0;0;0;.00nan;0;0
2397;5137;58;0;0;0;0;.00nan;0;0
2397;6847;52;0;0;0;0;.00nan;0;0
2397;14321;58;90;53;5;48;.906;3600000;0
2397;23255;52;100;31;0;31;1.000;3600000;0
2398;6062;36;72;31;3;28;.903;3806000;0
2398;6081;56;0;0;0;0;.00nan;0;0
2398;14874;36;0;0;0;0;.00nan;0;0
2398;26824;56;71;27;2;25;.926;3806000;0
2399;907;39;0;0;0;0;.00nan;0;0
2399;5298;55;0;0;0;0;.00nan;0;0
2399;9238;39;84;33;2;31;.939;3600000;0
2399;34770;55;81;34;3;31;.912;3570000;0
2400;23493;51;0;0;0;0;.00nan;0;0
2400;26967;63;76;36;3;33;.917;3899000;0
2400;31408;51;80;28;2;26;.929;3899000;0
2400;34814;63;0;0;0;0;.00nan;0;0
2401;323;46;100;38;0;38;1.000;3600000;0
2401;5146;64;92;37;1;36;.973;3600000;0
2401;14323;64;0;0;0;0;.00nan;0;0
2401;35622;46;0;0;0;0;.00nan;0;0
2402;2796;59;46;22;4;18;.818;2541000;0
2402;3847;38;0;0;0;0;.00nan;0;0
2402;31021;38;74;34;3;31;.912;3600000;0
2402;34639;59;25;14;4;10;.714;1059000;0
2403;4338;65;51;49;6;43;.878;3188000;0
2403;4987;65;52;4;0;4;1.000;412000;0
2403;8046;57;0;0;0;0;.00nan;0;0
2403;26865;57;69;19;1;18;.947;3600000;0
2404;3;50;0;0;0;0;.00nan;0;0
2404;2198;45;99;36;1;35;.972;3600000;0
2404;5048;50;60;43;5;38;.884;3600000;0
2404;36703;45;0;0;0;0;.00nan;0;0
2405;2152;49;0;0;0;0;.00nan;0;0
2405;2553;4619;63;28;3;25;.893;3851000;0
2405;4435;49;64;21;2;19;.905;3851000;0
2405;4716;4619;0;0;0;0;.00nan;0;0
2406;1051;44;76;28;2;26;.929;3600000;0
2406;3281;44;0;0;0;0;.00nan;0;0
2406;7049;47;0;0;0;0;.00nan;0;0
2406;33654;47;85;39;3;36;.923;3595000;0
2407;2016;61;0;0;0;0;.00nan;0;0
2407;14351;40;100;36;1;35;.972;3600000;0
2407;28712;40;0;0;0;0;.00nan;0;0
2407;30971;61;62;38;4;34;.895;3600000;0
2408;2796;59;0;0;0;0;.00nan;0;0
2408;5137;58;0;0;0;0;.00nan;0;0
2408;14321;58;71;26;2;24;.923;3900000;0
2408;34639;59;72;33;2;31;.939;3900000;0
2409;6847;52;75;30;2;28;.933;3600000;0
2409;23255;52;0;0;0;0;.00nan;0;0
2409;28772;53;0;0;0;0;.00nan;0;0
2409;31156;53;40;20;4;16;.800;3596000;0
2410;4338;65;0;0;0;0;.00nan;0;0
2410;4987;65;88;36;2;34;.944;3560000;0
2410;8046;57;0;0;0;0;.00nan;0;0
2410;26865;57;83;29;1;28;.966;3600000;0
2411;6062;36;0;0;0;0;.00nan;0;0
2411;14874;36;60;39;5;34;.872;3600000;0
2411;23493;51;94;43;2;41;.953;3600000;0
2411;31408;51;0;0;0;0;.00nan;0;0
2412;1098;42;0;0;0;0;.00nan;0;0
2412;5883;37;84;28;1;27;.964;3899000;0
2412;23043;37;0;0;0;0;.00nan;0;0
2412;37416;42;100;43;0;43;1.000;3899000;0
2413;3;50;0;0;0;0;.00nan;0;0
2413;2198;45;63;23;2;21;.913;3518000;0
2413;5048;50;100;33;0;33;1.000;3600000;0
2413;36703;45;0;0;0;0;.00nan;0;0
2414;3847;38;0;0;0;0;.00nan;0;0
2414;19640;41;0;0;0;0;.00nan;0;0
2414;23075;41;55;22;3;19;.864;3900000;0
2414;31021;38;85;43;3;40;.930;3900000;0
2415;262;43;65;20;1;19;.950;3600000;0
2415;907;39;66;37;4;33;.892;3600000;0
2415;3625;43;0;0;0;0;.00nan;0;0
2415;9238;39;0;0;0;0;.00nan;0;0
2416;4447;54;0;0;0;0;.00nan;0;0
2416;5146;64;0;0;0;0;.00nan;0;0
2416;14323;64;81;41;4;37;.902;3515000;0
2416;31643;54;77;31;2;29;.935;3600000;0
2417;2152;49;93;30;1;29;.967;3600000;0
2417;2553;4619;0;0;0;0;.00nan;0;0
2417;4435;49;0;0;0;0;.00nan;0;0
2417;4716;4619;65;31;4;27;.871;3600000;0
2418;7049;47;63;25;3;22;.880;3839000;0
2418;14351;40;0;0;0;0;.00nan;0;0
2418;28712;40;64;34;4;30;.882;3839000;0
2418;33654;47;0;0;0;0;.00nan;0;0
2419;1051;44;0;0;0;0;.00nan;0;0
2419;3281;44;82;40;2;38;.950;3600000;0
2419;6572;62;0;0;0;0;.00nan;0;0
2419;26919;62;48;26;4;22;.846;3600000;0
2420;3626;48;0;0;0;0;.00nan;0;0
2420;20717;60;0;0;0;0;.00nan;0;0
2420;35536;60;57;30;5;25;.833;3745000;0
2420;38547;48;69;39;4;35;.897;3745000;0
2421;3847;38;0;0;0;0;.00nan;0;0
2421;5137;58;48;26;4;22;.846;3900000;0
2421;14321;58;0;0;0;0;.00nan;0;0
2421;31021;38;82;49;4;45;.918;3900000;0
2422;2796;59;51;39;5;34;.872;3600000;0
2422;28772;53;71;29;2;27;.931;3600000;0
2422;31156;53;0;0;0;0;.00nan;0;0
2422;34639;59;0;0;0;0;.00nan;0;0
2423;262;43;0;0;0;0;.00nan;0;0
2423;907;39;0;0;0;0;.00nan;0;0
2423;3625;43;97;33;1;32;.970;3600000;0
2423;9238;39;42;24;4;20;.833;3600000;0
2424;6081;56;31;30;6;24;.800;3600000;0
2424;26824;56;0;0;0;0;.00nan;0;0
2424;26967;63;99;42;1;41;.976;3600000;0
2424;34814;63;0;0;0;0;.00nan;0;0
2425;4447;54;75;25;1;24;.960;3600000;0
2425;5883;37;82;41;3;38;.927;3548000;0
2425;23043;37;0;0;0;0;.00nan;0;0
2425;31643;54;0;0;0;0;.00nan;0;0
2426;323;46;65;32;4;28;.875;3600000;0
2426;5146;64;91;40;2;38;.950;3600000;0
2426;14323;64;0;0;0;0;.00nan;0;0
2426;35622;46;0;0;0;0;.00nan;0;0
2427;4338;65;81;38;3;35;.921;3585000;0
2427;4987;65;0;0;0;0;.00nan;0;0
2427;6062;36;60;17;2;15;.882;3600000;0
2427;14874;36;0;0;0;0;.00nan;0;0
2428;3;50;54;8;1;7;.875;1101000;0
2428;1098;42;0;0;0;0;.00nan;0;0
2428;5048;50;24;26;6;20;.769;2499000;0
2428;37416;42;63;26;3;23;.885;3600000;0
2429;3626;48;82;39;3;36;.923;3591000;0
2429;20717;60;0;0;0;0;.00nan;0;0
2429;35536;60;71;26;2;24;.923;3600000;0
2429;38547;48;0;0;0;0;.00nan;0;0
2925;376;45;84;35;2;33;.943;3600000;0
2925;2198;45;0;0;0;0;.00nan;0;0
2925;3847;38;0;0;0;0;.00nan;0;0
2925;31021;38;38;18;4;14;.778;3541000;0
2927;780;52;0;0;0;0;.00nan;0;0
2927;3626;48;0;0;0;0;.00nan;0;0
2927;23255;52;81;27;1;26;.963;3600000;0
2927;38547;48;72;31;3;28;.903;3545000;0
2929;1486;43;44;25;5;20;.800;3600000;0
2929;3625;43;0;0;0;0;.00nan;0;0
2929;6081;56;0;0;0;0;.00nan;0;0
2929;26824;56;73;33;2;31;.939;3600000;0
2931;3;50;0;0;0;0;.00nan;0;0
2931;2900;36;86;30;1;29;.967;3600000;0
2931;5048;50;56;28;4;24;.857;3600000;0
2931;14874;36;0;0;0;0;.00nan;0;0
2933;4338;65;0;0;0;0;.00nan;0;0
2933;4987;65;100;28;0;28;1.000;3600000;0
2933;14351;40;0;0;0;0;.00nan;0;0
2933;26840;40;94;46;3;43;.935;3600000;0
2935;1592;63;73;24;2;22;.917;3600000;0
2935;8046;57;52;34;5;29;.853;3600000;0
2935;26865;57;0;0;0;0;.00nan;0;0
2935;26967;63;0;0;0;0;.00nan;0;0
2937;2163;39;0;0;0;0;.00nan;0;0
2937;9238;39;68;31;3;28;.903;3600000;0
2937;34788;42;61;33;4;29;.879;3598000;0
2937;37416;42;0;0;0;0;.00nan;0;0
2939;2016;61;40;26;6;20;.769;3679000;0
2939;4447;54;43;31;5;26;.839;3679000;0
2939;30971;61;0;0;0;0;.00nan;0;0
2939;31643;54;0;0;0;0;.00nan;0;0
2941;2796;59;0;0;0;0;.00nan;0;0
2941;28772;53;0;0;0;0;.00nan;0;0
2941;31156;53;69;38;4;34;.895;3600000;0
2941;31858;59;28;26;6;20;.769;3563000;0
2943;2296;37;0;0;0;0;.00nan;0;0
2943;4716;4619;48;23;4;19;.826;3530000;0
2943;5883;37;58;19;2;17;.895;3600000;0
2943;35210;4619;0;0;0;0;.00nan;0;0
2945;37;46;0;0;0;0;.00nan;0;0
2945;23493;51;0;0;0;0;.00nan;0;0
2945;26929;46;81;32;2;30;.938;3600000;0
2945;31822;51;69;30;3;27;.900;3553000;0
2947;2152;49;35;30;6;24;.800;3600000;0
2947;4435;49;0;0;0;0;.00nan;0;0
2947;5146;64;0;0;0;0;.00nan;0;0
2947;28845;64;78;29;2;27;.931;3600000;0
2949;7049;47;71;24;2;22;.917;3552000;0
2949;19640;41;81;28;1;27;.964;3600000;0
2949;23075;41;0;0;0;0;.00nan;0;0
2949;33654;47;0;0;0;0;.00nan;0;0
2951;5298;55;88;45;3;42;.933;3600000;0
2951;6572;62;50;29;4;25;.862;3545000;0
2951;26919;62;0;0;0;0;.00nan;0;0
2951;34770;55;0;0;0;0;.00nan;0;0
2953;5137;58;0;0;0;0;.00nan;0;0
2953;14321;58;73;35;3;32;.914;3900000;0
2953;20717;60;0;0;0;0;.00nan;0;0
2953;35536;60;56;18;3;15;.833;3866000;0
2955;2163;39;0;0;0;0;.00nan;0;0
2955;2796;59;48;25;3;22;.880;1637000;0
2955;9238;39;31;30;5;25;.833;3600000;0
2955;31858;59;21;27;7;20;.741;1963000;0
2957;3626;48;92;33;2;31;.939;3900000;0
2957;20717;60;74;26;2;24;.923;3900000;0
2957;35536;60;0;0;0;0;.00nan;0;0
2957;38547;48;0;0;0;0;.00nan;0;0
2959;6572;62;73;37;3;34;.919;3871000;0
2959;7049;47;0;0;0;0;.00nan;0;0
2959;26919;62;0;0;0;0;.00nan;0;0
2959;33654;47;68;36;4;32;.889;3871000;0
2961;780;52;94;34;2;32;.941;3600000;0
2961;23255;52;0;0;0;0;.00nan;0;0
2961;34788;42;0;0;0;0;.00nan;0;0
2961;37416;42;34;30;6;24;.800;3600000;0
2963;37;46;48;25;4;21;.840;3600000;0
2963;6081;56;74;27;1;26;.963;3600000;0
2963;26824;56;0;0;0;0;.00nan;0;0
2963;26929;46;0;0;0;0;.00nan;0;0
2965;376;45;61;41;5;36;.878;3580000;0
2965;2198;45;0;0;0;0;.00nan;0;0
2965;19640;41;0;0;0;0;.00nan;0;0
2965;23075;41;63;35;4;31;.886;3600000;0
2967;1051;44;0;0;0;0;.00nan;0;0
2967;2900;36;53;16;2;14;.875;3600000;0
2967;3281;44;94;50;3;47;.940;3553000;0
2967;14874;36;0;0;0;0;.00nan;0;0
2969;3;50;39;36;6;30;.833;3524000;0
2969;5048;50;0;0;0;0;.00nan;0;0
2969;5883;37;65;36;4;32;.889;3600000;0
2969;23043;37;0;0;0;0;.00nan;0;0
2971;4338;65;0;0;0;0;.00nan;0;0
2971;4987;65;61;26;3;23;.885;3600000;0
2971;28772;53;0;0;0;0;.00nan;0;0
2971;31156;53;82;40;2;38;.950;3600000;0
2973;1486;43;0;0;0;0;.00nan;0;0
2973;3625;43;80;22;1;21;.955;3900000;0
2973;4716;4619;0;0;0;0;.00nan;0;0
2973;35210;4619;93;34;1;33;.971;3900000;0
2975;5146;64;0;0;0;0;.00nan;0;0
2975;8046;57;69;36;3;33;.917;3900000;0
2975;26865;57;0;0;0;0;.00nan;0;0
2975;28845;64;73;38;3;35;.921;3900000;0
2977;2016;61;0;0;0;0;.00nan;0;0
2977;14351;40;94;44;2;42;.955;3872000;0
2977;26840;40;0;0;0;0;.00nan;0;0
2977;30971;61;82;21;1;20;.952;3872000;0
2979;4447;54;0;0;0;0;.00nan;0;0
2979;5137;58;0;0;0;0;.00nan;0;0
2979;14321;58;74;25;1;24;.960;3600000;0
2979;31643;54;84;32;2;30;.938;3553000;0
2981;1592;63;63;25;3;22;.880;3526000;0
2981;23493;51;73;21;1;20;.952;3600000;0
2981;26967;63;0;0;0;0;.00nan;0;0
2981;31822;51;0;0;0;0;.00nan;0;0
2983;2152;49;60;26;3;23;.885;3544000;0
2983;4435;49;0;0;0;0;.00nan;0;0
2983;5298;55;78;31;2;29;.935;3600000;0
2983;34770;55;0;0;0;0;.00nan;0;0
2985;780;52;0;0;0;0;.00nan;0;0
2985;4447;54;74;31;1;30;.968;3600000;0
2985;23255;52;83;36;2;34;.944;3575000;0
2985;31643;54;0;0;0;0;.00nan;0;0
2987;5298;55;0;0;0;0;.00nan;0;0
2987;5883;37;0;0;0;0;.00nan;0;0
2987;23043;37;71;35;3;32;.914;3600000;0
2987;34770;55;53;29;4;25;.862;3559000;0
2989;37;46;0;0;0;0;.00nan;0;0
2989;20717;60;0;0;0;0;.00nan;0;0
2989;26929;46;44;29;5;24;.828;3600000;0
2989;35536;60;100;32;0;32;1.000;3600000;0
2991;2900;36;0;0;0;0;.00nan;0;0
2991;3626;48;0;0;0;0;.00nan;0;0
2991;14874;36;82;28;2;26;.929;3600000;0
2991;38547;48;69;34;3;31;.912;3559000;0
2993;2796;59;0;0;0;0;.00nan;0;0
2993;31858;59;76;33;2;31;.939;3600000;0
2993;34788;42;74;36;3;33;.917;3600000;0
2993;37416;42;0;0;0;0;.00nan;0;0
2995;1051;44;66;35;4;31;.886;3562000;0
2995;3281;44;0;0;0;0;.00nan;0;0
2995;23493;51;0;0;0;0;.00nan;0;0
2995;31822;51;78;34;2;32;.941;3600000;0
2997;1668;57;0;0;0;0;.00nan;0;0
2997;2152;49;0;0;0;0;.00nan;0;0
2997;4435;49;74;34;3;31;.912;3600000;0
2997;26865;57;49;30;4;26;.867;3543000;0
2999;4338;65;96;32;1;31;.969;3900000;0
2999;4987;65;0;0;0;0;.00nan;0;0
2999;6081;56;0;0;0;0;.00nan;0;0
2999;26824;56;100;40;1;39;.975;3900000;0
3001;1592;63;0;0;0;0;.00nan;0;0
3001;5137;58;48;26;4;22;.846;3547000;0
3001;14321;58;0;0;0;0;.00nan;0;0
3001;26967;63;80;28;2;26;.929;3600000;0
3003;6572;62;0;0;0;0;.00nan;0;0
3003;26919;62;71;50;6;44;.880;3600000;0
3003;28772;53;57;30;3;27;.900;3600000;0
3003;31156;53;0;0;0;0;.00nan;0;0
3005;3847;38;0;0;0;0;.00nan;0;0
3005;14351;40;0;0;0;0;.00nan;0;0
3005;26840;40;76;31;2;29;.935;3600000;0
3005;31021;38;42;24;4;20;.833;3550000;0
3007;376;45;0;0;0;0;.00nan;0;0
3007;2016;61;61;32;4;28;.875;3600000;0
3007;2198;45;66;32;3;29;.906;3600000;0
3007;30971;61;0;0;0;0;.00nan;0;0
3009;3;50;0;0;0;0;.00nan;0;0
3009;2163;39;83;26;2;24;.923;3632000;0
3009;5048;50;92;38;3;35;.921;3632000;0
3009;9238;39;0;0;0;0;.00nan;0;0
3011;7049;47;55;50;6;44;.880;3600000;0
3011;19640;41;61;27;3;24;.889;3600000;0
3011;23075;41;0;0;0;0;.00nan;0;0
3011;33654;47;0;0;0;0;.00nan;0;0
3013;1486;43;55;38;5;33;.868;3589000;0
3013;3625;43;0;0;0;0;.00nan;0;0
3013;4716;4619;57;23;3;20;.870;3600000;0
3013;35210;4619;0;0;0;0;.00nan;0;0
3015;37;46;62;37;4;33;.892;3541000;0
3015;6081;56;56;27;3;24;.889;3600000;0
3015;26824;56;0;0;0;0;.00nan;0;0
3015;26929;46;0;0;0;0;.00nan;0;0
3017;4338;65;0;0;0;0;.00nan;0;0
3017;4987;65;77;22;1;21;.955;3600000;0
3017;28772;53;0;0;0;0;.00nan;0;0
3017;31156;53;72;33;2;31;.939;3562000;0
3019;3;50;65;19;2;17;.895;3600000;0
3019;5048;50;0;0;0;0;.00nan;0;0
3019;7049;47;57;33;4;29;.879;3581000;0
3019;33654;47;0;0;0;0;.00nan;0;0
3021;1486;43;0;0;0;0;.00nan;0;0
3021;1668;57;63;29;3;26;.897;3582000;0
3021;3625;43;73;32;2;30;.938;3600000;0
3021;26865;57;0;0;0;0;.00nan;0;0
3023;2016;61;0;0;0;0;.00nan;0;0
3023;4447;54;48;33;6;27;.818;3249000;0
3023;30971;61;51;29;4;25;.862;3600000;0
3023;31643;54;48;0;0;0;.00nan;265000;0
3025;5298;55;86;30;1;29;.967;3600000;0
3025;20717;60;0;0;0;0;.00nan;0;0
3025;34770;55;0;0;0;0;.00nan;0;0
3025;35536;60;58;32;3;29;.906;3572000;0
3027;4716;4619;0;0;0;0;.00nan;0;0
3027;5883;37;82;44;4;40;.909;3742000;0
3027;23043;37;0;0;0;0;.00nan;0;0
3027;35210;4619;63;36;3;33;.917;3742000;0
3029;2152;49;58;26;3;23;.885;3600000;0
3029;4435;49;0;0;0;0;.00nan;0;0
3029;6572;62;100;29;0;29;1.000;3600000;0
3029;26919;62;0;0;0;0;.00nan;0;0
3031;3626;48;72;29;2;27;.931;3732000;0
3031;14351;40;43;15;3;12;.800;3767000;0
3031;26840;40;0;0;0;0;.00nan;0;0
3031;38547;48;0;0;0;0;.00nan;0;0
3033;5137;58;0;0;0;0;.00nan;0;0
3033;14321;58;79;14;0;14;1.000;3600000;0
3033;23493;51;61;36;4;32;.889;3600000;0
3033;31822;51;0;0;0;0;.00nan;0;0
3035;376;45;0;0;0;0;.00nan;0;0
3035;2198;45;64;29;3;26;.897;3562000;0
3035;2900;36;71;27;2;25;.926;3600000;0
3035;14874;36;0;0;0;0;.00nan;0;0
3037;780;52;0;0;0;0;.00nan;0;0
3037;2163;39;0;0;0;0;.00nan;0;0
3037;9238;39;83;29;1;28;.966;3600000;0
3037;23255;52;72;28;2;26;.929;3588000;0
3039;1592;63;58;43;5;38;.884;3549000;0
3039;5146;64;79;41;4;37;.902;3600000;0
3039;26967;63;0;0;0;0;.00nan;0;0
3039;28845;64;0;0;0;0;.00nan;0;0
3041;1051;44;0;0;0;0;.00nan;0;0
3041;2796;59;0;0;0;0;.00nan;0;0
3041;3281;44;99;35;1;34;.971;3600000;0
3041;31858;59;76;33;3;30;.909;3581000;0
3043;19640;41;0;0;0;0;.00nan;0;0
3043;23075;41;92;44;3;41;.932;3625000;0
3043;34788;42;61;23;2;21;.913;3625000;0
3043;37416;42;0;0;0;0;.00nan;0;0
3045;780;52;67;34;3;31;.912;3600000;0
3045;4447;54;0;0;0;0;.00nan;0;0
3045;23255;52;0;0;0;0;.00nan;0;0
3045;31643;54;62;29;4;25;.862;3554000;0
3047;376;45;48;29;5;24;.828;3600000;0
3047;2198;45;0;0;0;0;.00nan;0;0
3047;28772;53;73;25;1;24;.960;3600000;0
3047;31156;53;0;0;0;0;.00nan;0;0
3049;14351;40;0;0;0;0;.00nan;0;0
3049;23493;51;0;0;0;0;.00nan;0;0
3049;26840;40;89;34;1;33;.971;3568000;0
3049;31822;51;99;27;0;27;1.000;3600000;0
3051;2152;49;0;0;0;0;.00nan;0;0
3051;4435;49;60;28;3;25;.893;3600000;0
3051;5883;37;0;0;0;0;.00nan;0;0
3051;23043;37;57;35;5;30;.857;3575000;0
3053;1668;57;0;0;0;0;.00nan;0;0
3053;19640;41;25;29;6;23;.793;3600000;0
3053;23075;41;0;0;0;0;.00nan;0;0
3053;26865;57;59;32;4;28;.875;3600000;0
3055;4716;4619;30;32;6;26;.813;3324000;0
3055;5146;64;0;0;0;0;.00nan;0;0
3055;28845;64;64;30;3;27;.900;3600000;0
3055;35210;4619;58;6;0;6;1.000;276000;0
3057;5137;58;0;0;0;0;.00nan;0;0
3057;5298;55;0;0;0;0;.00nan;0;0
3057;14321;58;57;28;3;25;.893;3591000;0
3057;34770;55;67;27;2;25;.926;3600000;0
3059;3;50;0;0;0;0;.00nan;0;0
3059;2796;59;93;32;1;31;.969;3600000;0
3059;5048;50;63;32;4;28;.875;3600000;0
3059;31858;59;0;0;0;0;.00nan;0;0
3061;1051;44;25;31;7;24;.774;3335000;0
3061;3281;44;50;2;0;2;1.000;265000;0
3061;3626;48;0;0;0;0;.00nan;0;0
3061;38547;48;59;38;4;34;.895;3600000;0
3063;3847;38;0;0;0;0;.00nan;0;0
3063;4338;65;89;43;3;40;.930;3900000;0
3063;4987;65;0;0;0;0;.00nan;0;0
3063;31021;38;57;31;3;28;.903;3876000;0
3065;2016;61;85;35;2;33;.943;3514000;0
3065;30971;61;0;0;0;0;.00nan;0;0
3065;34788;42;0;0;0;0;.00nan;0;0
3065;37416;42;100;31;0;31;1.000;3600000;0
3067;1486;43;18;23;6;17;.739;1983000;0
3067;2163;39;54;26;4;22;.846;3600000;0
3067;3625;43;60;8;0;8;1.000;1608000;0
3067;9238;39;0;0;0;0;.00nan;0;0
3069;37;46;0;0;0;0;.00nan;0;0
3069;6081;56;0;0;0;0;.00nan;0;0
3069;26824;56;40;18;3;15;.833;3600000;0
3069;26929;46;63;40;4;36;.900;3562000;0
3071;1592;63;0;0;0;0;.00nan;0;0
3071;6572;62;0;0;0;0;.00nan;0;0
3071;26919;62;66;25;2;23;.920;3575000;0
3071;26967;63;78;22;1;21;.955;3600000;0
3073;2900;36;0;0;0;0;.00nan;0;0
3073;14874;36;64;28;3;25;.893;3578000;0
3073;20717;60;77;27;1;26;.963;3600000;0
3073;35536;60;0;0;0;0;.00nan;0;0
3075;3;50;36;26;6;20;.769;3692000;0
3075;3847;38;43;3;1;2;.667;429000;0
3075;5048;50;0;0;0;0;.00nan;0;0
3075;31021;38;41;30;6;24;.800;3225000;0
3077;3533;57;0;0;0;0;.00nan;0;0
3077;5883;37;64;25;2;23;.920;3545000;0
3077;23043;37;0;0;0;0;.00nan;0;0
3077;26865;57;99;35;1;34;.971;3600000;0
3079;6572;62;76;29;2;27;.931;3600000;0
3079;26919;62;0;0;0;0;.00nan;0;0
3079;34788;42;0;0;0;0;.00nan;0;0
3079;37416;42;62;30;3;27;.900;3569000;0
3081;2016;61;0;0;0;0;.00nan;0;0
3081;14351;40;60;18;2;16;.889;3589000;0
3081;26840;40;0;0;0;0;.00nan;0;0
3081;30971;61;100;32;1;31;.969;3600000;0
3083;37;46;0;0;0;0;.00nan;0;0
3083;1592;63;54;36;5;31;.861;3900000;0
3083;26929;46;66;42;5;37;.881;3900000;0
3083;26967;63;0;0;0;0;.00nan;0;0
3085;5298;55;43;32;5;27;.844;3600000;0
3085;19640;41;0;0;0;0;.00nan;0;0
3085;23075;41;87;37;2;35;.946;3600000;0
3085;34770;55;0;0;0;0;.00nan;0;0
3087;1486;43;84;42;3;39;.929;3900000;0
3087;3625;43;0;0;0;0;.00nan;0;0
3087;4716;4619;0;0;0;0;.00nan;0;0
3087;35210;4619;66;26;3;23;.885;3900000;0
3089;2163;39;0;0;0;0;.00nan;0;0
3089;7049;47;42;19;4;15;.789;3600000;0
3089;9238;39;81;28;1;27;.964;3600000;0
3089;33654;47;0;0;0;0;.00nan;0;0
3091;2796;59;0;0;0;0;.00nan;0;0
3091;14323;64;67;34;4;30;.882;3600000;0
3091;28845;64;0;0;0;0;.00nan;0;0
3091;31858;59;91;28;1;27;.964;3600000;0
3093;376;45;0;0;0;0;.00nan;0;0
3093;2198;45;76;32;2;30;.938;3579000;0
3093;4447;54;75;25;1;24;.960;3600000;0
3093;31643;54;0;0;0;0;.00nan;0;0
3095;1051;44;0;0;0;0;.00nan;0;0
3095;3281;44;69;32;4;28;.875;3552000;0
3095;20717;60;0;0;0;0;.00nan;0;0
3095;35536;60;51;17;2;15;.882;3600000;0
3097;3626;48;0;0;0;0;.00nan;0;0
3097;6081;56;59;22;3;19;.864;3600000;0
3097;26824;56;0;0;0;0;.00nan;0;0
3097;38547;48;73;48;4;44;.917;3600000;0
3099;5137;58;0;0;0;0;.00nan;0;0
3099;14321;58;74;29;2;27;.931;3572000;0
3099;28772;53;0;0;0;0;.00nan;0;0
3099;31156;53;100;27;0;27;1.000;3600000;0
3101;780;52;0;0;0;0;.00nan;0;0
3101;2152;49;74;39;4;35;.897;3900000;0
3101;4435;49;0;0;0;0;.00nan;0;0
3101;23255;52;67;35;4;31;.886;3900000;0
3103;714;51;0;0;0;0;.00nan;0;0
3103;4338;65;0;0;0;0;.00nan;0;0
3103;4987;65;64;38;4;34;.895;3523000;0
3103;23493;51;72;28;2;26;.929;3600000;0
3105;34815;45;33;14;3;11;.786;1720000;0
3105;34819;59;0;0;0;0;.00nan;0;0
3105;35538;59;44;18;3;15;.833;3600000;0
3105;36703;45;49;32;4;28;.875;1880000;0
3107;6572;62;0;0;0;0;.00nan;0;0
3107;14874;36;60;28;3;25;.893;3600000;0
3107;26919;62;25;26;6;20;.769;3600000;0
3107;42825;36;0;0;0;0;.00nan;0;0
3109;3533;57;86;29;2;27;.931;3600000;0
3109;26865;57;0;0;0;0;.00nan;0;0
3109;26967;63;82;38;3;35;.921;3600000;0
3109;31433;63;0;0;0;0;.00nan;0;0
3111;37;46;66;23;3;20;.870;3900000;0
3111;23255;52;77;39;3;36;.923;3900000;0
3111;26929;46;0;0;0;0;.00nan;0;0
3111;31126;52;0;0;0;0;.00nan;0;0
3113;5883;37;0;0;0;0;.00nan;0;0
3113;23043;37;60;30;3;27;.900;3577000;0
3113;23075;41;85;31;2;29;.935;3600000;0
3113;51213;41;0;0;0;0;.00nan;0;0
3115;3;50;75;28;2;26;.929;3600000;0
3115;4447;54;0;0;0;0;.00nan;0;0
3115;5571;50;0;0;0;0;.00nan;0;0
3115;35595;54;31;34;7;27;.794;3600000;0
3117;3281;44;0;0;0;0;.00nan;0;0
3117;31545;44;60;26;3;23;.885;3539000;0
3117;34788;42;85;27;1;26;.963;3600000;0
3117;37416;42;0;0;0;0;.00nan;0;0
3119;3626;48;82;31;2;29;.935;3600000;0
3119;20717;60;67;18;1;17;.944;3600000;0
3119;35536;60;0;0;0;0;.00nan;0;0
3119;38547;48;0;0;0;0;.00nan;0;0
3121;4435;49;46;27;4;23;.852;3600000;0
3121;28772;53;0;0;0;0;.00nan;0;0
3121;31156;53;63;14;1;13;.929;3600000;0
3121;38817;49;0;0;0;0;.00nan;0;0
3123;5298;55;0;0;0;0;.00nan;0;0
3123;6081;56;0;0;0;0;.00nan;0;0
3123;26824;56;71;32;2;30;.938;3900000;0
3123;34770;55;85;28;2;26;.929;3900000;0
3125;351;61;0;0;0;0;.00nan;0;0
3125;4716;4619;63;30;3;27;.900;3579000;0
3125;30971;61;71;23;1;22;.957;3600000;0
3125;35210;4619;0;0;0;0;.00nan;0;0
3127;9238;39;53;29;4;25;.862;3600000;0
3127;21469;39;0;0;0;0;.00nan;0;0
3127;22970;38;0;0;0;0;.00nan;0;0
3127;31021;38;41;31;5;26;.839;3547000;0
3129;14321;58;0;0;0;0;.00nan;0;0
3129;14323;64;0;0;0;0;.00nan;0;0
3129;26622;58;99;42;2;40;.952;3600000;0
3129;28845;64;75;35;3;32;.914;3555000;0
3131;7049;47;0;0;0;0;.00nan;0;0
3131;33654;47;75;27;2;25;.926;3600000;0
3131;33661;65;0;0;0;0;.00nan;0;0
3131;40296;65;85;57;5;52;.912;3600000;0
3133;714;51;0;0;0;0;.00nan;0;0
3133;7523;40;93;41;3;38;.927;3546000;0
3133;14351;40;0;0;0;0;.00nan;0;0
3133;31408;51;64;23;2;21;.913;3600000;0
