Game Id;PlayerId;TeamId;Game Rating;SA;GA;SV;SV%;TOI;PIM
0;233;29;72;37;3;34;.919;3900000;0
0;2423;15;0;0;0;0;.00nan;0;0
0;4106;15;67;33;3;30;.909;3900000;0
0;18351;29;0;0;0;0;.00nan;0;0
1;500;4182;41;27;5;22;.815;3600000;0
1;1572;4838;57;44;7;37;.841;3529000;0
1;2328;4838;0;0;0;0;.00nan;0;0
1;25521;4182;0;0;0;0;.00nan;0;0
2;1074;0;0;0;0;0;.00nan;0;0
2;1821;3;59;24;3;21;.875;3600000;0
2;2054;3;0;0;0;0;.00nan;0;0
2;31035;0;76;44;5;39;.886;3560000;0
3;18104;10;0;0;0;0;.00nan;0;0
3;27488;10;57;34;4;30;.882;3871000;0
3;27739;22;76;48;5;43;.896;3871000;0
3;28026;22;0;0;0;0;.00nan;0;0
4;1614;25;80;26;1;25;.962;3600000;0
4;5182;25;0;0;0;0;.00nan;0;0
4;15505;8;73;28;2;26;.929;3557000;0
4;25076;8;0;0;0;0;.00nan;0;0
5;335;18;60;44;5;39;.886;3900000;0
5;823;23;46;33;5;28;.848;3900000;0
5;5001;18;0;0;0;0;.00nan;0;0
5;10274;23;0;0;0;0;.00nan;0;0
6;1074;0;84;45;3;42;.933;3600000;0
6;5385;17;72;12;0;12;1.000;1443000;0
6;31035;0;0;0;0;0;.00nan;0;0
6;34006;17;19;26;7;19;.731;2157000;0
7;1821;3;0;0;0;0;.00nan;0;0
7;2054;3;83;26;1;25;.962;3585000;0
7;2058;28;100;41;0;41;1.000;3600000;0
7;14061;28;0;0;0;0;.00nan;0;0
8;233;29;64;26;3;23;.885;3900000;0
8;323;9;100;64;3;61;.953;3900000;0
8;18351;29;0;0;0;0;.00nan;0;0
8;20853;9;0;0;0;0;.00nan;0;0
9;61;31;0;0;0;0;.00nan;0;0
9;2423;15;49;29;4;25;.862;3600000;0
9;4106;15;0;0;0;0;.00nan;0;0
9;34797;31;95;35;1;34;.971;3600000;0
10;445;12;54;35;5;30;.857;3600000;0
10;18104;10;37;36;6;30;.833;3570000;0
10;27488;10;0;0;0;0;.00nan;0;0
10;34786;12;0;0;0;0;.00nan;0;0
11;10103;24;0;0;0;0;.00nan;0;0
11;13979;24;67;33;3;30;.909;3562000;0
11;18078;20;77;27;2;25;.926;3600000;0
11;32146;20;0;0;0;0;.00nan;0;0
12;13842;34;0;0;0;0;.00nan;0;0
12;15502;34;77;37;3;34;.919;3694000;0
12;22601;26;0;0;0;0;.00nan;0;0
12;32754;26;84;38;2;36;.947;3694000;0
13;1572;4838;65;33;3;30;.909;3900000;0
13;2328;4838;0;0;0;0;.00nan;0;0
13;15464;32;68;26;3;23;.885;3900000;0
13;16006;32;0;0;0;0;.00nan;0;0
14;1913;30;45;44;7;37;.841;3600000;0
14;4506;33;88;16;0;16;1.000;3600000;0
14;4826;30;0;0;0;0;.00nan;0;0
14;34740;33;0;0;0;0;.00nan;0;0
15;500;4182;0;0;0;0;.00nan;0;0
15;724;11;73;27;3;24;.889;3779000;0
15;21522;11;0;0;0;0;.00nan;0;0
15;25521;4182;76;34;2;32;.941;3779000;0
16;51;21;43;27;5;22;.815;3600000;0
16;15505;8;0;0;0;0;.00nan;0;0
16;25076;8;88;21;0;21;1.000;3600000;0
16;25843;21;0;0;0;0;.00nan;0;0
17;335;18;0;0;0;0;.00nan;0;0
17;1251;14;0;0;0;0;.00nan;0;0
17;5001;18;68;25;3;22;.880;3600000;0
17;25584;14;49;37;5;32;.865;3582000;0
18;262;35;75;28;2;26;.929;3600000;0
18;1430;35;0;0;0;0;.00nan;0;0
18;1913;30;0;0;0;0;.00nan;0;0
18;4826;30;77;24;1;23;.958;3600000;0
19;445;12;100;37;1;36;.973;3600000;0
19;4450;5;46;23;4;19;.826;3600000;0
19;19823;5;0;0;0;0;.00nan;0;0
19;34786;12;0;0;0;0;.00nan;0;0
20;5385;17;0;0;0;0;.00nan;0;0
20;22601;26;72;37;3;34;.919;3600000;0
20;32754;26;0;0;0;0;.00nan;0;0
20;34006;17;62;20;2;18;.900;3600000;0
21;1821;3;100;30;0;30;1.000;3600000;0
21;2054;3;0;0;0;0;.00nan;0;0
21;2058;28;43;31;5;26;.839;3600000;0
21;14061;28;0;0;0;0;.00nan;0;0
22;1074;0;86;37;2;35;.946;3600000;0
22;18104;10;45;35;5;30;.857;3600000;0
22;27488;10;0;0;0;0;.00nan;0;0
22;31035;0;0;0;0;0;.00nan;0;0
23;323;9;0;0;0;0;.00nan;0;0
23;335;18;51;15;2;13;.867;3600000;0
23;5001;18;0;0;0;0;.00nan;0;0
23;20853;9;98;63;4;59;.937;3566000;0
24;61;31;55;21;3;18;.857;3900000;0
24;18078;20;74;34;3;31;.912;3900000;0
24;32146;20;0;0;0;0;.00nan;0;0
24;34797;31;0;0;0;0;.00nan;0;0
25;2423;15;0;0;0;0;.00nan;0;0
25;4106;15;71;30;2;28;.933;3600000;0
25;15505;8;61;36;4;32;.889;3579000;0
25;25076;8;0;0;0;0;.00nan;0;0
26;233;29;0;0;0;0;.00nan;0;0
26;18351;29;100;34;1;33;.971;3600000;0
26;27739;22;0;0;0;0;.00nan;0;0
26;28026;22;55;25;4;21;.840;3600000;0
27;1572;4838;56;33;4;29;.879;3545000;0
27;2328;4838;0;0;0;0;.00nan;0;0
27;13842;34;51;24;3;21;.875;3600000;0
27;15502;34;0;0;0;0;.00nan;0;0
28;10103;24;0;0;0;0;.00nan;0;0
28;13979;24;85;40;3;37;.925;3600000;0
28;15464;32;49;24;4;20;.833;3600000;0
28;16006;32;0;0;0;0;.00nan;0;0
29;1614;25;67;37;4;33;.892;3600000;0
29;1796;16;23;28;6;22;.786;3524000;0
29;5182;25;0;0;0;0;.00nan;0;0
29;15437;16;0;0;0;0;.00nan;0;0
30;544;19;73;31;3;28;.903;3568000;0
30;823;23;0;0;0;0;.00nan;0;0
30;10274;23;94;36;2;34;.944;3600000;0
30;31124;19;0;0;0;0;.00nan;0;0
31;262;35;96;28;1;27;.964;3600000;0
31;724;11;0;0;0;0;.00nan;0;0
31;1430;35;0;0;0;0;.00nan;0;0
31;21522;11;65;31;3;28;.903;3526000;0
32;738;27;0;0;0;0;.00nan;0;0
32;4506;33;100;41;1;40;.976;3880000;0
32;26623;27;85;37;2;35;.946;3880000;0
32;34740;33;0;0;0;0;.00nan;0;0
33;445;12;62;18;1;17;.944;2627000;0
33;2058;28;63;30;4;26;.867;3600000;0
33;14061;28;0;0;0;0;.00nan;0;0
33;34786;12;27;13;4;9;.692;928000;0
34;1821;3;52;20;3;17;.850;3579000;0
34;2054;3;0;0;0;0;.00nan;0;0
34;18104;10;99;48;2;46;.958;3600000;0
34;27488;10;0;0;0;0;.00nan;0;0
35;1251;14;0;0;0;0;.00nan;0;0
35;1572;4838;71;33;3;30;.909;3600000;0
35;2328;4838;0;0;0;0;.00nan;0;0
35;25584;14;69;27;2;25;.926;3600000;0
36;544;19;0;0;0;0;.00nan;0;0
36;1913;30;100;48;2;46;.958;3900000;0
36;4826;30;0;0;0;0;.00nan;0;0
36;31124;19;75;25;2;23;.920;3900000;0
37;1796;16;58;33;4;29;.879;3514000;0
37;15437;16;0;0;0;0;.00nan;0;0
37;22601;26;0;0;0;0;.00nan;0;0
37;32754;26;87;35;2;33;.943;3600000;0
38;335;18;0;0;0;0;.00nan;0;0
38;5001;18;78;37;3;34;.919;3600000;0
38;5385;17;0;0;0;0;.00nan;0;0
38;34006;17;96;32;0;32;1.000;3600000;0
39;738;27;76;37;3;34;.919;3899000;0
39;1074;0;71;37;3;34;.919;3900000;0
39;26623;27;0;0;0;0;.00nan;0;0
39;31035;0;0;0;0;0;.00nan;0;0
40;323;9;66;24;2;22;.917;3600000;0
40;13842;34;0;0;0;0;.00nan;0;0
40;15502;34;60;23;3;20;.870;3592000;0
40;20853;9;0;0;0;0;.00nan;0;0
41;61;31;0;0;0;0;.00nan;0;0
41;233;29;77;26;1;25;.962;3600000;0
41;18351;29;0;0;0;0;.00nan;0;0
41;34797;31;70;31;2;29;.935;3561000;0
42;51;21;56;26;3;23;.885;3600000;0
42;1572;4838;0;0;0;0;.00nan;0;0
42;2328;4838;70;22;1;21;.955;3600000;0
42;25843;21;0;0;0;0;.00nan;0;0
43;445;12;0;0;0;0;.00nan;0;0
43;2423;15;0;0;0;0;.00nan;0;0
43;4106;15;60;27;3;24;.889;3613000;0
43;34786;12;95;43;2;41;.953;3613000;0
44;1614;25;61;49;6;43;.878;3600000;0
44;5182;25;0;0;0;0;.00nan;0;0
44;27739;22;0;0;0;0;.00nan;0;0
44;28026;22;69;26;2;24;.923;3600000;0
45;15505;8;52;3;0;3;1.000;656000;0
45;18078;20;65;23;2;21;.913;3600000;0
45;25076;8;31;29;6;23;.793;2944000;0
45;32146;20;0;0;0;0;.00nan;0;0
46;724;11;37;27;5;22;.815;3899000;0
46;15464;32;0;0;0;0;.00nan;0;0
46;16006;32;75;44;4;40;.909;3893000;0
46;21522;11;0;0;0;0;.00nan;0;0
47;262;35;59;26;3;23;.885;3586000;0
47;1430;35;0;0;0;0;.00nan;0;0
47;4506;33;100;27;0;27;1.000;3600000;0
47;34740;33;0;0;0;0;.00nan;0;0
48;823;23;48;24;4;20;.833;3600000;0
48;1913;30;0;0;0;0;.00nan;0;0
48;4826;30;45;50;8;42;.840;3600000;0
48;10274;23;0;0;0;0;.00nan;0;0
49;1251;14;17;23;6;17;.739;1863000;0
49;4450;5;82;25;2;23;.920;3600000;0
49;19823;5;0;0;0;0;.00nan;0;0
49;25584;14;59;18;2;16;.889;1737000;0
50;500;4182;95;32;1;31;.969;3600000;0
50;1796;16;63;33;3;30;.909;3534000;0
50;15437;16;0;0;0;0;.00nan;0;0
50;25521;4182;0;0;0;0;.00nan;0;0
51;1074;0;0;0;0;0;.00nan;0;0
51;10103;24;70;36;4;32;.889;3600000;0
51;13979;24;0;0;0;0;.00nan;0;0
51;31035;0;100;40;0;40;1.000;3600000;0
52;738;27;68;28;2;26;.929;3547000;0
52;2058;28;89;27;1;26;.963;3600000;0
52;14061;28;0;0;0;0;.00nan;0;0
52;26623;27;0;0;0;0;.00nan;0;0
53;323;9;100;35;0;35;1.000;3600000;0
53;544;19;0;0;0;0;.00nan;0;0
53;20853;9;0;0;0;0;.00nan;0;0
53;31124;19;56;25;3;22;.880;3600000;0
54;61;31;80;28;2;26;.929;3838000;0
54;1614;25;84;35;3;32;.914;3838000;0
54;5182;25;0;0;0;0;.00nan;0;0
54;34797;31;0;0;0;0;.00nan;0;0
55;51;21;44;24;4;20;.833;3546000;0
55;25843;21;0;0;0;0;.00nan;0;0
55;27739;22;95;39;2;37;.949;3600000;0
55;28026;22;0;0;0;0;.00nan;0;0
56;13842;34;0;0;0;0;.00nan;0;0
56;15502;34;91;39;2;37;.949;3600000;0
56;18078;20;32;22;5;17;.773;3600000;0
56;32146;20;0;0;0;0;.00nan;0;0
57;335;18;0;0;0;0;.00nan;0;0
57;5001;18;65;32;3;29;.906;3600000;0
57;15505;8;55;23;4;19;.826;3600000;0
57;25076;8;0;0;0;0;.00nan;0;0
58;15464;32;99;43;2;41;.953;3600000;0
58;16006;32;0;0;0;0;.00nan;0;0
58;18104;10;0;0;0;0;.00nan;0;0
58;27488;10;46;34;5;29;.853;3600000;0
59;1913;30;79;42;4;38;.905;3600000;0
59;4506;33;74;29;3;26;.897;3600000;0
59;4826;30;0;0;0;0;.00nan;0;0
59;34740;33;0;0;0;0;.00nan;0;0
60;823;23;0;0;0;0;.00nan;0;0
60;10274;23;38;27;5;22;.815;3853000;0
60;22601;26;0;0;0;0;.00nan;0;0
60;32754;26;58;43;6;37;.860;3853000;0
61;4450;5;53;19;3;16;.842;3561000;0
61;5385;17;0;0;0;0;.00nan;0;0
61;19823;5;0;0;0;0;.00nan;0;0
61;34006;17;81;32;2;30;.938;3600000;0
62;738;27;46;34;5;29;.853;3110000;0
62;1821;3;93;36;2;34;.944;3600000;0
62;2054;3;0;0;0;0;.00nan;0;0
62;26623;27;19;9;4;5;.556;490000;0
63;445;12;40;24;4;20;.833;3600000;0
63;724;11;86;39;3;36;.923;3600000;0
63;21522;11;0;0;0;0;.00nan;0;0
63;34786;12;0;0;0;0;.00nan;0;0
64;500;4182;73;33;2;31;.939;3560000;0
64;823;23;94;31;1;30;.968;3600000;0
64;10274;23;0;0;0;0;.00nan;0;0
64;25521;4182;0;0;0;0;.00nan;0;0
65;323;9;96;28;1;27;.964;3900000;0
65;1074;0;0;0;0;0;.00nan;0;0
65;20853;9;0;0;0;0;.00nan;0;0
65;31035;0;96;36;1;35;.972;3893000;0
66;2058;28;52;31;5;26;.839;3785000;0
66;14061;28;0;0;0;0;.00nan;0;0
66;18104;10;0;0;0;0;.00nan;0;0
66;27488;10;59;29;4;25;.862;3785000;0
67;233;29;81;32;2;30;.938;3600000;0
67;1614;25;0;0;0;0;.00nan;0;0
67;5182;25;50;27;4;23;.852;3600000;0
67;18351;29;0;0;0;0;.00nan;0;0
68;51;21;97;25;0;25;1.000;3600000;0
68;5385;17;0;0;0;0;.00nan;0;0
68;25843;21;0;0;0;0;.00nan;0;0
68;34006;17;85;32;2;30;.938;3600000;0
69;61;31;0;0;0;0;.00nan;0;0
69;1251;14;0;0;0;0;.00nan;0;0
69;25584;14;66;34;3;31;.912;3600000;0
69;34797;31;97;21;0;21;1.000;3600000;0
70;1821;3;0;0;0;0;.00nan;0;0
70;2054;3;69;33;3;30;.909;3885000;0
70;2423;15;60;37;4;33;.892;3885000;0
70;4106;15;0;0;0;0;.00nan;0;0
71;544;19;0;0;0;0;.00nan;0;0
71;27739;22;67;37;4;33;.892;3866000;0
71;28026;22;0;0;0;0;.00nan;0;0
71;31124;19;46;25;4;21;.840;3900000;0
72;10103;24;60;24;3;21;.875;3600000;0
72;13842;34;0;0;0;0;.00nan;0;0
72;13979;24;0;0;0;0;.00nan;0;0
72;15502;34;62;47;6;41;.872;3600000;0
73;724;11;0;0;0;0;.00nan;0;0
73;1796;16;75;39;3;36;.923;3600000;0
73;15437;16;0;0;0;0;.00nan;0;0
73;21522;11;62;35;4;31;.886;3547000;0
74;262;35;0;0;0;0;.00nan;0;0
74;1430;35;63;23;2;21;.913;3600000;0
74;1913;30;71;41;5;36;.878;3600000;0
74;4826;30;0;0;0;0;.00nan;0;0
75;4506;33;65;32;4;28;.875;3765000;0
75;15464;32;0;0;0;0;.00nan;0;0
75;16006;32;67;30;3;27;.900;3765000;0
75;34740;33;0;0;0;0;.00nan;0;0
76;18078;20;75;43;4;39;.907;3600000;0
76;22601;26;100;36;0;36;1.000;3600000;0
76;32146;20;0;0;0;0;.00nan;0;0
76;32754;26;0;0;0;0;.00nan;0;0
77;335;18;92;42;2;40;.952;3553000;0
77;1572;4838;0;0;0;0;.00nan;0;0
77;2328;4838;88;32;1;31;.969;3600000;0
77;5001;18;0;0;0;0;.00nan;0;0
78;738;27;0;0;0;0;.00nan;0;0
78;4450;5;64;23;2;21;.913;3600000;0
78;19823;5;0;0;0;0;.00nan;0;0
78;26623;27;83;49;4;45;.918;3600000;0
79;323;9;0;0;0;0;.00nan;0;0
79;15505;8;78;26;1;25;.962;3600000;0
79;20853;9;54;39;5;34;.872;3600000;0
79;25076;8;0;0;0;0;.00nan;0;0
80;262;35;68;29;3;26;.897;3525000;0
80;1430;35;0;0;0;0;.00nan;0;0
80;15464;32;70;24;1;23;.958;3600000;0
80;16006;32;0;0;0;0;.00nan;0;0
81;500;4182;69;34;4;30;.882;3528000;0
81;18078;20;80;30;2;28;.933;3600000;0
81;25521;4182;0;0;0;0;.00nan;0;0
81;32146;20;0;0;0;0;.00nan;0;0
82;233;29;69;22;2;20;.909;3600000;0
82;5385;17;0;0;0;0;.00nan;0;0
82;18351;29;0;0;0;0;.00nan;0;0
82;34006;17;58;33;4;29;.879;3600000;0
83;2058;28;75;44;4;40;.909;3900000;0
83;14061;28;0;0;0;0;.00nan;0;0
83;27739;22;0;0;0;0;.00nan;0;0
83;28026;22;59;35;4;31;.886;3900000;0
84;61;31;0;0;0;0;.00nan;0;0
84;22601;26;99;40;2;38;.950;3600000;0
84;32754;26;0;0;0;0;.00nan;0;0
84;34797;31;60;33;4;29;.879;3600000;0
85;544;19;47;21;3;18;.857;3600000;0
85;18104;10;0;0;0;0;.00nan;0;0
85;27488;10;66;41;4;37;.902;3543000;0
85;31124;19;0;0;0;0;.00nan;0;0
86;1821;3;85;23;1;22;.957;3600000;0
86;2054;3;0;0;0;0;.00nan;0;0
86;10103;24;0;0;0;0;.00nan;0;0
86;13979;24;70;35;3;32;.914;3577000;0
87;445;12;53;34;4;30;.882;3600000;0
87;13842;34;100;25;0;25;1.000;3600000;0
87;15502;34;0;0;0;0;.00nan;0;0
87;34786;12;0;0;0;0;.00nan;0;0
88;724;11;78;44;5;39;.886;3600000;0
88;1796;16;76;12;0;12;1.000;3600000;0
88;15437;16;0;0;0;0;.00nan;0;0
88;21522;11;0;0;0;0;.00nan;0;0
89;51;21;68;24;2;22;.917;3600000;0
89;544;19;74;27;2;25;.926;3230000;0
89;25843;21;0;0;0;0;.00nan;0;0
89;31124;19;31;9;3;6;.667;370000;0
90;233;29;0;0;0;0;.00nan;0;0
90;2423;15;86;32;1;31;.969;3600000;0
90;4106;15;0;0;0;0;.00nan;0;0
90;18351;29;63;32;3;29;.906;3576000;0
91;738;27;0;0;0;0;.00nan;0;0
91;15464;32;62;31;3;28;.903;3600000;0
91;16006;32;0;0;0;0;.00nan;0;0
91;26623;27;100;41;0;41;1.000;3600000;0
92;500;4182;100;40;2;38;.950;3900000;0
92;1614;25;94;41;2;39;.951;3900000;0
92;5182;25;0;0;0;0;.00nan;0;0
92;25521;4182;0;0;0;0;.00nan;0;0
93;262;35;67;29;3;26;.897;3556000;0
93;335;18;0;0;0;0;.00nan;0;0
93;1430;35;0;0;0;0;.00nan;0;0
93;5001;18;74;33;2;31;.939;3600000;0
94;1913;30;0;0;0;0;.00nan;0;0
94;4506;33;60;21;3;18;.857;3900000;0
94;4826;30;98;61;3;58;.951;3900000;0
94;34740;33;0;0;0;0;.00nan;0;0
95;1074;0;0;0;0;0;.00nan;0;0
95;1572;4838;66;37;4;33;.892;3900000;0
95;2328;4838;0;0;0;0;.00nan;0;0
95;31035;0;67;31;4;27;.871;3900000;0
96;61;31;0;0;0;0;.00nan;0;0
96;4450;5;100;26;0;26;1.000;3600000;0
96;19823;5;0;0;0;0;.00nan;0;0
96;34797;31;77;34;3;31;.912;3600000;0
97;323;9;0;0;0;0;.00nan;0;0
97;20853;9;80;43;3;40;.930;3900000;0
97;27739;22;0;0;0;0;.00nan;0;0
97;28026;22;64;30;3;27;.900;3900000;0
98;1821;3;0;0;0;0;.00nan;0;0
98;2054;3;87;29;1;28;.966;3600000;0
98;15505;8;97;44;2;42;.955;3561000;0
98;25076;8;0;0;0;0;.00nan;0;0
99;445;12;85;37;2;35;.946;3638000;0
99;500;4182;0;0;0;0;.00nan;0;0
99;25521;4182;62;26;3;23;.885;3638000;0
99;34786;12;0;0;0;0;.00nan;0;0
100;823;23;0;0;0;0;.00nan;0;0
100;1251;14;89;40;3;37;.925;3518000;0
100;10274;23;75;26;1;25;.962;3600000;0
100;25584;14;0;0;0;0;.00nan;0;0
101;233;29;77;25;2;23;.920;3600000;0
101;18351;29;0;0;0;0;.00nan;0;0
101;22601;26;57;40;5;35;.875;3094000;0
101;32754;26;27;7;3;4;.571;506000;0
102;544;19;0;0;0;0;.00nan;0;0
102;2423;15;0;0;0;0;.00nan;0;0
102;4106;15;90;38;2;36;.947;3900000;0
102;31124;19;63;21;2;19;.905;3900000;0
103;4450;5;62;24;3;21;.875;3860000;0
103;10103;24;83;31;2;29;.935;3860000;0
103;13979;24;0;0;0;0;.00nan;0;0
103;19823;5;0;0;0;0;.00nan;0;0
104;1614;25;59;40;5;35;.875;3577000;0
104;1796;16;54;24;4;20;.833;3600000;0
104;5182;25;0;0;0;0;.00nan;0;0
104;15437;16;0;0;0;0;.00nan;0;0
105;335;18;0;0;0;0;.00nan;0;0
105;1251;14;0;0;0;0;.00nan;0;0
105;5001;18;75;29;2;27;.931;3600000;0
105;25584;14;71;30;3;27;.900;3600000;0
106;1913;30;73;27;2;25;.926;3600000;0
106;4826;30;0;0;0;0;.00nan;0;0
106;5385;17;0;0;0;0;.00nan;0;0
106;34006;17;74;34;3;31;.912;3560000;0
107;724;11;78;29;2;27;.931;3558000;0
107;4506;33;99;37;1;36;.973;3600000;0
107;21522;11;0;0;0;0;.00nan;0;0
107;34740;33;0;0;0;0;.00nan;0;0
108;738;27;0;0;0;0;.00nan;0;0
108;1074;0;0;0;0;0;.00nan;0;0
108;26623;27;82;38;3;35;.921;3545000;0
108;31035;0;82;36;2;34;.944;3600000;0
109;262;35;91;39;2;37;.949;3600000;0
109;1430;35;0;0;0;0;.00nan;0;0
109;1572;4838;0;0;0;0;.00nan;0;0
109;2328;4838;25;23;5;18;.783;3600000;0
110;61;31;0;0;0;0;.00nan;0;0
110;323;9;87;39;3;36;.923;3899000;0
110;20853;9;0;0;0;0;.00nan;0;0
110;34797;31;78;41;3;38;.927;3900000;0
111;13842;34;83;42;3;39;.929;3886000;0
111;15502;34;0;0;0;0;.00nan;0;0
111;18104;10;0;0;0;0;.00nan;0;0
111;27488;10;73;30;2;28;.933;3886000;0
112;22601;26;0;0;0;0;.00nan;0;0
112;27739;22;0;0;0;0;.00nan;0;0
112;28026;22;78;24;1;23;.958;3600000;0
112;32754;26;44;41;7;34;.829;3600000;0
113;10103;24;0;0;0;0;.00nan;0;0
113;13979;24;100;41;1;40;.976;3600000;0
113;15505;8;82;44;4;40;.909;3600000;0
113;25076;8;0;0;0;0;.00nan;0;0
114;445;12;0;0;0;0;.00nan;0;0
114;2058;28;63;36;4;32;.889;3571000;0
114;14061;28;0;0;0;0;.00nan;0;0
114;34786;12;69;24;2;22;.917;3600000;0
115;500;4182;69;25;2;23;.920;3600000;0
115;1913;30;0;0;0;0;.00nan;0;0
115;4826;30;66;46;5;41;.891;3600000;0
115;25521;4182;0;0;0;0;.00nan;0;0
116;61;31;83;44;4;40;.909;3581000;0
116;4450;5;57;20;2;18;.900;3600000;0
116;19823;5;0;0;0;0;.00nan;0;0
116;34797;31;0;0;0;0;.00nan;0;0
117;323;9;0;0;0;0;.00nan;0;0
117;1821;3;62;41;5;36;.878;3600000;0
117;2054;3;0;0;0;0;.00nan;0;0
117;20853;9;100;42;1;41;.976;3600000;0
118;51;21;0;0;0;0;.00nan;0;0
118;2423;15;65;18;1;17;.944;3600000;0
118;4106;15;0;0;0;0;.00nan;0;0
118;25843;21;69;34;3;31;.912;3515000;0
119;1796;16;28;24;5;19;.792;3900000;0
119;15437;16;0;0;0;0;.00nan;0;0
119;15505;8;0;0;0;0;.00nan;0;0
119;25076;8;68;45;5;40;.889;3900000;0
120;928;20;0;0;0;0;.00nan;0;0
120;15464;32;65;35;4;31;.886;3600000;0
120;16006;32;0;0;0;0;.00nan;0;0
120;18078;20;55;26;3;23;.885;3600000;0
121;262;35;75;32;2;30;.938;3600000;0
121;1430;35;0;0;0;0;.00nan;0;0
121;1614;25;0;0;0;0;.00nan;0;0
121;5182;25;65;38;4;34;.895;3600000;0
122;544;19;64;23;2;21;.913;3900000;0
122;1251;14;0;0;0;0;.00nan;0;0
122;25584;14;73;32;2;30;.938;3900000;0
122;31124;19;0;0;0;0;.00nan;0;0
123;335;18;0;0;0;0;.00nan;0;0
123;823;23;0;0;0;0;.00nan;0;0
123;5001;18;54;43;6;37;.860;3600000;0
123;10274;23;65;26;2;24;.923;3600000;0
124;724;11;0;0;0;0;.00nan;0;0
124;1074;0;0;0;0;0;.00nan;0;0
124;21522;11;37;21;4;17;.810;3600000;0
124;31035;0;58;42;5;37;.881;3573000;0
125;738;27;0;0;0;0;.00nan;0;0
125;4506;33;59;45;6;39;.867;3600000;0
125;26623;27;58;24;3;21;.875;3600000;0
125;34740;33;0;0;0;0;.00nan;0;0
126;51;21;64;45;6;39;.867;3167000;0
126;13842;34;43;24;4;20;.833;3600000;0
126;15502;34;0;0;0;0;.00nan;0;0
126;25843;21;50;1;0;1;1.000;380000;0
127;10103;24;0;0;0;0;.00nan;0;0
127;13979;24;85;31;2;29;.935;3600000;0
127;22601;26;9;22;7;15;.682;2675000;0
127;32754;26;49;8;1;7;.875;925000;0
128;1074;0;76;23;1;22;.957;3600000;0
128;1913;30;0;0;0;0;.00nan;0;0
128;4826;30;74;29;3;26;.897;3529000;0
128;31035;0;0;0;0;0;.00nan;0;0
129;724;11;100;29;0;29;1.000;3600000;0
129;5385;17;49;7;1;6;.857;602000;0
129;21522;11;0;0;0;0;.00nan;0;0
129;34006;17;22;32;7;25;.781;2998000;0
130;1572;4838;90;48;5;43;.896;3600000;0
130;2328;4838;0;0;0;0;.00nan;0;0
130;18104;10;0;0;0;0;.00nan;0;0
130;27488;10;55;26;4;22;.846;3600000;0
131;233;29;42;31;5;26;.839;3600000;0
131;18351;29;0;0;0;0;.00nan;0;0
131;27739;22;90;42;3;39;.929;3600000;0
131;28026;22;0;0;0;0;.00nan;0;0
132;2058;28;57;44;6;38;.864;3542000;0
132;14061;28;0;0;0;0;.00nan;0;0
132;15505;8;31;22;5;17;.773;3600000;0
132;25076;8;0;0;0;0;.00nan;0;0
133;823;23;82;37;3;34;.919;3600000;0
133;1572;4838;0;0;0;0;.00nan;0;0
133;2328;4838;90;40;2;38;.950;3600000;0
133;10274;23;0;0;0;0;.00nan;0;0
134;500;4182;77;28;2;26;.929;3589000;0
134;1821;3;0;0;0;0;.00nan;0;0
134;2054;3;91;30;1;29;.967;3600000;0
134;25521;4182;0;0;0;0;.00nan;0;0
135;323;9;55;28;4;24;.857;3248000;0
135;1074;0;0;0;0;0;.00nan;0;0
135;20853;9;24;5;3;2;.400;352000;0
135;31035;0;100;33;1;32;.970;3600000;0
136;1251;14;91;37;2;35;.946;3900000;0
136;22601;26;73;27;2;25;.926;3900000;0
136;25584;14;0;0;0;0;.00nan;0;0
136;32754;26;0;0;0;0;.00nan;0;0
137;262;35;83;32;2;30;.938;3547000;0
137;1430;35;0;0;0;0;.00nan;0;0
137;2058;28;0;0;0;0;.00nan;0;0
137;14061;28;97;36;1;35;.972;3600000;0
138;445;12;0;0;0;0;.00nan;0;0
138;4506;33;0;0;0;0;.00nan;0;0
138;34740;33;100;37;1;36;.973;3600000;0
138;34786;12;40;19;4;15;.789;3600000;0
139;544;19;0;0;0;0;.00nan;0;0
139;15464;32;93;44;1;43;.977;3600000;0
139;16006;32;0;0;0;0;.00nan;0;0
139;31124;19;56;20;2;18;.900;3561000;0
140;335;18;0;0;0;0;.00nan;0;0
140;5001;18;73;31;3;28;.903;3600000;0
140;18104;10;47;13;2;11;.846;1317000;0
140;27488;10;53;38;5;33;.868;2283000;0
141;51;21;85;25;2;23;.920;3600000;0
141;1913;30;0;0;0;0;.00nan;0;0
141;4826;30;76;41;4;37;.902;3600000;0
141;25843;21;0;0;0;0;.00nan;0;0
142;738;27;88;38;2;36;.947;3600000;0
142;5385;17;86;29;3;26;.897;3560000;0
142;26623;27;0;0;0;0;.00nan;0;0
142;34006;17;0;0;0;0;.00nan;0;0
143;10103;24;0;0;0;0;.00nan;0;0
143;13979;24;62;40;5;35;.875;3600000;0
143;15505;8;77;19;1;18;.947;3600000;0
143;25076;8;0;0;0;0;.00nan;0;0
144;1614;25;0;0;0;0;.00nan;0;0
144;5182;25;86;17;0;17;1.000;3600000;0
144;13842;34;0;0;0;0;.00nan;0;0
144;15502;34;52;35;4;31;.886;3600000;0
145;823;23;0;0;0;0;.00nan;0;0
145;10274;23;64;33;3;30;.909;3529000;0
145;15464;32;88;35;1;34;.971;3600000;0
145;16006;32;0;0;0;0;.00nan;0;0
146;724;11;97;32;1;31;.969;3600000;0
146;1796;16;82;34;2;32;.941;3543000;0
146;15437;16;0;0;0;0;.00nan;0;0
146;21522;11;0;0;0;0;.00nan;0;0
147;323;9;39;8;2;6;.750;1488000;0
147;4450;5;91;19;0;19;1.000;3600000;0
147;19823;5;0;0;0;0;.00nan;0;0
147;20853;9;36;41;7;34;.829;2112000;0
148;233;29;65;39;5;34;.872;3600000;0
148;1821;3;62;21;2;19;.905;3600000;0
148;2054;3;0;0;0;0;.00nan;0;0
148;18351;29;0;0;0;0;.00nan;0;0
149;928;20;0;0;0;0;.00nan;0;0
149;1074;0;0;0;0;0;.00nan;0;0
149;18078;20;44;21;4;17;.810;3513000;0
149;31035;0;100;44;2;42;.955;3600000;0
150;500;4182;86;37;3;34;.919;3600000;0
150;2058;28;62;33;4;29;.879;3589000;0
150;14061;28;0;0;0;0;.00nan;0;0
150;25521;4182;0;0;0;0;.00nan;0;0
151;61;31;0;0;0;0;.00nan;0;0
151;27739;22;0;0;0;0;.00nan;0;0
151;28026;22;66;32;3;29;.906;3600000;0
151;34797;31;43;22;4;18;.818;3519000;0
152;1251;14;63;47;5;42;.894;3552000;0
152;2423;15;66;28;3;25;.893;3600000;0
152;4106;15;0;0;0;0;.00nan;0;0
152;25584;14;0;0;0;0;.00nan;0;0
153;445;12;0;0;0;0;.00nan;0;0
153;544;19;0;0;0;0;.00nan;0;0
153;31124;19;76;30;2;28;.933;3600000;0
153;34786;12;72;36;4;32;.889;3521000;0
154;738;27;0;0;0;0;.00nan;0;0
154;1796;16;97;42;1;41;.976;3578000;0
154;15437;16;0;0;0;0;.00nan;0;0
154;26623;27;94;26;0;26;1.000;3600000;0
155;1572;4838;58;22;3;19;.864;3600000;0
155;2328;4838;0;0;0;0;.00nan;0;0
155;5385;17;0;0;0;0;.00nan;0;0
155;34006;17;43;26;4;22;.846;3600000;0
156;4506;33;72;22;1;21;.955;3792000;0
156;15505;8;0;0;0;0;.00nan;0;0
156;25076;8;92;36;2;34;.944;3792000;0
156;34740;33;0;0;0;0;.00nan;0;0
157;823;23;0;0;0;0;.00nan;0;0
157;10274;23;72;36;3;33;.917;3544000;0
157;18104;10;0;0;0;0;.00nan;0;0
157;27488;10;70;26;2;24;.923;3600000;0
158;335;18;0;0;0;0;.00nan;0;0
158;5001;18;65;33;3;30;.909;3564000;0
158;15464;32;87;26;1;25;.962;3600000;0
158;16006;32;0;0;0;0;.00nan;0;0
159;1913;30;0;0;0;0;.00nan;0;0
159;4826;30;85;52;4;48;.923;3600000;0
159;22601;26;0;0;0;0;.00nan;0;0
159;32754;26;75;20;1;19;.950;3600000;0
160;51;21;0;0;0;0;.00nan;0;0
160;724;11;71;20;1;19;.950;3600000;0
160;21522;11;0;0;0;0;.00nan;0;0
160;25843;21;68;31;3;28;.903;3568000;0
161;323;9;49;35;5;30;.857;3600000;0
161;5385;17;0;0;0;0;.00nan;0;0
161;20853;9;0;0;0;0;.00nan;0;0
161;34006;17;86;36;2;34;.944;3600000;0
162;1592;3;0;0;0;0;.00nan;0;0
162;1821;3;60;28;4;24;.857;3514000;0
162;4450;5;65;22;2;20;.909;3600000;0
162;19823;5;0;0;0;0;.00nan;0;0
163;500;4182;94;18;0;18;1.000;3600000;0
163;1074;0;0;0;0;0;.00nan;0;0
163;25521;4182;0;0;0;0;.00nan;0;0
163;31035;0;82;41;3;38;.927;3600000;0
164;233;29;64;17;1;16;.941;3900000;0
164;2058;28;81;34;1;33;.971;3900000;0
164;14061;28;0;0;0;0;.00nan;0;0
164;18351;29;0;0;0;0;.00nan;0;0
165;61;31;0;0;0;0;.00nan;0;0
165;10103;24;0;0;0;0;.00nan;0;0
165;13979;24;62;44;5;39;.886;3542000;0
165;34797;31;53;28;4;24;.857;3600000;0
166;262;35;54;40;5;35;.875;3600000;0
166;1430;35;0;0;0;0;.00nan;0;0
166;2423;15;0;0;0;0;.00nan;0;0
166;4106;15;84;34;1;33;.971;3600000;0
167;1251;14;29;30;6;24;.800;3545000;0
167;25584;14;0;0;0;0;.00nan;0;0
167;27739;22;52;41;5;36;.878;3600000;0
167;28026;22;0;0;0;0;.00nan;0;0
168;1614;25;0;0;0;0;.00nan;0;0
168;5182;25;43;23;4;19;.826;3600000;0
168;13842;34;85;52;5;47;.904;3600000;0
168;15502;34;0;0;0;0;.00nan;0;0
169;928;20;51;16;2;14;.875;3600000;0
169;4506;33;0;0;0;0;.00nan;0;0
169;18078;20;0;0;0;0;.00nan;0;0
169;34740;33;83;36;3;33;.917;3600000;0
170;544;19;0;0;0;0;.00nan;0;0
170;18104;10;95;53;1;52;.981;3600000;0
170;27488;10;0;0;0;0;.00nan;0;0
170;31124;19;61;24;3;21;.875;3514000;0
171;1572;4838;82;25;1;24;.960;3600000;0
171;2328;4838;0;0;0;0;.00nan;0;0
171;22601;26;77;23;2;21;.913;3600000;0
171;32754;26;0;0;0;0;.00nan;0;0
172;51;21;52;33;6;27;.818;3600000;0
172;738;27;0;0;0;0;.00nan;0;0
172;25843;21;0;0;0;0;.00nan;0;0
172;26623;27;81;38;3;35;.921;3600000;0
173;323;9;0;0;0;0;.00nan;0;0
173;500;4182;71;29;3;26;.897;3655000;0
173;20853;9;93;36;2;34;.944;3655000;0
173;25521;4182;0;0;0;0;.00nan;0;0
174;15464;32;77;26;1;25;.962;3600000;0
174;15505;8;0;0;0;0;.00nan;0;0
174;16006;32;0;0;0;0;.00nan;0;0
174;25076;8;72;31;2;29;.935;3567000;0
175;262;35;0;0;0;0;.00nan;0;0
175;928;20;0;0;0;0;.00nan;0;0
175;1430;35;73;36;3;33;.917;3567000;0
175;18078;20;72;17;1;16;.941;3600000;0
176;335;18;64;27;3;24;.889;3900000;0
176;445;12;75;37;3;34;.919;3900000;0
176;5001;18;0;0;0;0;.00nan;0;0
176;34786;12;0;0;0;0;.00nan;0;0
177;1796;16;70;20;2;18;.900;3887000;0
177;1913;30;0;0;0;0;.00nan;0;0
177;4826;30;89;49;2;47;.959;3900000;0
177;15437;16;0;0;0;0;.00nan;0;0
178;724;11;49;32;4;28;.875;3900000;0
178;1592;3;64;31;4;27;.871;3900000;0
178;1821;3;0;0;0;0;.00nan;0;0
178;21522;11;0;0;0;0;.00nan;0;0
179;61;31;0;0;0;0;.00nan;0;0
179;18104;10;0;0;0;0;.00nan;0;0
179;27488;10;58;44;6;38;.864;3900000;0
179;34797;31;49;38;6;32;.842;3900000;0
180;5385;17;84;27;1;26;.963;3600000;0
180;27739;22;63;31;3;28;.903;3536000;0
180;28026;22;0;0;0;0;.00nan;0;0
180;34006;17;0;0;0;0;.00nan;0;0
181;2058;28;45;31;5;26;.839;3600000;0
181;4450;5;67;22;2;20;.909;3600000;0
181;14061;28;0;0;0;0;.00nan;0;0
181;19823;5;0;0;0;0;.00nan;0;0
182;724;11;59;25;3;22;.880;3548000;0
182;1074;0;0;0;0;0;.00nan;0;0
182;21522;11;0;0;0;0;.00nan;0;0
182;31035;0;92;37;2;35;.946;3600000;0
183;323;9;56;27;4;23;.852;3600000;0
183;823;23;0;0;0;0;.00nan;0;0
183;10274;23;80;23;1;22;.957;3600000;0
183;20853;9;0;0;0;0;.00nan;0;0
184;233;29;74;26;2;24;.923;3552000;0
184;10103;24;0;0;0;0;.00nan;0;0
184;13979;24;99;53;1;52;.981;3600000;0
184;18351;29;0;0;0;0;.00nan;0;0
185;51;21;100;39;1;38;.974;3900000;0
185;61;31;87;31;1;30;.968;3900000;0
185;25843;21;0;0;0;0;.00nan;0;0
185;34797;31;0;0;0;0;.00nan;0;0
186;2423;15;0;0;0;0;.00nan;0;0
186;4106;15;72;32;3;29;.906;3600000;0
186;15505;8;54;31;4;27;.871;3600000;0
186;25076;8;0;0;0;0;.00nan;0;0
187;1796;16;92;32;1;31;.969;3600000;0
187;4506;33;68;23;2;21;.913;3538000;0
187;15437;16;0;0;0;0;.00nan;0;0
187;34740;33;0;0;0;0;.00nan;0;0
188;544;19;0;0;0;0;.00nan;0;0
188;738;27;0;0;0;0;.00nan;0;0
188;26623;27;83;48;4;44;.917;3542000;0
188;31124;19;82;32;2;30;.938;3600000;0
189;335;18;0;0;0;0;.00nan;0;0
189;1913;30;79;22;1;21;.955;3600000;0
189;4826;30;0;0;0;0;.00nan;0;0
189;5001;18;52;30;4;26;.867;3600000;0
190;500;4182;76;18;1;17;.944;3900000;0
190;1572;4838;0;0;0;0;.00nan;0;0
190;2328;4838;100;43;1;42;.977;3900000;0
190;25521;4182;0;0;0;0;.00nan;0;0
191;1251;14;54;28;4;24;.857;3600000;0
191;1592;3;0;0;0;0;.00nan;0;0
191;1821;3;90;32;1;31;.969;3600000;0
191;25584;14;0;0;0;0;.00nan;0;0
192;445;12;70;32;3;29;.906;3599000;0
192;15464;32;73;20;1;19;.950;3600000;0
192;16006;32;0;0;0;0;.00nan;0;0
192;34786;12;0;0;0;0;.00nan;0;0
193;262;35;73;33;3;30;.909;3900000;0
193;1430;35;0;0;0;0;.00nan;0;0
193;22601;26;98;39;3;36;.923;3900000;0
193;32754;26;0;0;0;0;.00nan;0;0
194;823;23;0;0;0;0;.00nan;0;0
194;4450;5;75;22;1;21;.955;3600000;0
194;10274;23;57;30;3;27;.900;3579000;0
194;19823;5;0;0;0;0;.00nan;0;0
195;544;19;92;34;1;33;.971;3600000;0
195;1074;0;0;0;0;0;.00nan;0;0
195;31035;0;85;31;2;29;.935;3600000;0
195;31124;19;0;0;0;0;.00nan;0;0
196;724;11;65;41;6;35;.854;3600000;0
196;2058;28;0;0;0;0;.00nan;0;0
196;14061;28;58;28;3;25;.893;3600000;0
196;21522;11;0;0;0;0;.00nan;0;0
197;323;9;0;0;0;0;.00nan;0;0
197;20853;9;53;25;3;22;.880;3600000;0
197;27739;22;47;25;5;20;.800;3581000;0
197;28026;22;0;0;0;0;.00nan;0;0
198;51;21;100;35;0;35;1.000;3600000;0
198;928;20;18;23;6;17;.739;2765000;0
198;18078;20;52;4;0;4;1.000;835000;0
198;25843;21;0;0;0;0;.00nan;0;0
199;61;31;0;0;0;0;.00nan;0;0
199;2423;15;71;26;2;24;.923;3552000;0
199;4106;15;0;0;0;0;.00nan;0;0
199;34797;31;89;32;1;31;.969;3600000;0
200;1796;16;73;35;3;32;.914;3900000;0
200;15437;16;0;0;0;0;.00nan;0;0
200;15464;32;65;36;3;33;.917;3900000;0
200;16006;32;0;0;0;0;.00nan;0;0
201;738;27;0;0;0;0;.00nan;0;0
201;4506;33;94;36;2;34;.944;3600000;0
201;26623;27;54;38;5;33;.868;3600000;0
201;34740;33;0;0;0;0;.00nan;0;0
202;335;18;70;44;5;39;.886;3600000;0
202;1614;25;0;0;0;0;.00nan;0;0
202;5001;18;0;0;0;0;.00nan;0;0
202;5182;25;43;22;4;18;.818;3600000;0
203;262;35;0;0;0;0;.00nan;0;0
203;500;4182;88;29;2;27;.931;3600000;0
203;1430;35;64;32;3;29;.906;3595000;0
203;25521;4182;0;0;0;0;.00nan;0;0
204;1572;4838;85;27;1;26;.963;3600000;0
204;1913;30;0;0;0;0;.00nan;0;0
204;2328;4838;0;0;0;0;.00nan;0;0
204;4826;30;65;33;4;29;.879;3600000;0
205;823;23;56;28;4;24;.857;3600000;0
205;5385;17;0;0;0;0;.00nan;0;0
205;10274;23;0;0;0;0;.00nan;0;0
205;34006;17;96;36;1;35;.972;3600000;0
206;544;19;33;11;3;8;.727;1218000;0
206;1592;3;46;5;1;4;.800;528000;0
206;1821;3;35;29;6;23;.793;3072000;0
206;31124;19;33;28;6;22;.786;2382000;0
207;1251;14;95;40;3;37;.925;3600000;0
207;10103;24;80;45;4;41;.911;3579000;0
207;13979;24;0;0;0;0;.00nan;0;0
207;25584;14;0;0;0;0;.00nan;0;0
208;13842;34;91;36;2;34;.944;3871000;0
208;15502;34;0;0;0;0;.00nan;0;0
208;27739;22;0;0;0;0;.00nan;0;0
208;28026;22;78;29;1;28;.966;3871000;0
209;15505;8;43;24;4;20;.833;3600000;0
209;22601;26;44;33;5;28;.848;3544000;0
209;25076;8;0;0;0;0;.00nan;0;0
209;32754;26;0;0;0;0;.00nan;0;0
210;1592;3;92;38;2;36;.947;3900000;0
210;1821;3;0;0;0;0;.00nan;0;0
210;5385;17;66;32;2;30;.938;3900000;0
210;34006;17;0;0;0;0;.00nan;0;0
211;2058;28;91;31;1;30;.968;3551000;0
211;2423;15;96;24;0;24;1.000;3600000;0
211;4106;15;0;0;0;0;.00nan;0;0
211;14061;28;0;0;0;0;.00nan;0;0
212;323;9;73;29;2;27;.931;3600000;0
212;1074;0;0;0;0;0;.00nan;0;0
212;20853;9;0;0;0;0;.00nan;0;0
212;31035;0;60;27;3;24;.889;3585000;0
213;61;31;0;0;0;0;.00nan;0;0
213;233;29;41;21;4;17;.810;3600000;0
213;18351;29;0;0;0;0;.00nan;0;0
213;34797;31;94;40;2;38;.950;3600000;0
214;51;21;82;41;3;38;.927;3713000;0
214;4450;5;59;23;2;21;.913;3713000;0
214;19823;5;0;0;0;0;.00nan;0;0
214;25843;21;0;0;0;0;.00nan;0;0
215;1796;16;97;22;0;22;1.000;3600000;0
215;10103;24;0;0;0;0;.00nan;0;0
215;13979;24;65;37;4;33;.892;3600000;0
215;15437;16;0;0;0;0;.00nan;0;0
216;13842;34;0;0;0;0;.00nan;0;0
216;15502;34;95;47;3;44;.936;3600000;0
216;18104;10;0;0;0;0;.00nan;0;0
216;27488;10;59;20;2;18;.900;3600000;0
217;15464;32;58;41;5;36;.878;3900000;0
217;16006;32;0;0;0;0;.00nan;0;0
217;22601;26;0;0;0;0;.00nan;0;0
217;32754;26;47;28;5;23;.821;3900000;0
218;445;12;0;0;0;0;.00nan;0;0
218;1251;14;0;0;0;0;.00nan;0;0
218;25584;14;59;35;4;31;.886;3560000;0
218;34786;12;54;27;3;24;.889;3600000;0
219;724;11;0;0;0;0;.00nan;0;0
219;4506;33;68;24;2;22;.917;3600000;0
219;21522;11;70;36;3;33;.917;3575000;0
219;34740;33;0;0;0;0;.00nan;0;0
220;738;27;0;0;0;0;.00nan;0;0
220;1614;25;0;0;0;0;.00nan;0;0
220;5182;25;83;37;2;35;.946;3600000;0
220;26623;27;63;41;5;36;.878;3600000;0
221;335;18;91;36;2;34;.944;3600000;0
221;500;4182;44;33;6;27;.818;3600000;0
221;5001;18;0;0;0;0;.00nan;0;0
221;25521;4182;0;0;0;0;.00nan;0;0
222;262;35;88;38;3;35;.921;3600000;0
222;1430;35;0;0;0;0;.00nan;0;0
222;1572;4838;0;0;0;0;.00nan;0;0
222;2328;4838;54;37;5;32;.865;3566000;0
223;1074;0;82;39;3;36;.923;3813000;0
223;4450;5;0;0;0;0;.00nan;0;0
223;19823;5;97;39;2;37;.949;3813000;0
223;31035;0;0;0;0;0;.00nan;0;0
224;544;19;69;28;3;25;.893;3600000;0
224;2058;28;0;0;0;0;.00nan;0;0
224;14061;28;43;23;4;19;.826;3576000;0
224;31124;19;0;0;0;0;.00nan;0;0
225;51;21;0;0;0;0;.00nan;0;0
225;18104;10;24;5;3;2;.400;543000;0
225;25843;21;93;46;2;44;.957;3600000;0
225;27488;10;65;29;3;26;.897;3057000;0
226;2423;15;93;28;1;27;.964;3600000;0
226;4106;15;0;0;0;0;.00nan;0;0
226;27739;22;92;54;4;50;.926;3600000;0
226;28026;22;0;0;0;0;.00nan;0;0
227;823;23;86;33;2;31;.939;3600000;0
227;1796;16;74;25;1;24;.960;3600000;0
227;10274;23;0;0;0;0;.00nan;0;0
227;15437;16;0;0;0;0;.00nan;0;0
228;335;18;0;0;0;0;.00nan;0;0
228;1913;30;0;0;0;0;.00nan;0;0
228;4826;30;67;41;5;36;.878;3600000;0
228;5001;18;89;30;1;29;.967;3600000;0
229;233;29;65;31;3;28;.903;3547000;0
229;928;20;0;0;0;0;.00nan;0;0
229;18078;20;93;28;2;26;.929;3600000;0
229;18351;29;0;0;0;0;.00nan;0;0
230;323;9;97;51;2;49;.961;3564000;0
230;13842;34;0;0;0;0;.00nan;0;0
230;15502;34;86;21;1;20;.952;3600000;0
230;20853;9;0;0;0;0;.00nan;0;0
231;1592;3;88;31;2;29;.935;3900000;0
231;1821;3;0;0;0;0;.00nan;0;0
231;15464;32;84;39;2;37;.949;3900000;0
231;16006;32;0;0;0;0;.00nan;0;0
232;61;31;0;0;0;0;.00nan;0;0
232;928;20;31;32;6;26;.813;3191000;0
232;18078;20;54;4;0;4;1.000;409000;0
232;34797;31;95;39;3;36;.923;3600000;0
233;51;21;85;25;1;24;.960;3600000;0
233;2058;28;75;34;2;32;.941;3595000;0
233;14061;28;0;0;0;0;.00nan;0;0
233;25843;21;0;0;0;0;.00nan;0;0
234;1074;0;0;0;0;0;.00nan;0;0
234;18104;10;0;0;0;0;.00nan;0;0
234;27488;10;57;29;3;26;.897;3900000;0
234;31035;0;80;35;3;32;.914;3900000;0
235;544;19;100;39;1;38;.974;3600000;0
235;1251;14;57;30;4;26;.867;3600000;0
235;25584;14;0;0;0;0;.00nan;0;0
235;31124;19;0;0;0;0;.00nan;0;0
236;2423;15;95;44;2;42;.955;3600000;0
236;4106;15;0;0;0;0;.00nan;0;0
236;5385;17;46;28;5;23;.821;3600000;0
236;34006;17;0;0;0;0;.00nan;0;0
237;1796;16;0;0;0;0;.00nan;0;0
237;15437;16;63;34;4;30;.882;3577000;0
237;22601;26;92;37;2;35;.946;3600000;0
237;32754;26;0;0;0;0;.00nan;0;0
238;323;9;0;0;0;0;.00nan;0;0
238;445;12;100;25;0;25;1.000;3600000;0
238;20853;9;53;42;6;36;.857;3600000;0
238;34786;12;0;0;0;0;.00nan;0;0
239;262;35;88;48;2;46;.958;3546000;0
239;738;27;100;37;0;37;1.000;3600000;0
239;1430;35;0;0;0;0;.00nan;0;0
239;26623;27;0;0;0;0;.00nan;0;0
240;823;23;100;28;0;28;1.000;3600000;0
240;4506;33;51;17;2;15;.882;3546000;0
240;10274;23;0;0;0;0;.00nan;0;0
240;34740;33;0;0;0;0;.00nan;0;0
241;500;4182;82;31;2;29;.935;3600000;0
241;10103;24;0;0;0;0;.00nan;0;0
241;13979;24;99;31;1;30;.968;3600000;0
241;25521;4182;0;0;0;0;.00nan;0;0
242;1913;30;0;0;0;0;.00nan;0;0
242;4826;30;49;34;5;29;.853;3600000;0
242;27739;22;80;34;2;32;.941;3600000;0
242;28026;22;0;0;0;0;.00nan;0;0
243;335;18;69;35;3;32;.914;3600000;0
243;1614;25;66;40;5;35;.875;3600000;0
243;5001;18;0;0;0;0;.00nan;0;0
243;5182;25;0;0;0;0;.00nan;0;0
244;724;11;85;27;1;26;.963;3600000;0
244;21522;11;0;0;0;0;.00nan;0;0
244;27739;22;0;0;0;0;.00nan;0;0
244;28026;22;63;39;4;35;.897;3600000;0
245;1572;4838;0;0;0;0;.00nan;0;0
245;2328;4838;66;35;4;31;.886;3600000;0
245;15505;8;100;38;1;37;.974;3600000;0
245;25076;8;0;0;0;0;.00nan;0;0
246;544;19;68;24;2;22;.917;3600000;0
246;5385;17;0;0;0;0;.00nan;0;0
246;31124;19;0;0;0;0;.00nan;0;0
246;34006;17;50;31;5;26;.839;3600000;0
247;1821;3;0;0;0;0;.00nan;0;0
247;2054;3;100;29;1;28;.966;3600000;0
247;18104;10;0;0;0;0;.00nan;0;0
247;27488;10;81;44;4;40;.909;3600000;0
248;1074;0;0;0;0;0;.00nan;0;0
248;2423;15;55;26;3;23;.885;3600000;0
248;4106;15;0;0;0;0;.00nan;0;0
248;31035;0;83;43;4;39;.907;3549000;0
249;2058;28;92;32;1;31;.969;3600000;0
249;14061;28;0;0;0;0;.00nan;0;0
249;15464;32;66;34;4;30;.882;3600000;0
249;16006;32;0;0;0;0;.00nan;0;0
250;51;21;39;21;4;17;.810;3600000;0
250;61;31;0;0;0;0;.00nan;0;0
250;25843;21;0;0;0;0;.00nan;0;0
250;34797;31;98;48;1;47;.979;3600000;0
251;233;29;60;25;3;22;.880;3600000;0
251;1251;14;0;0;0;0;.00nan;0;0
251;18351;29;0;0;0;0;.00nan;0;0
251;25584;14;69;38;4;34;.895;3567000;0
252;738;27;86;34;2;32;.941;3600000;0
252;1796;16;49;25;4;21;.840;3558000;0
252;15437;16;0;0;0;0;.00nan;0;0
252;26623;27;0;0;0;0;.00nan;0;0
253;262;35;61;35;4;31;.886;3600000;0
253;445;12;82;33;2;31;.939;3600000;0
253;1430;35;0;0;0;0;.00nan;0;0
253;34786;12;0;0;0;0;.00nan;0;0
254;823;23;21;23;6;17;.739;3223000;0
254;4506;33;46;36;6;30;.833;3206000;0
254;10274;23;56;7;0;7;1.000;677000;0
254;34740;33;58;3;0;3;1.000;694000;0
255;13842;34;25;22;6;16;.727;3520000;0
255;15502;34;0;0;0;0;.00nan;0;0
255;22601;26;55;28;4;24;.857;3600000;0
255;32754;26;0;0;0;0;.00nan;0;0
256;323;9;71;48;6;42;.875;3600000;0
256;500;4182;60;25;3;22;.880;3600000;0
256;20853;9;0;0;0;0;.00nan;0;0
256;25521;4182;0;0;0;0;.00nan;0;0
257;1913;30;0;0;0;0;.00nan;0;0
257;4826;30;93;43;2;41;.953;3600000;0
257;10103;24;0;0;0;0;.00nan;0;0
257;13979;24;54;22;3;19;.864;3547000;0
258;335;18;64;36;4;32;.889;3600000;0
258;4506;33;75;22;1;21;.955;3175000;0
258;5001;18;0;0;0;0;.00nan;0;0
258;34740;33;22;11;4;7;.636;425000;0
259;1572;4838;0;0;0;0;.00nan;0;0
259;1614;25;0;0;0;0;.00nan;0;0
259;2328;4838;41;26;4;22;.846;3600000;0
259;5182;25;48;22;3;19;.864;3600000;0
260;1821;3;0;0;0;0;.00nan;0;0
260;2054;3;47;26;4;22;.846;3600000;0
260;2423;15;0;0;0;0;.00nan;0;0
260;4106;15;100;41;0;41;1.000;3600000;0
261;1074;0;0;0;0;0;.00nan;0;0
261;15464;32;61;24;2;22;.917;3532000;0
261;16006;32;0;0;0;0;.00nan;0;0
261;31035;0;96;21;0;21;1.000;3600000;0
262;2058;28;96;26;0;26;1.000;3600000;0
262;14061;28;0;0;0;0;.00nan;0;0
262;18104;10;0;0;0;0;.00nan;0;0
262;27488;10;60;31;5;26;.839;3600000;0
263;51;21;69;30;2;28;.933;3900000;0
263;233;29;75;27;2;25;.926;3900000;0
263;18351;29;0;0;0;0;.00nan;0;0
263;25843;21;0;0;0;0;.00nan;0;0
264;61;31;0;0;0;0;.00nan;0;0
264;262;35;79;34;3;31;.912;3600000;0
264;1430;35;0;0;0;0;.00nan;0;0
264;34797;31;79;28;2;26;.929;3600000;0
265;544;19;47;27;4;23;.852;3600000;0
265;928;20;97;39;2;37;.949;3600000;0
265;18078;20;0;0;0;0;.00nan;0;0
265;31124;19;0;0;0;0;.00nan;0;0
266;1251;14;52;33;4;29;.879;3064000;0
266;4450;5;73;27;2;25;.926;3600000;0
266;19823;5;0;0;0;0;.00nan;0;0
266;25584;14;51;3;0;3;1.000;465000;0
267;445;12;49;26;3;23;.885;3600000;0
267;1796;16;59;26;4;22;.846;3570000;0
267;15437;16;0;0;0;0;.00nan;0;0
267;34786;12;0;0;0;0;.00nan;0;0
268;823;23;0;0;0;0;.00nan;0;0
268;10274;23;97;40;1;39;.975;3600000;0
268;15505;8;75;32;2;30;.938;3583000;0
268;25076;8;0;0;0;0;.00nan;0;0
269;323;9;81;37;3;34;.919;3600000;0
269;20853;9;0;0;0;0;.00nan;0;0
269;22601;26;44;23;4;19;.826;3600000;0
269;32754;26;0;0;0;0;.00nan;0;0
270;500;4182;100;23;0;23;1.000;3600000;0
270;13842;34;49;47;6;41;.872;3600000;0
270;15502;34;0;0;0;0;.00nan;0;0
270;25521;4182;0;0;0;0;.00nan;0;0
271;724;11;83;32;2;30;.938;3600000;0
271;10103;24;0;0;0;0;.00nan;0;0
271;13979;24;83;35;3;32;.914;3600000;0
271;21522;11;0;0;0;0;.00nan;0;0
272;738;27;0;0;0;0;.00nan;0;0
272;26623;27;78;24;1;23;.958;3600000;0
272;27739;22;0;0;0;0;.00nan;0;0
272;28026;22;62;33;3;30;.909;3575000;0
273;544;19;0;0;0;0;.00nan;0;0
273;4450;5;0;0;0;0;.00nan;0;0
273;19823;5;95;28;1;27;.964;3600000;0
273;31124;19;40;26;5;21;.808;3600000;0
274;233;29;0;0;0;0;.00nan;0;0
274;262;35;77;28;2;26;.929;3082000;0
274;1430;35;33;16;4;12;.750;518000;0
274;18351;29;70;17;1;16;.941;3600000;0
275;928;20;0;0;0;0;.00nan;0;0
275;1821;3;99;39;2;37;.949;3600000;0
275;2054;3;0;0;0;0;.00nan;0;0
275;18078;20;53;23;3;20;.870;3600000;0
276;5385;17;37;31;5;26;.839;3600000;0
276;18104;10;66;22;2;20;.909;3600000;0
276;27488;10;0;0;0;0;.00nan;0;0
276;34006;17;0;0;0;0;.00nan;0;0
277;335;18;0;0;0;0;.00nan;0;0
277;5001;18;85;16;0;16;1.000;3600000;0
277;15505;8;64;6;0;6;1.000;583000;0
277;25076;8;51;42;6;36;.857;3017000;0
278;724;11;0;0;0;0;.00nan;0;0
278;21522;11;92;31;1;30;.968;3600000;0
278;22601;26;0;0;0;0;.00nan;0;0
278;32754;26;59;21;3;18;.857;3600000;0
279;1572;4838;0;0;0;0;.00nan;0;0
279;2328;4838;95;41;2;39;.951;3600000;0
279;27739;22;83;26;1;25;.962;3600000;0
279;28026;22;0;0;0;0;.00nan;0;0
280;5385;17;45;11;2;9;.818;1355000;0
280;13842;34;0;0;0;0;.00nan;0;0
280;15502;34;84;27;2;25;.926;3600000;0
280;34006;17;40;35;6;29;.829;2245000;0
281;500;4182;87;31;1;30;.968;3600000;0
281;1796;16;77;34;3;31;.912;3528000;0
281;15437;16;0;0;0;0;.00nan;0;0
281;25521;4182;0;0;0;0;.00nan;0;0
282;1913;30;0;0;0;0;.00nan;0;0
282;4826;30;55;35;4;31;.886;3562000;0
282;15464;32;67;20;2;18;.900;3600000;0
282;16006;32;0;0;0;0;.00nan;0;0
283;2423;15;0;0;0;0;.00nan;0;0
283;4106;15;46;27;4;23;.852;3600000;0
283;4506;33;60;25;3;22;.880;3600000;0
283;34740;33;0;0;0;0;.00nan;0;0
284;1614;25;51;21;2;19;.905;3600000;0
284;2058;28;59;40;6;34;.850;2883000;0
284;5182;25;0;0;0;0;.00nan;0;0
284;14061;28;50;13;1;12;.923;717000;0
285;738;27;80;46;4;42;.913;3571000;0
285;10103;24;0;0;0;0;.00nan;0;0
285;13979;24;71;26;2;24;.923;3600000;0
285;26623;27;0;0;0;0;.00nan;0;0
286;233;29;68;25;2;23;.920;3600000;0
286;1251;14;0;0;0;0;.00nan;0;0
286;18351;29;0;0;0;0;.00nan;0;0
286;25584;14;76;46;4;42;.913;3558000;0
287;445;12;83;35;3;32;.914;3900000;0
287;823;23;92;48;3;45;.938;3900000;0
287;10274;23;0;0;0;0;.00nan;0;0
287;34786;12;0;0;0;0;.00nan;0;0
288;544;19;61;21;2;19;.905;3550000;0
288;15505;8;0;0;0;0;.00nan;0;0
288;25076;8;100;32;0;32;1.000;3600000;0
288;31124;19;0;0;0;0;.00nan;0;0
289;4450;5;68;27;3;24;.889;3600000;0
289;5385;17;0;0;0;0;.00nan;0;0
289;19823;5;0;0;0;0;.00nan;0;0
289;34006;17;69;32;4;28;.875;3600000;0
290;323;9;0;0;0;0;.00nan;0;0
290;1796;16;75;26;2;24;.923;3579000;0
290;15437;16;0;0;0;0;.00nan;0;0
290;20853;9;99;30;1;29;.967;3600000;0
291;61;31;0;0;0;0;.00nan;0;0
291;1251;14;82;31;2;29;.935;3600000;0
291;25584;14;0;0;0;0;.00nan;0;0
291;34797;31;68;31;3;28;.903;3554000;0
292;51;21;0;0;0;0;.00nan;0;0
292;262;35;60;37;4;33;.892;3600000;0
292;1430;35;0;0;0;0;.00nan;0;0
292;25843;21;55;27;3;24;.889;3600000;0
293;928;20;37;16;4;12;.750;3600000;0
293;18078;20;0;0;0;0;.00nan;0;0
293;18104;10;0;0;0;0;.00nan;0;0
293;27488;10;56;38;5;33;.868;3549000;0
294;335;18;0;0;0;0;.00nan;0;0
294;2423;15;59;27;3;24;.889;3544000;0
294;4106;15;0;0;0;0;.00nan;0;0
294;5001;18;72;26;2;24;.923;3600000;0
295;1074;0;0;0;0;0;.00nan;0;0
295;27739;22;68;35;4;31;.886;3900000;0
295;28026;22;0;0;0;0;.00nan;0;0
295;31035;0;76;36;4;32;.889;3900000;0
296;4506;33;100;33;0;33;1.000;3600000;0
296;13842;34;0;0;0;0;.00nan;0;0
296;15502;34;59;27;3;24;.889;3600000;0
296;34740;33;0;0;0;0;.00nan;0;0
297;500;4182;70;39;3;36;.923;3706000;0
297;15464;32;96;32;2;30;.938;3706000;0
297;16006;32;0;0;0;0;.00nan;0;0
297;25521;4182;0;0;0;0;.00nan;0;0
298;1614;25;0;0;0;0;.00nan;0;0
298;1913;30;0;0;0;0;.00nan;0;0
298;4826;30;79;42;4;38;.905;3574000;0
298;5182;25;60;28;3;25;.893;3600000;0
299;823;23;0;0;0;0;.00nan;0;0
299;10274;23;67;24;2;22;.917;3600000;0
299;22601;26;70;48;6;42;.875;3332000;0
299;32754;26;57;4;0;4;1.000;268000;0
300;724;11;65;37;5;32;.865;3600000;0
300;1821;3;79;29;2;27;.931;3600000;0
300;2054;3;0;0;0;0;.00nan;0;0
300;21522;11;0;0;0;0;.00nan;0;0
301;738;27;0;0;0;0;.00nan;0;0
301;2058;28;0;0;0;0;.00nan;0;0
301;14061;28;52;30;4;26;.867;3600000;0
301;26623;27;99;29;1;28;.966;3600000;0
302;1572;4838;52;34;4;30;.882;3900000;0
302;2328;4838;0;0;0;0;.00nan;0;0
302;10103;24;0;0;0;0;.00nan;0;0
302;13979;24;71;42;4;38;.905;3900000;0
303;4450;5;67;27;2;25;.926;3600000;0
303;18104;10;68;48;5;43;.896;3600000;0
303;19823;5;0;0;0;0;.00nan;0;0
303;27488;10;0;0;0;0;.00nan;0;0
304;1074;0;0;0;0;0;.00nan;0;0
304;5385;17;85;28;2;26;.929;3566000;0
304;31035;0;100;39;0;39;1.000;3600000;0
304;34006;17;0;0;0;0;.00nan;0;0
305;233;29;12;21;6;15;.714;1835000;0
305;1572;4838;0;0;0;0;.00nan;0;0
305;2328;4838;100;29;0;29;1.000;3600000;0
305;18351;29;65;9;0;9;1.000;1765000;0
306;928;20;60;22;3;19;.864;3600000;0
306;2423;15;70;45;5;40;.889;3589000;0
306;4106;15;0;0;0;0;.00nan;0;0
306;18078;20;0;0;0;0;.00nan;0;0
307;1251;14;0;0;0;0;.00nan;0;0
307;10103;24;0;0;0;0;.00nan;0;0
307;13979;24;43;43;7;36;.837;3600000;0
307;25584;14;68;37;3;34;.919;3600000;0
308;61;31;0;0;0;0;.00nan;0;0
308;27739;22;99;32;0;32;1.000;3600000;0
308;28026;22;0;0;0;0;.00nan;0;0
308;34797;31;37;35;6;29;.829;3600000;0
309;335;18;63;52;5;47;.904;3600000;0
309;5001;18;0;0;0;0;.00nan;0;0
309;13842;34;0;0;0;0;.00nan;0;0
309;15502;34;100;32;0;32;1.000;3600000;0
310;1796;16;100;34;1;33;.971;3600000;0
310;15437;16;0;0;0;0;.00nan;0;0
310;15505;8;0;0;0;0;.00nan;0;0
310;25076;8;63;23;2;21;.913;3600000;0
311;51;21;63;31;3;28;.903;3900000;0
311;15464;32;0;0;0;0;.00nan;0;0
311;16006;32;63;32;3;29;.906;3900000;0
311;25843;21;0;0;0;0;.00nan;0;0
312;445;12;55;42;6;36;.857;3823000;0
312;1614;25;73;43;5;38;.884;3823000;0
312;5182;25;0;0;0;0;.00nan;0;0
312;34786;12;0;0;0;0;.00nan;0;0
313;262;35;78;26;1;25;.962;3600000;0
313;1430;35;0;0;0;0;.00nan;0;0
313;4506;33;89;42;2;40;.952;3544000;0
313;34740;33;0;0;0;0;.00nan;0;0
314;1913;30;86;30;2;28;.933;3600000;0
314;2058;28;0;0;0;0;.00nan;0;0
314;4826;30;0;0;0;0;.00nan;0;0
314;14061;28;52;23;3;20;.870;3563000;0
315;738;27;80;25;1;24;.960;3600000;0
315;1821;3;51;27;4;23;.852;3600000;0
315;2054;3;0;0;0;0;.00nan;0;0
315;26623;27;0;0;0;0;.00nan;0;0
316;323;9;80;32;2;30;.938;3572000;0
316;5385;17;0;0;0;0;.00nan;0;0
316;20853;9;0;0;0;0;.00nan;0;0
316;34006;17;86;25;1;24;.960;3600000;0
317;61;31;57;27;3;24;.889;3900000;0
317;1572;4838;0;0;0;0;.00nan;0;0
317;2328;4838;59;27;3;24;.889;3900000;0
317;34797;31;0;0;0;0;.00nan;0;0
318;1074;0;0;0;0;0;.00nan;0;0
318;2423;15;0;0;0;0;.00nan;0;0
318;4106;15;82;25;1;24;.960;3600000;0
318;31035;0;81;39;3;36;.923;3573000;0
319;1796;16;52;27;3;24;.889;3580000;0
319;13842;34;0;0;0;0;.00nan;0;0
319;15437;16;0;0;0;0;.00nan;0;0
319;15502;34;94;39;2;37;.949;3600000;0
320;1614;25;0;0;0;0;.00nan;0;0
320;5182;25;98;33;1;32;.970;3600000;0
320;15464;32;40;20;4;16;.800;3600000;0
320;16006;32;0;0;0;0;.00nan;0;0
321;544;19;0;0;0;0;.00nan;0;0
321;4506;33;0;0;0;0;.00nan;0;0
321;31124;19;88;48;3;45;.938;3600000;0
321;34740;33;49;30;4;26;.867;3553000;0
322;445;12;0;0;0;0;.00nan;0;0
322;22601;26;60;20;2;18;.900;3600000;0
322;32754;26;0;0;0;0;.00nan;0;0
322;34786;12;85;37;3;34;.919;3552000;0
323;500;4182;0;0;0;0;.00nan;0;0
323;823;23;75;43;3;40;.930;3515000;0
323;10274;23;0;0;0;0;.00nan;0;0
323;25521;4182;78;23;1;22;.957;3600000;0
324;724;11;81;33;2;31;.939;3900000;0
324;2058;28;72;24;2;22;.917;3900000;0
324;14061;28;0;0;0;0;.00nan;0;0
324;21522;11;0;0;0;0;.00nan;0;0
325;335;18;0;0;0;0;.00nan;0;0
325;4450;5;73;23;1;22;.957;3600000;0
325;5001;18;75;45;5;40;.889;3600000;0
325;19823;5;0;0;0;0;.00nan;0;0
326;51;21;59;23;3;20;.870;3600000;0
326;1251;14;0;0;0;0;.00nan;0;0
326;25584;14;67;33;4;29;.879;3565000;0
326;25843;21;0;0;0;0;.00nan;0;0
327;928;20;86;32;1;31;.969;3600000;0
327;18078;20;0;0;0;0;.00nan;0;0
327;18104;10;0;0;0;0;.00nan;0;0
327;27488;10;94;45;3;42;.933;3534000;0
328;10103;24;0;0;0;0;.00nan;0;0
328;13979;24;84;44;3;41;.932;3600000;0
328;27739;22;47;29;4;25;.862;3596000;0
328;28026;22;0;0;0;0;.00nan;0;0
329;738;27;0;0;0;0;.00nan;0;0
329;15505;8;76;43;4;39;.907;3699000;0
329;25076;8;0;0;0;0;.00nan;0;0
329;26623;27;76;35;3;32;.914;3699000;0
330;233;29;60;23;2;21;.913;3600000;0
330;262;35;92;45;3;42;.933;3591000;0
330;1430;35;0;0;0;0;.00nan;0;0
330;18351;29;0;0;0;0;.00nan;0;0
331;1821;3;0;0;0;0;.00nan;0;0
331;1913;30;94;54;3;51;.944;3806000;0
331;2054;3;87;34;2;32;.941;3806000;0
331;4826;30;0;0;0;0;.00nan;0;0
332;1572;4838;82;30;2;28;.933;3600000;0
332;2328;4838;0;0;0;0;.00nan;0;0
332;5385;17;56;12;1;11;.917;888000;0
332;34006;17;33;31;6;25;.806;2712000;0
333;335;18;54;25;4;21;.840;3520000;0
333;1074;0;82;30;2;28;.933;3600000;0
333;5001;18;0;0;0;0;.00nan;0;0
333;31035;0;0;0;0;0;.00nan;0;0
334;4506;33;100;43;1;42;.977;3600000;0
334;22601;26;71;25;2;23;.920;3600000;0
334;32754;26;0;0;0;0;.00nan;0;0
334;34740;33;0;0;0;0;.00nan;0;0
335;544;19;0;0;0;0;.00nan;0;0
335;2423;15;0;0;0;0;.00nan;0;0
335;4106;15;80;28;1;27;.964;3600000;0
335;31124;19;40;28;4;24;.857;3591000;0
336;323;9;0;0;0;0;.00nan;0;0
336;4450;5;89;29;1;28;.966;3900000;0
336;19823;5;0;0;0;0;.00nan;0;0
336;20853;9;88;35;1;34;.971;3900000;0
337;61;31;43;5;1;4;.800;813000;0
337;27739;22;39;33;6;27;.818;2720000;0
337;28026;22;63;9;0;9;1.000;1177000;0
337;34797;31;33;23;5;18;.783;3087000;0
338;51;21;0;0;0;0;.00nan;0;0
338;738;27;71;23;1;22;.957;3600000;0
338;25843;21;52;30;4;26;.867;3600000;0
338;26623;27;0;0;0;0;.00nan;0;0
339;928;20;0;0;0;0;.00nan;0;0
339;1251;14;94;19;0;19;1.000;3600000;0
339;18078;20;53;23;3;20;.870;3600000;0
339;25584;14;0;0;0;0;.00nan;0;0
340;233;29;25;26;6;20;.769;3600000;0
340;1796;16;100;37;0;37;1.000;3600000;0
340;15437;16;0;0;0;0;.00nan;0;0
340;18351;29;0;0;0;0;.00nan;0;0
341;13842;34;0;0;0;0;.00nan;0;0
341;15464;32;100;32;1;31;.969;3600000;0
341;15502;34;62;41;5;36;.878;3600000;0
341;16006;32;0;0;0;0;.00nan;0;0
342;445;12;95;38;1;37;.974;3600000;0
342;10103;24;0;0;0;0;.00nan;0;0
342;13979;24;50;24;4;20;.833;3600000;0
342;34786;12;0;0;0;0;.00nan;0;0
343;262;35;73;21;1;20;.952;3900000;0
343;1430;35;0;0;0;0;.00nan;0;0
343;22601;26;0;0;0;0;.00nan;0;0
343;32754;26;100;37;1;36;.973;3900000;0
344;724;11;53;16;2;14;.875;3600000;0
344;1913;30;75;39;3;36;.923;3600000;0
344;4826;30;0;0;0;0;.00nan;0;0
344;21522;11;0;0;0;0;.00nan;0;0
345;1614;25;0;0;0;0;.00nan;0;0
345;1821;3;0;0;0;0;.00nan;0;0
345;2054;3;99;43;2;41;.953;3600000;0
345;5182;25;55;30;4;26;.867;3516000;0
346;335;18;0;0;0;0;.00nan;0;0
346;2058;28;100;41;2;39;.951;3600000;0
346;5001;18;61;24;3;21;.875;3577000;0
346;14061;28;0;0;0;0;.00nan;0;0
347;323;9;64;32;3;29;.906;3600000;0
347;1572;4838;0;0;0;0;.00nan;0;0
347;2328;4838;84;27;1;26;.963;3600000;0
347;20853;9;0;0;0;0;.00nan;0;0
348;1251;14;0;0;0;0;.00nan;0;0
348;18104;10;0;0;0;0;.00nan;0;0
348;25584;14;91;44;3;41;.932;3600000;0
348;27488;10;100;41;2;39;.951;3600000;0
349;823;23;28;35;7;28;.800;3600000;0
349;2423;15;0;0;0;0;.00nan;0;0
349;4106;15;73;31;3;28;.903;3600000;0
349;10274;23;0;0;0;0;.00nan;0;0
350;500;4182;56;19;2;17;.895;3600000;0
350;1913;30;0;0;0;0;.00nan;0;0
350;4826;30;96;52;3;49;.942;3600000;0
350;25521;4182;0;0;0;0;.00nan;0;0
351;1074;0;0;0;0;0;.00nan;0;0
351;1614;25;81;28;2;26;.929;3600000;0
351;5182;25;0;0;0;0;.00nan;0;0
351;31035;0;90;45;3;42;.933;3560000;0
352;233;29;0;0;0;0;.00nan;0;0
352;1796;16;80;25;1;24;.960;3600000;0
352;15437;16;0;0;0;0;.00nan;0;0
352;18351;29;62;20;2;18;.900;3549000;0
353;61;31;0;0;0;0;.00nan;0;0
353;5385;17;0;0;0;0;.00nan;0;0
353;34006;17;40;30;5;25;.833;3529000;0
353;34797;31;37;13;3;10;.769;3600000;0
354;738;27;86;28;1;27;.964;3600000;0
354;928;20;76;27;2;25;.926;3600000;0
354;18078;20;0;0;0;0;.00nan;0;0
354;26623;27;0;0;0;0;.00nan;0;0
355;15505;8;0;0;0;0;.00nan;0;0
355;25076;8;79;47;4;43;.915;3600000;0
355;27739;22;0;0;0;0;.00nan;0;0
355;28026;22;72;20;1;19;.950;3600000;0
356;2058;28;35;34;7;27;.794;3600000;0
356;10103;24;0;0;0;0;.00nan;0;0
356;13979;24;65;22;2;20;.909;3600000;0
356;14061;28;0;0;0;0;.00nan;0;0
357;4450;5;71;19;1;18;.947;3600000;0
357;15464;32;56;30;4;26;.867;3600000;0
357;16006;32;0;0;0;0;.00nan;0;0
357;19823;5;0;0;0;0;.00nan;0;0
358;445;12;87;48;4;44;.917;3600000;0
358;13842;34;0;0;0;0;.00nan;0;0
358;15502;34;64;17;1;16;.941;3600000;0
358;34786;12;0;0;0;0;.00nan;0;0
359;51;21;0;0;0;0;.00nan;0;0
359;262;35;90;32;1;31;.969;3600000;0
359;1430;35;0;0;0;0;.00nan;0;0
359;25843;21;98;23;0;23;1.000;3600000;0
360;544;19;84;40;3;37;.925;3600000;0
360;724;11;100;29;0;29;1.000;3600000;0
360;21522;11;0;0;0;0;.00nan;0;0
360;31124;19;0;0;0;0;.00nan;0;0
361;738;27;0;0;0;0;.00nan;0;0
361;18104;10;81;32;2;30;.938;3600000;0
361;26623;27;28;32;7;25;.781;3600000;0
361;27488;10;0;0;0;0;.00nan;0;0
362;51;21;0;0;0;0;.00nan;0;0
362;5883;33;0;0;0;0;.00nan;0;0
362;25843;21;64;24;2;22;.917;3600000;0
362;34740;33;69;34;3;31;.912;3568000;0
363;500;4182;79;35;3;32;.914;3817000;0
363;22601;26;0;0;0;0;.00nan;0;0
363;25521;4182;0;0;0;0;.00nan;0;0
363;32754;26;54;29;4;25;.862;3817000;0
364;544;19;0;0;0;0;.00nan;0;0
364;1913;30;85;39;2;37;.949;3600000;0
364;4826;30;0;0;0;0;.00nan;0;0
364;31124;19;69;22;1;21;.955;3600000;0
365;823;23;56;35;5;30;.857;3600000;0
365;1572;4838;0;0;0;0;.00nan;0;0
365;2328;4838;100;33;0;33;1.000;3600000;0
365;10274;23;0;0;0;0;.00nan;0;0
366;233;29;0;0;0;0;.00nan;0;0
366;4450;5;44;29;6;23;.793;3640000;0
366;18351;29;61;32;5;27;.844;3640000;0
366;19823;5;0;0;0;0;.00nan;0;0
367;1614;25;0;0;0;0;.00nan;0;0
367;2058;28;0;0;0;0;.00nan;0;0
367;5182;25;99;24;0;24;1.000;3600000;0
367;14061;28;98;37;1;36;.973;3559000;0
368;323;9;98;54;3;51;.944;3581000;0
368;928;20;0;0;0;0;.00nan;0;0
368;18078;20;69;21;2;19;.905;3600000;0
368;20853;9;0;0;0;0;.00nan;0;0
369;61;31;0;0;0;0;.00nan;0;0
369;1796;16;85;33;2;31;.939;3600000;0
369;15437;16;0;0;0;0;.00nan;0;0
369;34797;31;100;30;1;29;.967;3600000;0
370;15505;8;73;29;3;26;.897;3900000;0
370;18104;10;0;0;0;0;.00nan;0;0
370;25076;8;0;0;0;0;.00nan;0;0
370;27488;10;64;35;3;32;.914;3900000;0
371;13842;34;0;0;0;0;.00nan;0;0
371;15502;34;55;33;4;29;.879;3600000;0
371;27739;22;93;20;0;20;1.000;3600000;0
371;28026;22;0;0;0;0;.00nan;0;0
372;5385;17;0;0;0;0;.00nan;0;0
372;10103;24;0;0;0;0;.00nan;0;0
372;13979;24;64;18;2;16;.889;3600000;0
372;34006;17;62;33;3;30;.909;3558000;0
373;1074;0;0;0;0;0;.00nan;0;0
373;15464;32;68;33;3;30;.909;3900000;0
373;16006;32;0;0;0;0;.00nan;0;0
373;31035;0;80;41;3;38;.927;3900000;0
374;262;35;51;42;6;36;.857;3600000;0
374;1430;35;0;0;0;0;.00nan;0;0
374;1821;3;83;28;1;27;.964;3600000;0
374;2054;3;0;0;0;0;.00nan;0;0
375;335;18;0;0;0;0;.00nan;0;0
375;2423;15;0;0;0;0;.00nan;0;0
375;4106;15;69;28;3;25;.893;3900000;0
375;5001;18;86;36;3;33;.917;3900000;0
376;233;29;72;32;2;30;.938;3900000;0
376;1251;14;84;34;2;32;.941;3900000;0
376;18351;29;0;0;0;0;.00nan;0;0
376;25584;14;0;0;0;0;.00nan;0;0
377;738;27;100;32;0;32;1.000;3600000;0
377;13842;34;48;23;3;20;.870;3600000;0
377;15502;34;0;0;0;0;.00nan;0;0
377;26623;27;0;0;0;0;.00nan;0;0
378;928;20;33;23;5;18;.783;3600000;0
378;15505;8;0;0;0;0;.00nan;0;0
378;18078;20;0;0;0;0;.00nan;0;0
378;25076;8;89;35;2;33;.943;3600000;0
379;1821;3;0;0;0;0;.00nan;0;0
379;2054;3;69;33;4;29;.879;3900000;0
379;5883;33;0;0;0;0;.00nan;0;0
379;34740;33;84;44;4;40;.909;3900000;0
380;724;11;39;20;4;16;.800;712000;0
380;823;23;0;0;0;0;.00nan;0;0
380;10274;23;86;38;2;36;.947;3600000;0
380;21522;11;51;13;2;11;.846;2888000;0
381;500;4182;86;24;1;23;.958;3600000;0
381;544;19;55;30;4;26;.867;3600000;0
381;25521;4182;0;0;0;0;.00nan;0;0
381;31124;19;0;0;0;0;.00nan;0;0
382;1251;14;0;0;0;0;.00nan;0;0
382;1614;25;0;0;0;0;.00nan;0;0
382;5182;25;95;31;1;30;.968;3600000;0
382;25584;14;64;38;5;33;.868;3600000;0
383;1913;30;90;37;2;35;.946;3600000;0
383;4826;30;0;0;0;0;.00nan;0;0
383;27739;22;29;28;6;22;.786;3600000;0
383;28026;22;0;0;0;0;.00nan;0;0
384;445;12;77;21;1;20;.952;3600000;0
384;22601;26;0;0;0;0;.00nan;0;0
384;32754;26;98;53;2;51;.962;3578000;0
384;34786;12;0;0;0;0;.00nan;0;0
385;335;18;0;0;0;0;.00nan;0;0
385;724;11;53;41;6;35;.854;3600000;0
385;5001;18;53;25;3;22;.880;3600000;0
385;21522;11;0;0;0;0;.00nan;0;0
386;1572;4838;0;0;0;0;.00nan;0;0
386;2328;4838;82;40;4;36;.900;3900000;0
386;2423;15;0;0;0;0;.00nan;0;0
386;4106;15;54;29;4;25;.862;3900000;0
387;1913;30;82;44;4;40;.909;3548000;0
387;4826;30;0;0;0;0;.00nan;0;0
387;5385;17;0;0;0;0;.00nan;0;0
387;34006;17;60;29;3;26;.897;3600000;0
388;1821;3;0;0;0;0;.00nan;0;0
388;2054;3;61;33;5;28;.848;3600000;0
388;13842;34;0;0;0;0;.00nan;0;0
388;15502;34;87;34;2;32;.941;3600000;0
389;233;29;0;0;0;0;.00nan;0;0
389;1074;0;0;0;0;0;.00nan;0;0
389;18351;29;71;15;1;14;.933;3600000;0
389;31035;0;89;41;3;38;.927;3568000;0
390;928;20;0;0;0;0;.00nan;0;0
390;2058;28;72;44;4;40;.909;3600000;0
390;14061;28;0;0;0;0;.00nan;0;0
390;18078;20;36;28;5;23;.821;3560000;0
391;323;9;68;49;6;43;.878;3572000;0
391;15464;32;60;30;4;26;.867;3600000;0
391;16006;32;0;0;0;0;.00nan;0;0
391;20853;9;0;0;0;0;.00nan;0;0
392;15505;8;0;0;0;0;.00nan;0;0
392;18104;10;0;0;0;0;.00nan;0;0
392;25076;8;68;30;3;27;.900;3548000;0
392;27488;10;74;30;2;28;.933;3600000;0
393;61;31;0;0;0;0;.00nan;0;0
393;1796;16;100;28;0;28;1.000;3600000;0
393;15437;16;0;0;0;0;.00nan;0;0
393;34797;31;65;30;3;27;.900;3600000;0
394;5883;33;0;0;0;0;.00nan;0;0
394;10103;24;0;0;0;0;.00nan;0;0
394;13979;24;79;45;4;41;.911;3513000;0
394;34740;33;65;26;2;24;.923;3600000;0
395;262;35;83;30;2;28;.933;3600000;0
395;823;23;82;42;5;37;.881;3600000;0
395;1430;35;0;0;0;0;.00nan;0;0
395;10274;23;0;0;0;0;.00nan;0;0
396;544;19;98;39;1;38;.974;3900000;0
396;738;27;100;40;1;39;.975;3900000;0
396;26623;27;0;0;0;0;.00nan;0;0
396;31124;19;0;0;0;0;.00nan;0;0
397;51;21;94;36;1;35;.972;3600000;0
397;1251;14;76;32;2;30;.938;3554000;0
397;25584;14;0;0;0;0;.00nan;0;0
397;25843;21;0;0;0;0;.00nan;0;0
398;1614;25;64;36;4;32;.889;3571000;0
398;5182;25;0;0;0;0;.00nan;0;0
398;18104;10;100;52;3;49;.942;3600000;0
398;27488;10;0;0;0;0;.00nan;0;0
399;335;18;0;0;0;0;.00nan;0;0
399;4450;5;18;18;5;13;.722;3514000;0
399;5001;18;100;54;3;51;.944;3600000;0
399;19823;5;0;0;0;0;.00nan;0;0
400;445;12;99;42;1;41;.976;3813000;0
400;500;4182;94;35;2;33;.943;3813000;0
400;25521;4182;0;0;0;0;.00nan;0;0
400;34786;12;0;0;0;0;.00nan;0;0
401;233;29;0;0;0;0;.00nan;0;0
401;1821;3;0;0;0;0;.00nan;0;0
401;2054;3;59;33;4;29;.879;3600000;0
401;18351;29;65;17;1;16;.941;3600000;0
402;1074;0;0;0;0;0;.00nan;0;0
402;15505;8;91;33;1;32;.970;3600000;0
402;25076;8;0;0;0;0;.00nan;0;0
402;31035;0;52;27;4;23;.852;3600000;0
403;928;20;0;0;0;0;.00nan;0;0
403;15464;32;65;39;4;35;.897;3600000;0
403;16006;32;0;0;0;0;.00nan;0;0
403;18078;20;44;18;3;15;.833;3600000;0
404;1913;30;71;38;4;34;.895;3589000;0
404;4826;30;0;0;0;0;.00nan;0;0
404;13842;34;0;0;0;0;.00nan;0;0
404;15502;34;52;21;3;18;.857;3600000;0
405;323;9;0;0;0;0;.00nan;0;0
405;1796;16;37;15;4;11;.733;1923000;0
405;15437;16;56;11;1;10;.909;1677000;0
405;20853;9;86;32;1;31;.969;3600000;0
406;544;19;0;0;0;0;.00nan;0;0
406;10103;24;68;43;5;38;.884;3900000;0
406;13979;24;0;0;0;0;.00nan;0;0
406;31124;19;33;27;5;22;.815;3900000;0
407;823;23;0;0;0;0;.00nan;0;0
407;4450;5;95;39;1;38;.974;3543000;0
407;10274;23;100;28;0;28;1.000;3600000;0
407;19823;5;0;0;0;0;.00nan;0;0
408;445;12;75;28;2;26;.929;3900000;0
408;724;11;77;26;2;24;.923;3900000;0
408;21522;11;0;0;0;0;.00nan;0;0
408;34786;12;0;0;0;0;.00nan;0;0
409;262;35;92;37;3;34;.919;3600000;0
409;738;27;0;0;0;0;.00nan;0;0
409;1430;35;0;0;0;0;.00nan;0;0
409;26623;27;44;23;5;18;.783;3513000;0
410;1572;4838;90;34;1;33;.971;3900000;0
410;2328;4838;0;0;0;0;.00nan;0;0
410;5883;33;97;43;1;42;.977;3900000;0
410;34740;33;0;0;0;0;.00nan;0;0
411;5385;17;40;29;5;24;.828;3600000;0
411;18104;10;81;24;2;22;.917;3600000;0
411;27488;10;0;0;0;0;.00nan;0;0
411;34006;17;0;0;0;0;.00nan;0;0
412;51;21;0;0;0;0;.00nan;0;0
412;15464;32;0;0;0;0;.00nan;0;0
412;16006;32;84;35;2;33;.943;3900000;0
412;25843;21;72;30;2;28;.933;3900000;0
413;2423;15;0;0;0;0;.00nan;0;0
413;4106;15;69;41;4;37;.902;3535000;0
413;27739;22;82;29;2;27;.931;3600000;0
413;28026;22;0;0;0;0;.00nan;0;0
414;323;9;60;44;6;38;.864;3600000;0
414;1614;25;0;0;0;0;.00nan;0;0
414;5182;25;65;24;2;22;.917;3600000;0
414;20853;9;0;0;0;0;.00nan;0;0
415;61;31;0;0;0;0;.00nan;0;0
415;22601;26;59;26;3;23;.885;3600000;0
415;32754;26;0;0;0;0;.00nan;0;0
415;34797;31;60;33;4;29;.879;3573000;0
416;335;18;0;0;0;0;.00nan;0;0
416;5001;18;57;20;2;18;.900;3600000;0
416;5883;33;0;0;0;0;.00nan;0;0
416;34740;33;50;37;5;32;.865;3600000;0
417;500;4182;77;31;2;29;.935;3886000;0
417;1251;14;79;36;3;33;.917;3895000;0
417;25521;4182;0;0;0;0;.00nan;0;0
417;25584;14;0;0;0;0;.00nan;0;0
418;5385;17;0;0;0;0;.00nan;0;0
418;27739;22;58;27;3;24;.889;3562000;0
418;28026;22;0;0;0;0;.00nan;0;0
418;34006;17;85;40;2;38;.950;3600000;0
419;1821;3;60;39;5;34;.872;3579000;0
419;2054;3;0;0;0;0;.00nan;0;0
419;15505;8;63;28;3;25;.893;3600000;0
419;25076;8;0;0;0;0;.00nan;0;0
420;233;29;0;0;0;0;.00nan;0;0
420;2058;28;74;27;2;25;.926;3536000;0
420;14061;28;0;0;0;0;.00nan;0;0
420;18351;29;82;16;0;16;1.000;3600000;0
421;51;21;96;40;1;39;.975;3900000;0
421;928;20;0;0;0;0;.00nan;0;0
421;18078;20;88;29;1;28;.966;3900000;0
421;25843;21;0;0;0;0;.00nan;0;0
422;1913;30;67;48;6;42;.875;3129000;0
422;2423;15;95;39;1;38;.974;3600000;0
422;4106;15;0;0;0;0;.00nan;0;0
422;4826;30;53;4;0;4;1.000;471000;0
423;1074;0;67;15;1;14;.933;1194000;0
423;1796;16;38;28;5;23;.821;3600000;0
423;15437;16;0;0;0;0;.00nan;0;0
423;31035;0;20;23;6;17;.739;2387000;0
424;544;19;77;43;4;39;.907;3600000;0
424;4450;5;58;19;2;17;.895;3600000;0
424;19823;5;0;0;0;0;.00nan;0;0
424;31124;19;0;0;0;0;.00nan;0;0
425;823;23;0;0;0;0;.00nan;0;0
425;10103;24;0;0;0;0;.00nan;0;0
425;10274;23;72;24;1;23;.958;3600000;0
425;13979;24;79;35;3;32;.914;3573000;0
426;1251;14;0;0;0;0;.00nan;0;0
426;22601;26;0;0;0;0;.00nan;0;0
426;25584;14;70;39;4;35;.897;3600000;0
426;32754;26;93;25;0;25;1.000;3600000;0
427;262;35;90;32;1;31;.969;3600000;0
427;724;11;70;29;2;27;.931;3581000;0
427;1430;35;0;0;0;0;.00nan;0;0
427;21522;11;0;0;0;0;.00nan;0;0
428;445;12;75;37;4;33;.892;3534000;0
428;738;27;0;0;0;0;.00nan;0;0
428;26623;27;84;34;2;32;.941;3600000;0
428;34786;12;0;0;0;0;.00nan;0;0
429;1572;4838;65;15;1;14;.933;1555000;0
429;2328;4838;27;12;4;8;.667;2045000;0
429;13842;34;48;17;2;15;.882;1388000;0
429;15502;34;44;28;4;24;.857;2164000;0
430;15464;32;100;36;0;36;1.000;3600000;0
430;16006;32;0;0;0;0;.00nan;0;0
430;18104;10;81;30;3;27;.900;3600000;0
430;27488;10;0;0;0;0;.00nan;0;0
431;1796;16;0;0;0;0;.00nan;0;0
431;1913;30;0;0;0;0;.00nan;0;0
431;4826;30;67;47;5;42;.894;3600000;0
431;15437;16;95;22;0;22;1.000;3600000;0
432;61;31;0;0;0;0;.00nan;0;0
432;1614;25;0;0;0;0;.00nan;0;0
432;5182;25;91;26;1;25;.962;3600000;0
432;34797;31;75;51;6;45;.882;3600000;0
433;335;18;0;0;0;0;.00nan;0;0
433;5001;18;77;35;3;32;.914;3600000;0
433;10103;24;86;31;2;29;.935;3600000;0
433;13979;24;0;0;0;0;.00nan;0;0
434;262;35;0;0;0;0;.00nan;0;0
434;500;4182;71;22;1;21;.955;3600000;0
434;1430;35;69;39;3;36;.923;3600000;0
434;25521;4182;0;0;0;0;.00nan;0;0
435;544;19;42;35;6;29;.829;3600000;0
435;15505;8;99;40;2;38;.950;3600000;0
435;25076;8;0;0;0;0;.00nan;0;0
435;31124;19;0;0;0;0;.00nan;0;0
436;500;4182;95;46;3;43;.935;3600000;0
436;4450;5;0;0;0;0;.00nan;0;0
436;19823;5;95;21;0;21;1.000;3600000;0
436;25521;4182;0;0;0;0;.00nan;0;0
437;323;9;0;0;0;0;.00nan;0;0
437;928;20;0;0;0;0;.00nan;0;0
437;18078;20;58;19;2;17;.895;3900000;0
437;20853;9;89;44;2;42;.955;3900000;0
438;233;29;0;0;0;0;.00nan;0;0
438;724;11;84;36;2;34;.944;3574000;0
438;18351;29;87;25;1;24;.960;3600000;0
438;21522;11;0;0;0;0;.00nan;0;0
439;61;31;0;0;0;0;.00nan;0;0
439;2058;28;59;31;4;27;.871;3546000;0
439;14061;28;0;0;0;0;.00nan;0;0
439;34797;31;54;22;3;19;.864;3600000;0
440;51;21;90;41;3;38;.927;3900000;0
440;1251;14;77;42;3;39;.929;3900000;0
440;25584;14;0;0;0;0;.00nan;0;0
440;25843;21;0;0;0;0;.00nan;0;0
441;1074;0;0;0;0;0;.00nan;0;0
441;2423;15;0;0;0;0;.00nan;0;0
441;4106;15;71;29;2;27;.931;3600000;0
441;31035;0;82;42;3;39;.929;3548000;0
442;544;19;0;0;0;0;.00nan;0;0
442;15464;32;88;37;3;34;.919;3600000;0
442;16006;32;0;0;0;0;.00nan;0;0
442;31124;19;82;30;2;28;.933;3600000;0
443;445;12;69;25;3;22;.880;3600000;0
443;1796;16;0;0;0;0;.00nan;0;0
443;15437;16;99;36;1;35;.972;3600000;0
443;34786;12;0;0;0;0;.00nan;0;0
444;262;35;96;47;3;44;.936;3862000;0
444;1430;35;0;0;0;0;.00nan;0;0
444;10103;24;0;0;0;0;.00nan;0;0
444;13979;24;72;37;4;33;.892;3862000;0
445;4506;33;91;25;1;24;.960;3600000;0
445;5385;17;0;0;0;0;.00nan;0;0
445;34006;17;65;26;3;23;.885;3530000;0
445;34740;33;0;0;0;0;.00nan;0;0
446;1614;25;0;0;0;0;.00nan;0;0
446;5182;25;91;35;1;34;.971;3600000;0
446;18104;10;59;35;4;31;.886;3600000;0
446;27488;10;0;0;0;0;.00nan;0;0
447;823;23;72;34;3;31;.912;3600000;0
447;1821;3;95;48;4;44;.917;3600000;0
447;2054;3;0;0;0;0;.00nan;0;0
447;10274;23;0;0;0;0;.00nan;0;0
448;335;18;0;0;0;0;.00nan;0;0
448;5001;18;74;27;2;25;.926;3600000;0
448;13842;34;0;0;0;0;.00nan;0;0
448;15502;34;71;41;4;37;.902;3517000;0
449;738;27;0;0;0;0;.00nan;0;0
449;1572;4838;0;0;0;0;.00nan;0;0
449;2328;4838;79;35;3;32;.914;3600000;0
449;26623;27;65;36;4;32;.889;3560000;0
450;15505;8;0;0;0;0;.00nan;0;0
450;25076;8;64;33;4;29;.879;3600000;0
450;27739;22;94;34;1;33;.971;3600000;0
450;28026;22;0;0;0;0;.00nan;0;0
451;18104;10;0;0;0;0;.00nan;0;0
451;22601;26;0;0;0;0;.00nan;0;0
451;27488;10;90;31;1;30;.968;3600000;0
451;32754;26;85;34;2;32;.941;3580000;0
452;1572;4838;33;32;6;26;.813;3600000;0
452;1913;30;0;0;0;0;.00nan;0;0
452;2328;4838;0;0;0;0;.00nan;0;0
452;4826;30;91;28;1;27;.964;3600000;0
453;1074;0;0;0;0;0;.00nan;0;0
453;1251;14;0;0;0;0;.00nan;0;0
453;25584;14;76;31;2;29;.935;3600000;0
453;31035;0;41;33;6;27;.818;3600000;0
454;233;29;54;18;2;16;.889;3600000;0
454;2058;28;49;40;6;34;.850;3167000;0
454;14061;28;49;6;1;5;.833;433000;0
454;18351;29;0;0;0;0;.00nan;0;0
455;61;31;0;0;0;0;.00nan;0;0
455;724;11;66;33;3;30;.909;3600000;0
455;21522;11;0;0;0;0;.00nan;0;0
455;34797;31;56;27;4;23;.852;3597000;0
456;51;21;69;33;3;30;.909;3550000;0
456;500;4182;72;21;1;20;.952;3600000;0
456;25521;4182;0;0;0;0;.00nan;0;0
456;25843;21;0;0;0;0;.00nan;0;0
457;928;20;65;31;4;27;.871;3764000;0
457;4450;5;0;0;0;0;.00nan;0;0
457;18078;20;0;0;0;0;.00nan;0;0
457;19823;5;47;34;5;29;.853;3764000;0
458;323;9;0;0;0;0;.00nan;0;0
458;10103;24;0;0;0;0;.00nan;0;0
458;13979;24;100;32;0;32;1.000;3600000;0
458;20853;9;80;38;4;34;.895;3600000;0
459;1614;25;90;28;1;27;.964;3600000;0
459;5182;25;0;0;0;0;.00nan;0;0
459;15464;32;53;29;4;25;.862;3600000;0
459;16006;32;0;0;0;0;.00nan;0;0
460;262;35;88;36;2;34;.944;3600000;0
460;1430;35;0;0;0;0;.00nan;0;0
460;5385;17;0;0;0;0;.00nan;0;0
460;34006;17;43;33;5;28;.848;3567000;0
461;544;19;0;0;0;0;.00nan;0;0
461;1821;3;63;33;4;29;.879;3600000;0
461;2054;3;0;0;0;0;.00nan;0;0
461;31124;19;45;35;6;29;.829;3595000;0
462;823;23;0;0;0;0;.00nan;0;0
462;10274;23;73;35;3;32;.914;3600000;0
462;13842;34;71;38;4;34;.895;3600000;0
462;15502;34;0;0;0;0;.00nan;0;0
463;335;18;0;0;0;0;.00nan;0;0
463;738;27;0;0;0;0;.00nan;0;0
463;5001;18;100;27;0;27;1.000;3600000;0
463;26623;27;95;43;2;41;.953;3600000;0
464;500;4182;77;29;3;26;.897;3570000;0
464;18104;10;72;31;2;29;.935;3600000;0
464;25521;4182;0;0;0;0;.00nan;0;0
464;27488;10;0;0;0;0;.00nan;0;0
465;2423;15;0;0;0;0;.00nan;0;0
465;4106;15;67;23;2;21;.913;3600000;0
465;5385;17;25;20;6;14;.700;2051000;0
465;34006;17;48;20;3;17;.850;1549000;0
466;15464;32;0;0;0;0;.00nan;0;0
466;15505;8;58;41;5;36;.878;3555000;0
466;16006;32;47;23;4;19;.826;3600000;0
466;25076;8;0;0;0;0;.00nan;0;0
467;445;12;100;39;1;38;.974;3600000;0
467;1796;16;55;21;2;19;.905;3563000;0
467;15437;16;0;0;0;0;.00nan;0;0
467;34786;12;0;0;0;0;.00nan;0;0
468;4506;33;98;52;3;49;.942;3519000;0
468;27739;22;87;28;1;27;.964;3600000;0
468;28026;22;0;0;0;0;.00nan;0;0
468;34740;33;0;0;0;0;.00nan;0;0
469;1913;30;70;19;1;18;.947;3600000;0
469;4826;30;0;0;0;0;.00nan;0;0
469;22601;26;69;33;2;31;.939;3600000;0
469;32754;26;0;0;0;0;.00nan;0;0
470;1074;0;0;0;0;0;.00nan;0;0
470;4450;5;36;19;4;15;.789;3600000;0
470;19823;5;0;0;0;0;.00nan;0;0
470;31035;0;100;51;1;50;.980;3600000;0
471;51;21;40;31;6;25;.806;3527000;0
471;323;9;65;36;4;32;.889;3600000;0
471;20853;9;0;0;0;0;.00nan;0;0
471;25843;21;0;0;0;0;.00nan;0;0
472;1251;14;80;34;2;32;.941;3591000;0
472;2058;28;100;45;1;44;.978;3600000;0
472;14061;28;0;0;0;0;.00nan;0;0
472;25584;14;0;0;0;0;.00nan;0;0
473;724;11;80;32;3;29;.906;3600000;0
473;10103;24;0;0;0;0;.00nan;0;0
473;13979;24;67;43;4;39;.907;3600000;0
473;21522;11;0;0;0;0;.00nan;0;0
474;445;12;0;0;0;0;.00nan;0;0
474;15505;8;0;0;0;0;.00nan;0;0
474;25076;8;96;38;2;36;.947;3600000;0
474;34786;12;77;21;1;20;.952;3600000;0
475;61;31;40;31;5;26;.839;3600000;0
475;262;35;93;34;1;33;.971;3600000;0
475;1430;35;0;0;0;0;.00nan;0;0
475;34797;31;0;0;0;0;.00nan;0;0
476;233;29;57;5;0;5;1.000;427000;0
476;1614;25;0;0;0;0;.00nan;0;0
476;5182;25;70;33;3;30;.909;3600000;0
476;18351;29;18;25;6;19;.760;3173000;0
477;544;19;78;26;2;24;.923;3641000;0
477;13842;34;0;0;0;0;.00nan;0;0
477;15502;34;99;39;1;38;.974;3641000;0
477;31124;19;0;0;0;0;.00nan;0;0
478;335;18;0;0;0;0;.00nan;0;0
478;1821;3;60;40;5;35;.875;3600000;0
478;2054;3;0;0;0;0;.00nan;0;0
478;5001;18;77;29;2;27;.931;3600000;0
479;823;23;77;38;3;35;.921;3581000;0
479;1572;4838;0;0;0;0;.00nan;0;0
479;2328;4838;86;32;2;30;.938;3600000;0
479;10274;23;0;0;0;0;.00nan;0;0
480;2058;28;0;0;0;0;.00nan;0;0
480;4450;5;0;0;0;0;.00nan;0;0
480;14061;28;73;26;1;25;.962;3600000;0
480;19823;5;78;25;2;23;.920;3590000;0
481;51;21;0;0;0;0;.00nan;0;0
481;2423;15;71;22;1;21;.955;3600000;0
481;4106;15;0;0;0;0;.00nan;0;0
481;25843;21;62;36;4;32;.889;3600000;0
482;500;4182;88;52;4;48;.923;3600000;0
482;928;20;0;0;0;0;.00nan;0;0
482;18078;20;100;21;0;21;1.000;3600000;0
482;25521;4182;0;0;0;0;.00nan;0;0
483;724;11;0;0;0;0;.00nan;0;0
483;21522;11;60;41;4;37;.902;3576000;0
483;27739;22;68;29;2;27;.931;3600000;0
483;28026;22;0;0;0;0;.00nan;0;0
484;10103;24;0;0;0;0;.00nan;0;0
484;13979;24;70;24;2;22;.917;3600000;0
484;15464;32;56;37;5;32;.865;3600000;0
484;16006;32;0;0;0;0;.00nan;0;0
485;1796;16;66;30;3;27;.900;3573000;0
485;4506;33;81;31;2;29;.935;3600000;0
485;15437;16;0;0;0;0;.00nan;0;0
485;34740;33;0;0;0;0;.00nan;0;0
486;335;18;75;29;2;27;.931;3600000;0
486;5001;18;0;0;0;0;.00nan;0;0
486;22601;26;0;0;0;0;.00nan;0;0
486;32754;26;96;49;3;46;.939;3562000;0
487;1572;4838;92;31;1;30;.968;3600000;0
487;1821;3;0;0;0;0;.00nan;0;0
487;2054;3;45;21;4;17;.810;3600000;0
487;2328;4838;0;0;0;0;.00nan;0;0
488;5385;17;0;0;0;0;.00nan;0;0
488;13842;34;75;39;4;35;.897;3900000;0
488;15502;34;0;0;0;0;.00nan;0;0
488;34006;17;44;28;4;24;.857;3900000;0
489;323;9;77;47;4;43;.915;3553000;0
489;1614;25;0;0;0;0;.00nan;0;0
489;5182;25;99;40;2;38;.950;3600000;0
489;20853;9;0;0;0;0;.00nan;0;0
490;928;20;0;0;0;0;.00nan;0;0
490;1074;0;68;25;3;22;.880;2826000;0
490;18078;20;93;23;0;23;1.000;3600000;0
490;31035;0;21;11;4;7;.636;774000;0
491;262;35;94;38;2;36;.947;3600000;0
491;445;12;41;25;4;21;.840;3548000;0
491;1430;35;0;0;0;0;.00nan;0;0
491;34786;12;0;0;0;0;.00nan;0;0
492;823;23;0;0;0;0;.00nan;0;0
492;1913;30;32;15;4;11;.733;1071000;0
492;4826;30;82;26;2;24;.923;2529000;0
492;10274;23;88;35;1;34;.971;3600000;0
493;4450;5;64;28;3;25;.893;3595000;0
493;10103;24;0;0;0;0;.00nan;0;0
493;13979;24;94;31;1;30;.968;3600000;0
493;19823;5;0;0;0;0;.00nan;0;0
494;1796;16;54;20;2;18;.900;3570000;0
494;2058;28;84;25;1;24;.960;3600000;0
494;14061;28;0;0;0;0;.00nan;0;0
494;15437;16;0;0;0;0;.00nan;0;0
495;1251;14;0;0;0;0;.00nan;0;0
495;25584;14;59;26;3;23;.885;3600000;0
495;27739;22;35;27;6;21;.778;3303000;0
495;28026;22;49;1;0;1;1.000;297000;0
496;51;21;97;53;3;50;.943;3900000;0
496;2423;15;0;0;0;0;.00nan;0;0
496;4106;15;56;20;3;17;.850;3900000;0
496;25843;21;0;0;0;0;.00nan;0;0
497;61;31;0;0;0;0;.00nan;0;0
497;15505;8;81;41;3;38;.927;3600000;0
497;25076;8;0;0;0;0;.00nan;0;0
497;34797;31;59;35;4;31;.886;3545000;0
498;4506;33;85;43;3;40;.930;3600000;0
498;15464;32;99;24;0;24;1.000;3600000;0
498;16006;32;0;0;0;0;.00nan;0;0
498;34740;33;0;0;0;0;.00nan;0;0
499;544;19;73;25;2;23;.920;3600000;0
499;1913;30;80;45;4;41;.911;3534000;0
499;4826;30;0;0;0;0;.00nan;0;0
499;31124;19;0;0;0;0;.00nan;0;0
500;233;29;0;0;0;0;.00nan;0;0
500;500;4182;90;36;2;34;.944;3600000;0
500;18351;29;80;35;3;32;.914;3580000;0
500;25521;4182;0;0;0;0;.00nan;0;0
501;335;18;0;0;0;0;.00nan;0;0
501;738;27;0;0;0;0;.00nan;0;0
501;5001;18;79;47;4;43;.915;3871000;0
501;26623;27;41;16;3;13;.813;3871000;0
502;1572;4838;0;0;0;0;.00nan;0;0
502;2328;4838;75;23;2;21;.913;3600000;0
502;22601;26;71;36;4;32;.889;3600000;0
502;32754;26;0;0;0;0;.00nan;0;0
503;1614;25;89;32;1;31;.969;3600000;0
503;5182;25;0;0;0;0;.00nan;0;0
503;5385;17;0;0;0;0;.00nan;0;0
503;34006;17;91;47;3;44;.936;3587000;0
504;1074;0;0;0;0;0;.00nan;0;0
504;18104;10;39;28;5;23;.821;3574000;0
504;27488;10;0;0;0;0;.00nan;0;0
504;31035;0;76;37;4;33;.892;3600000;0
505;445;12;75;40;5;35;.875;3600000;0
505;4506;33;0;0;0;0;.00nan;0;0
505;34740;33;52;18;2;16;.889;3600000;0
505;34786;12;0;0;0;0;.00nan;0;0
506;724;11;91;33;1;32;.970;3600000;0
506;823;23;0;0;0;0;.00nan;0;0
506;10274;23;83;34;2;32;.941;3600000;0
506;21522;11;0;0;0;0;.00nan;0;0
507;1614;25;0;0;0;0;.00nan;0;0
507;4450;5;0;0;0;0;.00nan;0;0
507;5182;25;37;41;7;34;.829;3600000;0
507;19823;5;55;19;3;16;.842;3600000;0
508;1796;16;44;30;5;25;.833;3600000;0
508;1821;3;69;21;2;19;.905;3600000;0
508;2054;3;0;0;0;0;.00nan;0;0
508;15437;16;0;0;0;0;.00nan;0;0
509;2058;28;0;0;0;0;.00nan;0;0
509;10103;24;0;0;0;0;.00nan;0;0
509;13979;24;100;26;0;26;1.000;3600000;0
509;14061;28;87;32;1;31;.969;3584000;0
510;61;31;0;0;0;0;.00nan;0;0
510;15464;32;99;51;2;49;.961;3900000;0
510;16006;32;0;0;0;0;.00nan;0;0
510;34797;31;61;25;2;23;.920;3900000;0
511;51;21;83;41;3;38;.927;3600000;0
511;1074;0;87;32;2;30;.938;3600000;0
511;25843;21;0;0;0;0;.00nan;0;0
511;31035;0;0;0;0;0;.00nan;0;0
512;928;20;0;0;0;0;.00nan;0;0
512;18078;20;69;20;1;19;.950;3900000;0
512;27739;22;100;40;1;39;.975;3900000;0
512;28026;22;0;0;0;0;.00nan;0;0
513;1251;14;81;16;0;16;1.000;1907000;0
513;2423;15;27;28;5;23;.821;3900000;0
513;4106;15;0;0;0;0;.00nan;0;0
513;25584;14;27;20;5;15;.750;1993000;0
514;5385;17;100;48;1;47;.979;3600000;0
514;13842;34;57;22;2;20;.909;3544000;0
514;15502;34;0;0;0;0;.00nan;0;0
514;34006;17;0;0;0;0;.00nan;0;0
515;445;12;0;0;0;0;.00nan;0;0
515;15505;8;90;41;3;38;.927;3600000;0
515;25076;8;0;0;0;0;.00nan;0;0
515;34786;12;53;20;2;18;.900;3600000;0
516;262;35;42;36;5;31;.861;3900000;0
516;323;9;0;0;0;0;.00nan;0;0
516;1430;35;0;0;0;0;.00nan;0;0
516;20853;9;63;32;5;27;.844;3900000;0
517;544;19;0;0;0;0;.00nan;0;0
517;1572;4838;0;0;0;0;.00nan;0;0
517;2328;4838;75;29;2;27;.931;3570000;0
517;31124;19;100;28;0;28;1.000;3600000;0
518;233;29;0;0;0;0;.00nan;0;0
518;18351;29;82;13;0;13;1.000;3600000;0
518;22601;26;92;50;3;47;.940;3600000;0
518;32754;26;0;0;0;0;.00nan;0;0
519;335;18;0;0;0;0;.00nan;0;0
519;1913;30;0;0;0;0;.00nan;0;0
519;4826;30;100;35;1;34;.971;3600000;0
519;5001;18;79;27;2;25;.926;3600000;0
520;500;4182;66;31;3;28;.903;3570000;0
520;724;11;78;28;2;26;.929;3600000;0
520;21522;11;0;0;0;0;.00nan;0;0
520;25521;4182;0;0;0;0;.00nan;0;0
521;738;27;0;0;0;0;.00nan;0;0
521;823;23;83;28;1;27;.964;3600000;0
521;10274;23;0;0;0;0;.00nan;0;0
521;26623;27;54;19;2;17;.895;3545000;0
522;2423;15;0;0;0;0;.00nan;0;0
522;4106;15;97;30;1;29;.967;3600000;0
522;4450;5;0;0;0;0;.00nan;0;0
522;19823;5;79;35;3;32;.914;3547000;0
523;928;20;0;0;0;0;.00nan;0;0
523;5385;17;0;0;0;0;.00nan;0;0
523;18078;20;65;35;4;31;.886;3592000;0
523;34006;17;72;30;2;28;.933;3600000;0
524;323;9;0;0;0;0;.00nan;0;0
524;18104;10;72;25;1;24;.960;3600000;0
524;20853;9;72;37;3;34;.919;3519000;0
524;27488;10;0;0;0;0;.00nan;0;0
525;2058;28;80;40;3;37;.925;3600000;0
525;14061;28;0;0;0;0;.00nan;0;0
525;27739;22;0;0;0;0;.00nan;0;0
525;28026;22;89;19;0;19;1.000;3600000;0
526;61;31;25;6;3;3;.500;563000;0
526;10103;24;0;0;0;0;.00nan;0;0
526;13979;24;82;46;4;42;.913;3600000;0
526;34797;31;51;24;4;20;.833;3037000;0
527;1821;3;61;33;4;29;.879;3600000;0
527;2054;3;0;0;0;0;.00nan;0;0
527;13842;34;55;35;5;30;.857;3562000;0
527;15502;34;0;0;0;0;.00nan;0;0
528;51;21;100;41;0;41;1.000;3600000;0
528;1796;16;59;27;3;24;.889;3600000;0
528;15437;16;0;0;0;0;.00nan;0;0
528;25843;21;0;0;0;0;.00nan;0;0
529;445;12;89;26;2;24;.923;3900000;0
529;15464;32;88;39;2;37;.949;3900000;0
529;16006;32;0;0;0;0;.00nan;0;0
529;34786;12;0;0;0;0;.00nan;0;0
530;262;35;67;43;4;39;.907;3600000;0
530;1430;35;0;0;0;0;.00nan;0;0
530;4506;33;79;26;1;25;.962;3600000;0
530;34740;33;0;0;0;0;.00nan;0;0
531;544;19;0;0;0;0;.00nan;0;0
531;823;23;32;27;6;21;.778;2998000;0
531;10274;23;50;1;0;1;1.000;548000;0
531;31124;19;95;48;4;44;.917;3600000;0
532;724;11;89;34;2;32;.941;3900000;0
532;21522;11;0;0;0;0;.00nan;0;0
532;22601;26;100;45;2;43;.956;3900000;0
532;32754;26;0;0;0;0;.00nan;0;0
533;335;18;0;0;0;0;.00nan;0;0
533;1572;4838;0;0;0;0;.00nan;0;0
533;2328;4838;61;34;3;31;.912;3552000;0
533;5001;18;84;27;1;26;.963;3600000;0
534;500;4182;93;28;1;27;.964;3600000;0
534;1614;25;98;50;2;48;.960;3578000;0
534;5182;25;0;0;0;0;.00nan;0;0
534;25521;4182;0;0;0;0;.00nan;0;0
535;738;27;62;21;2;19;.905;3567000;0
535;1913;30;0;0;0;0;.00nan;0;0
535;4826;30;99;43;1;42;.977;3600000;0
535;26623;27;0;0;0;0;.00nan;0;0
536;233;29;0;0;0;0;.00nan;0;0
536;1074;0;0;0;0;0;.00nan;0;0
536;18351;29;54;26;4;22;.846;3565000;0
536;31035;0;83;48;3;45;.938;3600000;0
537;13842;34;0;0;0;0;.00nan;0;0
537;15502;34;94;31;1;30;.968;3600000;0
537;15505;8;52;36;5;31;.861;3600000;0
537;25076;8;0;0;0;0;.00nan;0;0
538;500;4182;73;22;2;20;.909;3900000;0
538;724;11;97;51;2;49;.961;3900000;0
538;21522;11;0;0;0;0;.00nan;0;0
538;25521;4182;0;0;0;0;.00nan;0;0
539;738;27;0;0;0;0;.00nan;0;0
539;22601;26;0;0;0;0;.00nan;0;0
539;26623;27;75;31;2;29;.935;3600000;0
539;32754;26;86;41;3;38;.927;3561000;0
540;51;21;68;26;2;24;.923;3565000;0
540;5385;17;0;0;0;0;.00nan;0;0
540;25843;21;0;0;0;0;.00nan;0;0
540;34006;17;90;33;1;32;.970;3600000;0
541;1821;3;100;36;1;35;.972;3900000;0
541;2054;3;0;0;0;0;.00nan;0;0
541;2423;15;0;0;0;0;.00nan;0;0
541;4106;15;82;25;1;24;.960;3900000;0
542;2058;28;93;42;2;40;.952;3600000;0
542;4450;5;69;33;3;30;.909;3600000;0
542;14061;28;0;0;0;0;.00nan;0;0
542;19823;5;0;0;0;0;.00nan;0;0
543;61;31;0;0;0;0;.00nan;0;0
543;18104;10;74;39;3;36;.923;3569000;0
543;27488;10;0;0;0;0;.00nan;0;0
543;34797;31;82;28;1;27;.964;3600000;0
544;323;9;61;36;5;31;.861;3600000;0
544;928;20;0;0;0;0;.00nan;0;0
544;18078;20;70;19;1;18;.947;3600000;0
544;20853;9;0;0;0;0;.00nan;0;0
545;15464;32;94;41;2;39;.951;3600000;0
545;16006;32;0;0;0;0;.00nan;0;0
545;27739;22;0;0;0;0;.00nan;0;0
545;28026;22;69;33;3;30;.909;3572000;0
546;823;23;0;0;0;0;.00nan;0;0
546;1796;16;91;36;1;35;.972;3600000;0
546;10274;23;71;45;4;41;.911;3600000;0
546;15437;16;0;0;0;0;.00nan;0;0
547;4506;33;67;24;2;22;.917;3600000;0
547;15505;8;0;0;0;0;.00nan;0;0
547;25076;8;99;34;1;33;.971;3600000;0
547;34740;33;0;0;0;0;.00nan;0;0
548;445;12;94;47;2;45;.957;3900000;0
548;1614;25;0;0;0;0;.00nan;0;0
548;5182;25;82;26;1;25;.962;3900000;0
548;34786;12;0;0;0;0;.00nan;0;0
549;335;18;0;0;0;0;.00nan;0;0
549;1913;30;0;0;0;0;.00nan;0;0
549;4826;30;73;33;2;31;.939;3573000;0
549;5001;18;70;19;1;18;.947;3600000;0
550;1251;14;57;25;3;22;.880;3534000;0
550;1572;4838;0;0;0;0;.00nan;0;0
550;2328;4838;100;44;1;43;.977;3600000;0
550;25584;14;0;0;0;0;.00nan;0;0
551;61;31;30;28;6;22;.786;2706000;0
551;233;29;0;0;0;0;.00nan;0;0
551;18351;29;71;20;1;19;.950;3600000;0
551;34797;31;54;5;0;5;1.000;894000;0
552;928;20;65;27;3;24;.889;3900000;0
552;5385;17;68;40;3;37;.925;3900000;0
552;18078;20;0;0;0;0;.00nan;0;0
552;34006;17;0;0;0;0;.00nan;0;0
553;1074;0;0;0;0;0;.00nan;0;0
553;10103;24;0;0;0;0;.00nan;0;0
553;13979;24;94;36;2;34;.944;3600000;0
553;31035;0;62;40;6;34;.850;3600000;0
554;13842;34;67;31;3;28;.903;3576000;0
554;15464;32;0;0;0;0;.00nan;0;0
554;15502;34;0;0;0;0;.00nan;0;0
554;16006;32;80;22;1;21;.955;3600000;0
555;335;18;0;0;0;0;.00nan;0;0
555;724;11;86;29;1;28;.966;3600000;0
555;5001;18;73;33;3;30;.909;3600000;0
555;21522;11;0;0;0;0;.00nan;0;0
556;738;27;0;0;0;0;.00nan;0;0
556;1251;14;0;0;0;0;.00nan;0;0
556;25584;14;49;38;5;33;.868;3538000;0
556;26623;27;74;37;3;34;.919;3600000;0
557;544;19;40;17;3;14;.824;3600000;0
557;1572;4838;70;44;5;39;.886;3536000;0
557;2328;4838;0;0;0;0;.00nan;0;0
557;31124;19;0;0;0;0;.00nan;0;0
558;2058;28;0;0;0;0;.00nan;0;0
558;2423;15;0;0;0;0;.00nan;0;0
558;4106;15;76;37;3;34;.919;3733000;0
558;14061;28;78;32;2;30;.938;3733000;0
559;323;9;62;34;4;30;.882;3600000;0
559;20853;9;0;0;0;0;.00nan;0;0
559;27739;22;100;27;0;27;1.000;3600000;0
559;28026;22;0;0;0;0;.00nan;0;0
560;233;29;67;28;2;26;.929;3865000;0
560;18104;10;85;40;3;37;.925;3865000;0
560;18351;29;0;0;0;0;.00nan;0;0
560;27488;10;0;0;0;0;.00nan;0;0
561;51;21;77;33;3;30;.909;3600000;0
561;823;23;73;21;1;20;.952;2429000;0
561;10274;23;38;22;4;18;.818;1154000;0
561;25843;21;0;0;0;0;.00nan;0;0
562;445;12;33;11;3;8;.727;311000;0
562;1614;25;86;34;2;32;.941;3600000;0
562;5182;25;0;0;0;0;.00nan;0;0
562;34786;12;74;32;2;30;.938;3289000;0
563;544;19;0;0;0;0;.00nan;0;0
563;4506;33;75;26;2;24;.923;3600000;0
563;31124;19;80;37;3;34;.919;3571000;0
563;34740;33;0;0;0;0;.00nan;0;0
564;500;4182;94;19;0;19;1.000;3600000;0
564;1913;30;20;26;6;20;.769;1706000;0
564;4826;30;48;18;3;15;.833;1894000;0
564;25521;4182;0;0;0;0;.00nan;0;0
565;4450;5;0;0;0;0;.00nan;0;0
565;5385;17;58;37;5;32;.865;3600000;0
565;19823;5;84;26;1;25;.962;3600000;0
565;34006;17;0;0;0;0;.00nan;0;0
566;1821;3;77;32;3;29;.906;3900000;0
566;2054;3;0;0;0;0;.00nan;0;0
566;2058;28;51;31;3;28;.903;3900000;0
566;14061;28;0;0;0;0;.00nan;0;0
567;61;31;0;0;0;0;.00nan;0;0
567;1074;0;0;0;0;0;.00nan;0;0
567;31035;0;82;38;3;35;.921;3595000;0
567;34797;31;58;20;2;18;.900;3600000;0
568;823;23;0;0;0;0;.00nan;0;0
568;928;20;0;0;0;0;.00nan;0;0
568;10274;23;99;36;1;35;.972;3600000;0
568;18078;20;68;31;3;28;.903;3534000;0
569;10103;24;0;0;0;0;.00nan;0;0
569;13842;34;0;0;0;0;.00nan;0;0
569;13979;24;90;48;4;44;.917;3600000;0
569;15502;34;91;33;1;32;.970;3600000;0
570;15464;32;74;31;3;28;.903;3653000;0
570;15505;8;95;38;2;36;.947;3653000;0
570;16006;32;0;0;0;0;.00nan;0;0
570;25076;8;0;0;0;0;.00nan;0;0
571;262;35;57;35;5;30;.857;3600000;0
571;1430;35;0;0;0;0;.00nan;0;0
571;1796;16;95;27;1;26;.963;3600000;0
571;15437;16;0;0;0;0;.00nan;0;0
572;724;11;0;0;0;0;.00nan;0;0
572;1251;14;0;0;0;0;.00nan;0;0
572;21522;11;65;25;3;22;.880;3600000;0
572;25584;14;50;33;5;28;.848;3551000;0
573;335;18;0;0;0;0;.00nan;0;0
573;1572;4838;0;0;0;0;.00nan;0;0
573;2328;4838;100;32;0;32;1.000;3600000;0
573;5001;18;82;33;2;31;.939;3589000;0
574;323;9;88;36;2;34;.944;3600000;0
574;4450;5;54;25;3;22;.880;3537000;0
574;19823;5;0;0;0;0;.00nan;0;0
574;20853;9;0;0;0;0;.00nan;0;0
575;233;29;0;0;0;0;.00nan;0;0
575;18104;10;76;50;5;45;.900;3600000;0
575;18351;29;76;27;2;25;.926;3600000;0
575;27488;10;0;0;0;0;.00nan;0;0
576;738;27;61;8;0;8;1.000;1004000;0
576;2423;15;0;0;0;0;.00nan;0;0
576;4106;15;71;32;3;29;.906;3600000;0
576;26623;27;37;29;6;23;.793;2596000;0
577;51;21;93;44;1;43;.977;3600000;0
577;25843;21;0;0;0;0;.00nan;0;0
577;27739;22;72;33;2;31;.939;3548000;0
577;28026;22;0;0;0;0;.00nan;0;0
578;544;19;0;0;0;0;.00nan;0;0
578;15505;8;0;0;0;0;.00nan;0;0
578;25076;8;68;27;2;25;.926;3900000;0
578;31124;19;72;25;2;23;.920;3900000;0
579;1614;25;0;0;0;0;.00nan;0;0
579;1913;30;0;0;0;0;.00nan;0;0
579;4826;30;99;55;1;54;.982;3600000;0
579;5182;25;66;23;2;21;.913;3600000;0
580;445;12;0;0;0;0;.00nan;0;0
580;22601;26;95;16;0;16;1.000;3600000;0
580;32754;26;0;0;0;0;.00nan;0;0
580;34786;12;66;31;3;28;.903;3600000;0
581;500;4182;82;24;1;23;.958;3663000;0
581;4506;33;94;51;2;49;.961;3663000;0
581;25521;4182;0;0;0;0;.00nan;0;0
581;34740;33;0;0;0;0;.00nan;0;0
582;1821;3;0;0;0;0;.00nan;0;0
582;2054;3;75;25;2;23;.920;3600000;0
582;10103;24;71;26;2;24;.923;1305000;0
582;13979;24;25;33;7;26;.788;2295000;0
583;262;35;82;27;1;26;.963;3547000;0
583;1430;35;0;0;0;0;.00nan;0;0
583;2058;28;0;0;0;0;.00nan;0;0
583;14061;28;98;26;0;26;1.000;3600000;0
584;823;23;0;0;0;0;.00nan;0;0
584;10274;23;74;25;2;23;.920;3600000;0
584;18104;10;0;0;0;0;.00nan;0;0
584;27488;10;73;34;3;31;.912;3570000;0
585;51;21;59;37;5;32;.865;3600000;0
585;4450;5;0;0;0;0;.00nan;0;0
585;19823;5;68;20;1;19;.950;3600000;0
585;25843;21;0;0;0;0;.00nan;0;0
586;1074;0;0;0;0;0;.00nan;0;0
586;27739;22;56;24;3;21;.875;3900000;0
586;28026;22;0;0;0;0;.00nan;0;0
586;31035;0;88;41;3;38;.927;3900000;0
587;323;9;70;30;3;27;.900;3600000;0
587;738;27;0;0;0;0;.00nan;0;0
587;20853;9;0;0;0;0;.00nan;0;0
587;26623;27;96;22;0;22;1.000;3600000;0
588;61;31;0;0;0;0;.00nan;0;0
588;544;19;0;0;0;0;.00nan;0;0
588;31124;19;53;21;3;18;.857;3521000;0
588;34797;31;97;38;1;37;.974;3600000;0
589;233;29;0;0;0;0;.00nan;0;0
589;13842;34;0;0;0;0;.00nan;0;0
589;15502;34;98;37;2;35;.946;3900000;0
589;18351;29;71;27;2;25;.926;3900000;0
590;1614;25;77;32;2;30;.938;3900000;0
590;5182;25;0;0;0;0;.00nan;0;0
590;15505;8;100;44;2;42;.955;3900000;0
590;25076;8;0;0;0;0;.00nan;0;0
591;4506;33;61;30;4;26;.867;3600000;0
591;22601;26;34;33;6;27;.818;3600000;0
591;32754;26;0;0;0;0;.00nan;0;0
591;34740;33;0;0;0;0;.00nan;0;0
592;500;4182;77;30;2;28;.933;3900000;0
592;15464;32;95;39;2;37;.949;3900000;0
592;16006;32;0;0;0;0;.00nan;0;0
592;25521;4182;0;0;0;0;.00nan;0;0
593;1251;14;0;0;0;0;.00nan;0;0
593;1913;30;100;42;1;41;.976;3600000;0
593;4826;30;0;0;0;0;.00nan;0;0
593;25584;14;73;27;2;25;.926;3600000;0
594;928;20;0;0;0;0;.00nan;0;0
594;1572;4838;0;0;0;0;.00nan;0;0
594;2328;4838;92;50;3;47;.940;3585000;0
594;18078;20;69;19;1;18;.947;3600000;0
595;823;23;0;0;0;0;.00nan;0;0
595;1821;3;76;37;4;33;.892;3600000;0
595;2054;3;0;0;0;0;.00nan;0;0
595;10274;23;83;49;3;46;.939;3600000;0
596;1796;16;69;21;1;20;.952;3600000;0
596;2423;15;61;30;3;27;.900;3578000;0
596;4106;15;0;0;0;0;.00nan;0;0
596;15437;16;0;0;0;0;.00nan;0;0
597;335;18;0;0;0;0;.00nan;0;0
597;928;20;94;36;1;35;.972;3600000;0
597;5001;18;89;34;2;32;.941;3600000;0
597;18078;20;0;0;0;0;.00nan;0;0
598;262;35;70;33;3;30;.909;3551000;0
598;1430;35;0;0;0;0;.00nan;0;0
598;4450;5;0;0;0;0;.00nan;0;0
598;19823;5;80;31;2;29;.935;3600000;0
599;738;27;0;0;0;0;.00nan;0;0
599;5385;17;0;0;0;0;.00nan;0;0
599;26623;27;96;35;1;34;.971;3900000;0
599;34006;17;98;39;1;38;.974;3900000;0
600;1074;0;0;0;0;0;.00nan;0;0
600;1821;3;0;0;0;0;.00nan;0;0
600;2054;3;72;29;2;27;.931;3596000;0
600;31035;0;100;38;1;37;.974;3600000;0
601;233;29;0;0;0;0;.00nan;0;0
601;544;19;0;0;0;0;.00nan;0;0
601;18351;29;50;31;5;26;.839;3571000;0
601;31124;19;91;43;3;40;.930;3600000;0
602;51;21;75;27;2;25;.926;3600000;0
602;13842;34;71;39;4;35;.897;3539000;0
602;15502;34;0;0;0;0;.00nan;0;0
602;25843;21;0;0;0;0;.00nan;0;0
603;1251;14;85;46;3;43;.935;3600000;0
603;2423;15;0;0;0;0;.00nan;0;0
603;4106;15;100;24;0;24;1.000;3600000;0
603;25584;14;0;0;0;0;.00nan;0;0
604;61;31;0;0;0;0;.00nan;0;0
604;445;12;53;22;3;19;.864;3569000;0
604;34786;12;0;0;0;0;.00nan;0;0
604;34797;31;96;42;2;40;.952;3600000;0
605;1614;25;0;0;0;0;.00nan;0;0
605;4506;33;82;33;2;31;.939;3775000;0
605;5182;25;66;34;3;31;.912;3775000;0
605;34740;33;0;0;0;0;.00nan;0;0
606;15505;8;61;40;4;36;.900;3545000;0
606;22601;26;82;42;3;39;.929;3600000;0
606;25076;8;0;0;0;0;.00nan;0;0
606;32754;26;0;0;0;0;.00nan;0;0
607;500;4182;83;26;2;24;.923;3600000;0
607;18104;10;78;37;3;34;.919;3600000;0
607;25521;4182;0;0;0;0;.00nan;0;0
607;27488;10;0;0;0;0;.00nan;0;0
608;323;9;95;31;2;29;.935;3900000;0
608;1913;30;0;0;0;0;.00nan;0;0
608;4826;30;100;37;2;35;.946;3900000;0
608;20853;9;0;0;0;0;.00nan;0;0
609;724;11;74;40;4;36;.900;3600000;0
609;15464;32;100;35;1;34;.971;3600000;0
609;16006;32;0;0;0;0;.00nan;0;0
609;21522;11;0;0;0;0;.00nan;0;0
610;1572;4838;0;0;0;0;.00nan;0;0
610;2058;28;0;0;0;0;.00nan;0;0
610;2328;4838;69;32;4;28;.875;3600000;0
610;14061;28;68;32;3;29;.906;3600000;0
611;544;19;48;33;6;27;.818;3600000;0
611;10103;24;0;0;0;0;.00nan;0;0
611;13979;24;59;38;5;33;.868;3600000;0
611;31124;19;0;0;0;0;.00nan;0;0
612;1796;16;68;22;2;20;.909;3600000;0
612;15437;16;0;0;0;0;.00nan;0;0
612;27739;22;84;33;3;30;.909;3555000;0
612;28026;22;0;0;0;0;.00nan;0;0
613;1074;0;0;0;0;0;.00nan;0;0
613;5385;17;47;25;4;21;.840;3600000;0
613;31035;0;93;20;0;20;1.000;3600000;0
613;34006;17;0;0;0;0;.00nan;0;0
614;233;29;0;0;0;0;.00nan;0;0
614;4450;5;0;0;0;0;.00nan;0;0
614;18351;29;83;31;2;29;.935;3600000;0
614;19823;5;70;33;3;30;.909;3569000;0
615;738;27;50;5;1;4;.800;1175000;0
615;1251;14;62;38;4;34;.895;3600000;0
615;25584;14;0;0;0;0;.00nan;0;0
615;26623;27;23;24;6;18;.750;2425000;0
616;61;31;0;0;0;0;.00nan;0;0
616;10103;24;90;28;1;27;.964;3600000;0
616;13979;24;0;0;0;0;.00nan;0;0
616;34797;31;100;34;0;34;1.000;3600000;0
617;51;21;87;22;1;21;.955;3900000;0
617;13842;34;92;39;1;38;.974;3900000;0
617;15502;34;0;0;0;0;.00nan;0;0
617;25843;21;0;0;0;0;.00nan;0;0
618;445;12;100;48;2;46;.958;3900000;0
618;2423;15;0;0;0;0;.00nan;0;0
618;4106;15;69;26;2;24;.923;3900000;0
618;34786;12;0;0;0;0;.00nan;0;0
619;262;35;0;0;0;0;.00nan;0;0
619;1430;35;72;47;5;42;.894;3600000;0
619;27739;22;0;0;0;0;.00nan;0;0
619;28026;22;64;27;2;25;.926;3600000;0
620;1572;4838;0;0;0;0;.00nan;0;0
620;2328;4838;55;39;5;34;.872;3600000;0
620;4506;33;85;15;0;15;1.000;3600000;0
620;34740;33;0;0;0;0;.00nan;0;0
621;1614;25;79;42;4;38;.905;3600000;0
621;1821;3;79;38;3;35;.921;3600000;0
621;2054;3;0;0;0;0;.00nan;0;0
621;5182;25;0;0;0;0;.00nan;0;0
622;823;23;100;49;2;47;.959;3600000;0
622;928;20;32;22;5;17;.773;3600000;0
622;10274;23;0;0;0;0;.00nan;0;0
622;18078;20;0;0;0;0;.00nan;0;0
623;15464;32;61;24;3;21;.875;3900000;0
623;16006;32;0;0;0;0;.00nan;0;0
623;22601;26;0;0;0;0;.00nan;0;0
623;32754;26;90;43;3;40;.930;3900000;0
624;335;18;0;0;0;0;.00nan;0;0
624;2058;28;0;0;0;0;.00nan;0;0
624;5001;18;47;32;5;27;.844;3544000;0
624;14061;28;76;44;4;40;.909;3600000;0
625;500;4182;0;0;0;0;.00nan;0;0
625;15505;8;95;39;1;38;.974;3600000;0
625;25076;8;0;0;0;0;.00nan;0;0
625;25521;4182;43;19;3;16;.842;3549000;0
626;1913;30;89;46;3;43;.935;3600000;0
626;4826;30;0;0;0;0;.00nan;0;0
626;18104;10;68;35;4;31;.886;3539000;0
626;27488;10;0;0;0;0;.00nan;0;0
627;323;9;49;37;6;31;.838;3600000;0
627;724;11;72;27;2;25;.926;3600000;0
627;20853;9;0;0;0;0;.00nan;0;0
627;21522;11;0;0;0;0;.00nan;0;0
628;445;12;0;0;0;0;.00nan;0;0
628;1796;16;66;28;3;25;.893;3600000;0
628;15437;16;0;0;0;0;.00nan;0;0
628;34786;12;53;26;4;22;.846;3552000;0
629;1074;0;0;0;0;0;.00nan;0;0
629;13842;34;89;31;1;30;.968;3600000;0
629;15502;34;0;0;0;0;.00nan;0;0
629;31035;0;69;25;2;23;.920;3558000;0
630;51;21;100;36;1;35;.972;3600000;0
630;233;29;0;0;0;0;.00nan;0;0
630;18351;29;75;36;4;32;.889;3600000;0
630;25843;21;0;0;0;0;.00nan;0;0
631;4450;5;0;0;0;0;.00nan;0;0
631;19823;5;81;23;1;22;.957;3600000;0
631;27739;22;57;32;4;28;.875;3600000;0
631;28026;22;0;0;0;0;.00nan;0;0
632;262;35;0;0;0;0;.00nan;0;0
632;1430;35;66;29;3;26;.897;3550000;0
632;4506;33;74;28;2;26;.929;3600000;0
632;34740;33;0;0;0;0;.00nan;0;0
633;1572;4838;0;0;0;0;.00nan;0;0
633;1614;25;0;0;0;0;.00nan;0;0
633;2328;4838;93;48;3;45;.938;3596000;0
633;5182;25;68;26;2;24;.923;3600000;0
634;823;23;0;0;0;0;.00nan;0;0
634;2058;28;0;0;0;0;.00nan;0;0
634;10274;23;68;34;3;31;.912;3547000;0
634;14061;28;83;32;2;30;.938;3600000;0
635;724;11;79;50;4;46;.920;3900000;0
635;18104;10;69;32;4;28;.875;3900000;0
635;21522;11;0;0;0;0;.00nan;0;0
635;27488;10;0;0;0;0;.00nan;0;0
636;233;29;0;0;0;0;.00nan;0;0
636;5385;17;0;0;0;0;.00nan;0;0
636;18351;29;55;32;4;28;.875;3600000;0
636;34006;17;71;33;3;30;.909;3600000;0
637;61;31;50;16;2;14;.875;2492000;0
637;335;18;0;0;0;0;.00nan;0;0
637;5001;18;93;39;3;36;.923;3600000;0
637;34797;31;36;18;4;14;.778;1108000;0
638;1251;14;60;28;3;25;.893;3514000;0
638;10103;24;0;0;0;0;.00nan;0;0
638;13979;24;86;24;1;23;.958;3600000;0
638;25584;14;0;0;0;0;.00nan;0;0
639;13842;34;0;0;0;0;.00nan;0;0
639;15502;34;92;52;3;49;.942;3600000;0
639;15505;8;0;0;0;0;.00nan;0;0
639;25076;8;55;38;5;33;.868;3512000;0
640;1614;25;64;27;2;25;.926;3900000;0
640;5182;25;0;0;0;0;.00nan;0;0
640;15464;32;100;50;2;48;.960;3900000;0
640;16006;32;0;0;0;0;.00nan;0;0
641;544;19;0;0;0;0;.00nan;0;0
641;928;20;0;0;0;0;.00nan;0;0
641;18078;20;79;31;3;28;.903;3900000;0
641;31124;19;77;43;3;40;.930;3900000;0
642;500;4182;80;26;2;24;.923;3600000;0
642;1821;3;79;36;4;32;.889;3600000;0
642;2054;3;0;0;0;0;.00nan;0;0
642;25521;4182;0;0;0;0;.00nan;0;0
643;1913;30;0;0;0;0;.00nan;0;0
643;2423;15;0;0;0;0;.00nan;0;0
643;4106;15;81;36;2;34;.944;3900000;0
643;4826;30;93;38;2;36;.947;3900000;0
644;323;9;77;35;3;32;.914;3600000;0
644;738;27;0;0;0;0;.00nan;0;0
644;20853;9;0;0;0;0;.00nan;0;0
644;26623;27;71;37;4;33;.892;3595000;0
645;1074;0;0;0;0;0;.00nan;0;0
645;4450;5;53;12;1;11;.917;3600000;0
645;19823;5;0;0;0;0;.00nan;0;0
645;31035;0;73;40;4;36;.900;3600000;0
646;445;12;53;33;5;28;.848;3848000;0
646;1572;4838;0;0;0;0;.00nan;0;0
646;2328;4838;60;36;4;32;.889;3848000;0
646;34786;12;0;0;0;0;.00nan;0;0
647;262;35;73;37;3;34;.919;3600000;0
647;823;23;0;0;0;0;.00nan;0;0
647;1430;35;0;0;0;0;.00nan;0;0
647;10274;23;90;17;0;17;1.000;3600000;0
648;1821;3;0;0;0;0;.00nan;0;0
648;2054;3;48;20;3;17;.850;3600000;0
648;22601;26;70;39;4;35;.897;3559000;0
648;32754;26;0;0;0;0;.00nan;0;0
649;1251;14;58;35;5;30;.857;3608000;0
649;4450;5;0;0;0;0;.00nan;0;0
649;19823;5;65;38;4;34;.895;3608000;0
649;25584;14;0;0;0;0;.00nan;0;0
650;323;9;86;45;4;41;.911;3527000;0
650;4506;33;70;25;2;23;.920;3600000;0
650;20853;9;0;0;0;0;.00nan;0;0
650;34740;33;0;0;0;0;.00nan;0;0
651;233;29;0;0;0;0;.00nan;0;0
651;335;18;0;0;0;0;.00nan;0;0
651;5001;18;46;34;5;29;.853;3600000;0
651;18351;29;91;36;2;34;.944;3600000;0
652;51;21;76;28;2;26;.929;3722000;0
652;928;20;0;0;0;0;.00nan;0;0
652;18078;20;68;23;1;22;.957;3722000;0
652;25843;21;0;0;0;0;.00nan;0;0
653;10103;24;0;0;0;0;.00nan;0;0
653;13842;34;96;50;3;47;.940;3598000;0
653;13979;24;88;27;1;26;.963;3600000;0
653;15502;34;0;0;0;0;.00nan;0;0
654;1074;0;67;16;0;16;1.000;1774000;0
654;15505;8;0;0;0;0;.00nan;0;0
654;25076;8;88;36;2;34;.944;3600000;0
654;31035;0;29;22;5;17;.773;1826000;0
655;1572;4838;0;0;0;0;.00nan;0;0
655;1796;16;35;29;5;24;.828;3600000;0
655;2328;4838;100;27;0;27;1.000;3600000;0
655;15437;16;0;0;0;0;.00nan;0;0
656;5385;17;0;0;0;0;.00nan;0;0
656;15464;32;56;27;3;24;.889;3528000;0
656;16006;32;0;0;0;0;.00nan;0;0
656;34006;17;96;33;1;32;.970;3600000;0
657;544;19;0;0;0;0;.00nan;0;0
657;2058;28;0;0;0;0;.00nan;0;0
657;14061;28;51;42;6;36;.857;3600000;0
657;31124;19;89;18;0;18;1.000;3600000;0
658;724;11;59;27;4;23;.852;3600000;0
658;2423;15;0;0;0;0;.00nan;0;0
658;4106;15;40;46;8;38;.826;3600000;0
658;21522;11;0;0;0;0;.00nan;0;0
659;738;27;0;0;0;0;.00nan;0;0
659;18104;10;96;46;1;45;.978;3900000;0
659;26623;27;87;31;1;30;.968;3900000;0
659;27488;10;0;0;0;0;.00nan;0;0
660;61;31;0;0;0;0;.00nan;0;0
660;445;12;74;33;3;30;.909;3571000;0
660;34786;12;0;0;0;0;.00nan;0;0
660;34797;31;76;21;1;20;.952;3600000;0
661;262;35;80;29;1;28;.966;3570000;0
661;1430;35;0;0;0;0;.00nan;0;0
661;1913;30;100;40;0;40;1.000;3600000;0
661;4826;30;0;0;0;0;.00nan;0;0
662;1614;25;73;18;1;17;.944;3600000;0
662;5182;25;0;0;0;0;.00nan;0;0
662;22601;26;0;0;0;0;.00nan;0;0
662;32754;26;98;47;2;45;.957;3569000;0
663;500;4182;95;38;3;35;.921;3900000;0
663;823;23;0;0;0;0;.00nan;0;0
663;10274;23;87;54;3;51;.944;3900000;0
663;25521;4182;0;0;0;0;.00nan;0;0
664;4450;5;0;0;0;0;.00nan;0;0
664;15464;32;81;45;4;41;.911;3600000;0
664;16006;32;0;0;0;0;.00nan;0;0
664;19823;5;88;13;0;13;1.000;3600000;0
665;51;21;75;22;1;21;.955;3600000;0
665;1074;0;0;0;0;0;.00nan;0;0
665;25843;21;0;0;0;0;.00nan;0;0
665;31035;0;89;46;3;43;.935;3536000;0
666;323;9;57;30;4;26;.867;3600000;0
666;5385;17;0;0;0;0;.00nan;0;0
666;20853;9;0;0;0;0;.00nan;0;0
666;34006;17;91;28;1;27;.964;3600000;0
667;233;29;0;0;0;0;.00nan;0;0
667;445;12;0;0;0;0;.00nan;0;0
667;18351;29;90;28;2;26;.929;3600000;0
667;34786;12;90;46;3;43;.935;3542000;0
668;61;31;63;36;4;32;.889;3567000;0
668;13842;34;99;42;2;40;.952;3600000;0
668;15502;34;0;0;0;0;.00nan;0;0
668;34797;31;0;0;0;0;.00nan;0;0
669;928;20;0;0;0;0;.00nan;0;0
669;18078;20;63;23;2;21;.913;3600000;0
669;27739;22;78;38;3;35;.921;3600000;0
669;28026;22;0;0;0;0;.00nan;0;0
670;1251;14;52;8;1;7;.875;1221000;0
670;18104;10;100;25;0;25;1.000;3600000;0
670;25584;14;27;25;6;19;.760;2379000;0
670;27488;10;0;0;0;0;.00nan;0;0
671;335;18;0;0;0;0;.00nan;0;0
671;5001;18;58;43;5;38;.884;3584000;0
671;10103;24;0;0;0;0;.00nan;0;0
671;13979;24;85;44;4;40;.909;3600000;0
672;1913;30;53;35;5;30;.857;3900000;0
672;4826;30;0;0;0;0;.00nan;0;0
672;15505;8;62;7;0;7;1.000;1021000;0
672;25076;8;45;27;5;22;.815;2879000;0
673;1796;16;85;44;3;41;.932;3534000;0
673;1821;3;98;34;1;33;.971;3600000;0
673;2054;3;0;0;0;0;.00nan;0;0
673;15437;16;0;0;0;0;.00nan;0;0
674;2058;28;0;0;0;0;.00nan;0;0
674;4506;33;100;27;0;27;1.000;3600000;0
674;14061;28;93;40;2;38;.950;3530000;0
674;34740;33;0;0;0;0;.00nan;0;0
675;500;4182;48;23;3;20;.870;3600000;0
675;544;19;0;0;0;0;.00nan;0;0
675;25521;4182;0;0;0;0;.00nan;0;0
675;31124;19;76;44;4;40;.909;3600000;0
676;1614;25;0;0;0;0;.00nan;0;0
676;5182;25;87;36;2;34;.944;3600000;0
676;22601;26;98;52;3;49;.942;3600000;0
676;32754;26;0;0;0;0;.00nan;0;0
677;738;27;0;0;0;0;.00nan;0;0
677;2423;15;0;0;0;0;.00nan;0;0
677;4106;15;75;34;3;31;.912;3775000;0
677;26623;27;67;41;4;37;.902;3775000;0
678;724;11;84;34;2;32;.941;3862000;0
678;1572;4838;0;0;0;0;.00nan;0;0
678;2328;4838;88;31;1;30;.968;3862000;0
678;21522;11;0;0;0;0;.00nan;0;0
679;335;18;0;0;0;0;.00nan;0;0
679;5001;18;65;48;6;42;.875;3600000;0
679;27739;22;0;0;0;0;.00nan;0;0
679;28026;22;83;26;1;25;.962;3600000;0
680;823;23;0;0;0;0;.00nan;0;0
680;4506;33;67;26;2;24;.923;3600000;0
680;10274;23;77;48;5;43;.896;3600000;0
680;34740;33;0;0;0;0;.00nan;0;0
681;323;9;99;34;1;33;.971;3600000;0
681;5385;17;0;0;0;0;.00nan;0;0
681;20853;9;0;0;0;0;.00nan;0;0
681;34006;17;54;32;5;27;.844;3600000;0
682;51;21;74;29;2;27;.931;3600000;0
682;1821;3;69;32;4;28;.875;3522000;0
682;2054;3;0;0;0;0;.00nan;0;0
682;25843;21;0;0;0;0;.00nan;0;0
683;928;20;62;22;2;20;.909;3600000;0
683;1251;14;0;0;0;0;.00nan;0;0
683;18078;20;0;0;0;0;.00nan;0;0
683;25584;14;58;40;5;35;.875;3600000;0
684;1796;16;0;0;0;0;.00nan;0;0
684;15437;16;63;21;2;19;.905;3600000;0
684;15464;32;71;41;5;36;.878;3600000;0
684;16006;32;0;0;0;0;.00nan;0;0
685;262;35;0;0;0;0;.00nan;0;0
685;1430;35;76;38;4;34;.895;3600000;0
685;1614;25;40;28;5;23;.821;3556000;0
685;5182;25;0;0;0;0;.00nan;0;0
686;1074;0;0;0;0;0;.00nan;0;0
686;22601;26;0;0;0;0;.00nan;0;0
686;31035;0;66;24;2;22;.917;3600000;0
686;32754;26;85;40;3;37;.925;3566000;0
687;500;4182;74;44;4;40;.909;3600000;0
687;2423;15;0;0;0;0;.00nan;0;0
687;4106;15;100;31;0;31;1.000;3600000;0
687;25521;4182;0;0;0;0;.00nan;0;0
688;724;11;100;28;0;28;1.000;3600000;0
688;738;27;0;0;0;0;.00nan;0;0
688;21522;11;0;0;0;0;.00nan;0;0
688;26623;27;62;30;4;26;.867;3600000;0
689;1572;4838;0;0;0;0;.00nan;0;0
689;2328;4838;67;24;2;22;.917;3600000;0
689;15505;8;28;6;3;3;.500;573000;0
689;25076;8;82;21;0;21;1.000;3005000;0
690;4450;5;0;0;0;0;.00nan;0;0
690;10103;24;0;0;0;0;.00nan;0;0
690;13979;24;96;53;4;49;.925;3600000;0
690;19823;5;51;34;5;29;.853;3579000;0
691;2058;28;0;0;0;0;.00nan;0;0
691;5385;17;100;43;1;42;.977;3600000;0
691;14061;28;58;17;2;15;.882;3546000;0
691;34006;17;0;0;0;0;.00nan;0;0
692;928;20;0;0;0;0;.00nan;0;0
692;13842;34;87;26;1;25;.962;3600000;0
692;15502;34;0;0;0;0;.00nan;0;0
692;18078;20;75;36;3;33;.917;3567000;0
693;323;9;0;0;0;0;.00nan;0;0
693;1251;14;81;36;3;33;.917;3900000;0
693;20853;9;76;36;3;33;.917;3900000;0
693;25584;14;0;0;0;0;.00nan;0;0
694;4506;33;79;37;3;34;.919;3900000;0
694;27739;22;65;27;3;24;.889;3900000;0
694;28026;22;0;0;0;0;.00nan;0;0
694;34740;33;0;0;0;0;.00nan;0;0
695;335;18;0;0;0;0;.00nan;0;0
695;5001;18;77;28;2;26;.929;3600000;0
695;15464;32;0;0;0;0;.00nan;0;0
695;16006;32;86;44;3;41;.932;3560000;0
696;445;12;61;25;3;22;.880;3600000;0
696;1074;0;50;27;4;23;.852;3600000;0
696;31035;0;0;0;0;0;.00nan;0;0
696;34786;12;0;0;0;0;.00nan;0;0
697;61;31;0;0;0;0;.00nan;0;0
697;544;19;0;0;0;0;.00nan;0;0
697;31124;19;74;29;2;27;.931;3600000;0
697;34797;31;74;34;3;31;.912;3578000;0
698;823;23;0;0;0;0;.00nan;0;0
698;10274;23;100;27;0;27;1.000;3600000;0
698;15505;8;76;33;3;30;.909;3600000;0
698;25076;8;0;0;0;0;.00nan;0;0
699;233;29;0;0;0;0;.00nan;0;0
699;724;11;40;34;6;28;.824;3600000;0
699;18351;29;70;24;2;22;.917;3600000;0
699;21522;11;0;0;0;0;.00nan;0;0
700;51;21;51;23;3;20;.870;3576000;0
700;22601;26;0;0;0;0;.00nan;0;0
700;25843;21;0;0;0;0;.00nan;0;0
700;32754;26;82;32;2;30;.938;3600000;0
701;1821;3;0;0;0;0;.00nan;0;0
701;2054;3;89;37;2;35;.946;3900000;0
701;18104;10;95;38;2;36;.947;3900000;0
701;27488;10;0;0;0;0;.00nan;0;0
702;1614;25;91;27;1;26;.963;3900000;0
702;1913;30;0;0;0;0;.00nan;0;0
702;4826;30;100;52;1;51;.981;3900000;0
702;5182;25;0;0;0;0;.00nan;0;0
703;4450;5;0;0;0;0;.00nan;0;0
703;19823;5;100;21;0;21;1.000;3600000;0
703;27739;22;47;35;5;30;.857;3600000;0
703;28026;22;0;0;0;0;.00nan;0;0
704;445;12;100;38;1;37;.974;3600000;0
704;5385;17;0;0;0;0;.00nan;0;0
704;34006;17;51;32;5;27;.844;3600000;0
704;34786;12;0;0;0;0;.00nan;0;0
705;1251;14;0;0;0;0;.00nan;0;0
705;13842;34;88;46;3;43;.935;3600000;0
705;15502;34;0;0;0;0;.00nan;0;0
705;25584;14;86;28;1;27;.964;3600000;0
706;2058;28;0;0;0;0;.00nan;0;0
706;2423;15;0;0;0;0;.00nan;0;0
706;4106;15;84;35;2;33;.943;3900000;0
706;14061;28;80;32;2;30;.938;3900000;0
707;4506;33;89;36;2;34;.944;3900000;0
707;15464;32;98;32;2;30;.938;3900000;0
707;16006;32;0;0;0;0;.00nan;0;0
707;34740;33;0;0;0;0;.00nan;0;0
708;61;31;0;0;0;0;.00nan;0;0
708;823;23;0;0;0;0;.00nan;0;0
708;10274;23;74;35;4;31;.886;3547000;0
708;34797;31;76;30;2;28;.933;3600000;0
709;500;4182;66;22;2;20;.909;3900000;0
709;1074;0;0;0;0;0;.00nan;0;0
709;25521;4182;0;0;0;0;.00nan;0;0
709;31035;0;98;45;2;43;.956;3900000;0
710;724;11;0;0;0;0;.00nan;0;0
710;1614;25;0;0;0;0;.00nan;0;0
710;5182;25;74;42;4;38;.905;3600000;0
710;21522;11;76;41;3;38;.927;3600000;0
711;738;27;0;0;0;0;.00nan;0;0
711;1572;4838;0;0;0;0;.00nan;0;0
711;2328;4838;86;48;3;45;.938;3572000;0
711;26623;27;78;28;2;26;.929;3600000;0
712;323;9;74;34;4;30;.882;3695000;0
712;445;12;0;0;0;0;.00nan;0;0
712;20853;9;0;0;0;0;.00nan;0;0
712;34786;12;55;33;5;28;.848;3695000;0
713;928;20;0;0;0;0;.00nan;0;0
713;18078;20;38;18;4;14;.778;3900000;0
713;22601;26;0;0;0;0;.00nan;0;0
713;32754;26;47;31;4;27;.871;3900000;0
714;10103;24;80;20;0;20;1.000;2506000;0
714;13979;24;37;17;4;13;.765;1094000;0
714;18104;10;47;37;7;30;.811;3600000;0
714;27488;10;0;0;0;0;.00nan;0;0
715;2423;15;74;47;4;43;.915;3515000;0
715;4106;15;0;0;0;0;.00nan;0;0
715;13842;34;0;0;0;0;.00nan;0;0
715;15502;34;91;41;2;39;.951;3600000;0
716;262;35;0;0;0;0;.00nan;0;0
716;1430;35;52;31;5;26;.839;3621000;0
716;15505;8;0;0;0;0;.00nan;0;0
716;25076;8;57;29;4;25;.862;3621000;0
717;61;31;75;43;3;40;.930;3600000;0
717;335;18;0;0;0;0;.00nan;0;0
717;5001;18;56;35;4;31;.886;3600000;0
717;34797;31;0;0;0;0;.00nan;0;0
718;233;29;41;8;2;6;.750;2496000;0
718;1913;30;100;39;0;39;1.000;3600000;0
718;4826;30;0;0;0;0;.00nan;0;0
718;18351;29;33;14;4;10;.714;1104000;0
719;1572;4838;53;6;0;6;1.000;332000;0
719;1796;16;88;17;0;17;1.000;3600000;0
719;2328;4838;76;53;6;47;.887;3268000;0
719;15437;16;0;0;0;0;.00nan;0;0
720;4450;5;0;0;0;0;.00nan;0;0
720;4506;33;78;31;2;29;.935;3600000;0
720;19823;5;61;42;5;37;.881;3600000;0
720;34740;33;0;0;0;0;.00nan;0;0
721;1251;14;0;0;0;0;.00nan;0;0
721;5385;17;78;33;3;30;.909;3900000;0
721;25584;14;58;27;3;24;.889;3900000;0
721;34006;17;0;0;0;0;.00nan;0;0
722;928;20;47;30;5;25;.833;3600000;0
722;1821;3;82;35;3;32;.914;3600000;0
722;2054;3;0;0;0;0;.00nan;0;0
722;18078;20;0;0;0;0;.00nan;0;0
723;51;21;0;0;0;0;.00nan;0;0
723;10103;24;0;0;0;0;.00nan;0;0
723;13979;24;85;27;1;26;.963;3600000;0
723;25843;21;91;36;2;34;.944;3561000;0
724;18104;10;0;0;0;0;.00nan;0;0
724;22601;26;87;34;2;32;.941;3900000;0
724;27488;10;94;38;2;36;.947;3900000;0
724;32754;26;0;0;0;0;.00nan;0;0
725;2058;28;71;38;4;34;.895;3600000;0
725;14061;28;0;0;0;0;.00nan;0;0
725;27739;22;0;0;0;0;.00nan;0;0
725;28026;22;85;32;1;31;.969;3600000;0
726;323;9;0;0;0;0;.00nan;0;0
726;15464;32;57;22;3;19;.864;3736000;0
726;16006;32;0;0;0;0;.00nan;0;0
726;20853;9;97;46;2;44;.957;3735000;0
727;262;35;75;39;3;36;.923;3600000;0
727;1430;35;0;0;0;0;.00nan;0;0
727;15505;8;100;26;0;26;1.000;3600000;0
727;25076;8;0;0;0;0;.00nan;0;0
728;1074;0;0;0;0;0;.00nan;0;0
728;1614;25;51;16;2;14;.875;3900000;0
728;5182;25;0;0;0;0;.00nan;0;0
728;31035;0;98;44;2;42;.955;3899000;0
729;544;19;0;0;0;0;.00nan;0;0
729;823;23;0;0;0;0;.00nan;0;0
729;10274;23;91;39;2;37;.949;3536000;0
729;31124;19;99;20;0;20;1.000;3600000;0
730;233;29;0;0;0;0;.00nan;0;0
730;738;27;0;0;0;0;.00nan;0;0
730;18351;29;76;28;3;25;.893;3600000;0
730;26623;27;48;30;5;25;.833;3532000;0
731;51;21;81;26;2;24;.923;3600000;0
731;724;11;83;45;4;41;.911;3545000;0
731;21522;11;0;0;0;0;.00nan;0;0
731;25843;21;0;0;0;0;.00nan;0;0
732;2423;15;0;0;0;0;.00nan;0;0
732;4106;15;77;26;2;24;.923;3600000;0
732;4506;33;93;56;5;51;.911;3600000;0
732;34740;33;0;0;0;0;.00nan;0;0
733;2058;28;0;0;0;0;.00nan;0;0
733;13842;34;100;31;0;31;1.000;3600000;0
733;14061;28;58;40;5;35;.875;3600000;0
733;15502;34;0;0;0;0;.00nan;0;0
734;335;18;0;0;0;0;.00nan;0;0
734;1796;16;77;28;2;26;.929;3850000;0
734;5001;18;66;29;3;26;.897;3850000;0
734;15437;16;0;0;0;0;.00nan;0;0
735;61;31;0;0;0;0;.00nan;0;0
735;1572;4838;0;0;0;0;.00nan;0;0
735;2328;4838;85;39;3;36;.923;3577000;0
735;34797;31;84;28;1;27;.964;3600000;0
736;1913;30;98;50;3;47;.940;3582000;0
736;4450;5;0;0;0;0;.00nan;0;0
736;4826;30;0;0;0;0;.00nan;0;0
736;19823;5;85;25;1;24;.960;3600000;0
737;724;11;0;0;0;0;.00nan;0;0
737;18104;10;85;26;2;24;.923;3532000;0
737;21522;11;100;35;0;35;1.000;3600000;0
737;27488;10;0;0;0;0;.00nan;0;0
738;445;12;82;24;1;23;.958;3600000;0
738;1251;14;0;0;0;0;.00nan;0;0
738;25584;14;46;43;7;36;.837;3600000;0
738;34786;12;0;0;0;0;.00nan;0;0
739;500;4182;68;40;4;36;.900;3550000;0
739;25521;4182;0;0;0;0;.00nan;0;0
739;27739;22;96;48;2;46;.958;3600000;0
739;28026;22;0;0;0;0;.00nan;0;0
740;262;35;76;23;1;22;.957;3600000;0
740;1074;0;0;0;0;0;.00nan;0;0
740;1430;35;0;0;0;0;.00nan;0;0
740;31035;0;59;36;4;32;.889;3600000;0
741;1614;25;0;0;0;0;.00nan;0;0
741;5182;25;74;36;3;33;.917;3900000;0
741;15505;8;83;38;3;35;.921;3900000;0
741;25076;8;0;0;0;0;.00nan;0;0
742;544;19;0;0;0;0;.00nan;0;0
742;1796;16;0;0;0;0;.00nan;0;0
742;15437;16;84;51;4;47;.922;3565000;0
742;31124;19;56;15;2;13;.867;3600000;0
743;2058;28;79;22;1;21;.955;3900000;0
743;5385;17;0;0;0;0;.00nan;0;0
743;14061;28;0;0;0;0;.00nan;0;0
743;34006;17;76;28;1;27;.964;3900000;0
744;51;21;76;38;4;34;.895;3600000;0
744;445;12;100;34;1;33;.971;3600000;0
744;25843;21;0;0;0;0;.00nan;0;0
744;34786;12;0;0;0;0;.00nan;0;0
745;928;20;0;0;0;0;.00nan;0;0
745;1251;14;61;33;4;29;.879;3600000;0
745;18078;20;76;29;1;28;.966;3600000;0
745;25584;14;0;0;0;0;.00nan;0;0
746;2423;15;0;0;0;0;.00nan;0;0
746;4106;15;78;26;1;25;.962;3600000;0
746;22601;26;0;0;0;0;.00nan;0;0
746;32754;26;94;43;2;41;.953;3600000;0
747;500;4182;0;0;0;0;.00nan;0;0
747;10103;24;0;0;0;0;.00nan;0;0
747;13979;24;98;32;1;31;.969;3600000;0
747;25521;4182;59;25;3;22;.880;3570000;0
748;61;31;0;0;0;0;.00nan;0;0
748;4506;33;0;0;0;0;.00nan;0;0
748;34740;33;33;20;4;16;.800;3724000;0
748;34797;31;43;28;5;23;.821;3724000;0
749;335;18;0;0;0;0;.00nan;0;0
749;823;23;0;0;0;0;.00nan;0;0
749;5001;18;73;29;3;26;.897;3900000;0
749;10274;23;90;40;3;37;.925;3900000;0
750;1572;4838;0;0;0;0;.00nan;0;0
750;2328;4838;71;26;2;24;.923;3600000;0
750;15464;32;48;19;3;16;.842;3547000;0
750;16006;32;0;0;0;0;.00nan;0;0
751;1821;3;60;21;2;19;.905;3600000;0
751;1913;30;0;0;0;0;.00nan;0;0
751;2054;3;0;0;0;0;.00nan;0;0
751;4826;30;80;43;4;39;.907;3562000;0
752;323;9;72;31;3;28;.903;3600000;0
752;15505;8;52;39;6;33;.846;3138000;0
752;20853;9;0;0;0;0;.00nan;0;0
752;25076;8;54;2;0;2;1.000;462000;0
753;738;27;0;0;0;0;.00nan;0;0
753;26623;27;35;27;5;22;.815;3548000;0
753;27739;22;73;45;4;41;.911;3600000;0
753;28026;22;0;0;0;0;.00nan;0;0
754;544;19;0;0;0;0;.00nan;0;0
754;13842;34;88;32;1;31;.969;3600000;0
754;15502;34;0;0;0;0;.00nan;0;0
754;31124;19;30;26;5;21;.808;3600000;0
755;1614;25;78;41;4;37;.902;3553000;0
755;4450;5;0;0;0;0;.00nan;0;0
755;5182;25;0;0;0;0;.00nan;0;0
755;19823;5;73;34;3;31;.912;3600000;0
756;1074;0;0;0;0;0;.00nan;0;0
756;1913;30;100;33;0;33;1.000;3600000;0
756;4826;30;0;0;0;0;.00nan;0;0
756;31035;0;67;22;2;20;.909;3573000;0
757;2058;28;0;0;0;0;.00nan;0;0
757;10103;24;0;0;0;0;.00nan;0;0
757;13979;24;80;25;1;24;.960;3600000;0
757;14061;28;78;45;4;41;.911;3600000;0
758;51;21;67;30;3;27;.900;3900000;0
758;233;29;0;0;0;0;.00nan;0;0
758;18351;29;76;36;3;33;.917;3900000;0
758;25843;21;0;0;0;0;.00nan;0;0
759;61;31;0;0;0;0;.00nan;0;0
759;500;4182;42;38;7;31;.816;3600000;0
759;25521;4182;0;0;0;0;.00nan;0;0
759;34797;31;85;35;3;32;.914;3600000;0
760;724;11;0;0;0;0;.00nan;0;0
760;928;20;0;0;0;0;.00nan;0;0
760;18078;20;76;15;1;14;.933;3600000;0
760;21522;11;89;50;4;46;.920;3600000;0
761;1572;4838;60;6;0;6;1.000;373000;0
761;2328;4838;48;38;6;32;.842;3227000;0
761;2423;15;0;0;0;0;.00nan;0;0
761;4106;15;100;28;0;28;1.000;3600000;0
762;13842;34;0;0;0;0;.00nan;0;0
762;15502;34;52;29;4;25;.862;3513000;0
762;18104;10;82;28;2;26;.929;3600000;0
762;27488;10;0;0;0;0;.00nan;0;0
763;544;19;68;16;1;15;.938;3600000;0
763;1796;16;71;34;3;31;.912;3510000;0
763;15437;16;0;0;0;0;.00nan;0;0
763;31124;19;0;0;0;0;.00nan;0;0
764;335;18;33;5;2;3;.600;961000;0
764;4506;33;99;31;1;30;.968;3600000;0
764;5001;18;26;28;6;22;.786;2639000;0
764;34740;33;0;0;0;0;.00nan;0;0
765;823;23;0;0;0;0;.00nan;0;0
765;10274;23;74;29;2;27;.931;3536000;0
765;15464;32;82;28;1;27;.964;3600000;0
765;16006;32;0;0;0;0;.00nan;0;0
766;262;35;66;34;3;31;.912;3600000;0
766;1430;35;0;0;0;0;.00nan;0;0
766;18104;10;100;33;0;33;1.000;3600000;0
766;27488;10;0;0;0;0;.00nan;0;0
767;323;9;54;16;2;14;.875;1532000;0
767;2423;15;0;0;0;0;.00nan;0;0
767;4106;15;73;33;3;30;.909;3600000;0
767;20853;9;44;29;5;24;.828;2068000;0
768;1614;25;100;36;1;35;.972;3900000;0
768;5182;25;0;0;0;0;.00nan;0;0
768;15505;8;0;0;0;0;.00nan;0;0
768;25076;8;96;40;1;39;.975;3900000;0
769;445;12;80;34;2;32;.941;3600000;0
769;27739;22;54;24;3;21;.875;3565000;0
769;28026;22;0;0;0;0;.00nan;0;0
769;34786;12;0;0;0;0;.00nan;0;0
770;4450;5;0;0;0;0;.00nan;0;0
770;19823;5;60;17;1;16;.941;3900000;0
770;22601;26;100;42;1;41;.976;3900000;0
770;32754;26;0;0;0;0;.00nan;0;0
771;823;23;0;0;0;0;.00nan;0;0
771;1074;0;0;0;0;0;.00nan;0;0
771;10274;23;71;17;1;16;.941;3600000;0
771;31035;0;65;35;4;31;.886;3600000;0
772;1913;30;82;37;3;34;.919;3600000;0
772;2058;28;0;0;0;0;.00nan;0;0
772;4826;30;0;0;0;0;.00nan;0;0
772;14061;28;83;28;1;27;.964;3600000;0
773;323;9;24;5;3;2;.400;191000;0
773;1821;3;65;27;3;24;.889;3600000;0
773;2054;3;0;0;0;0;.00nan;0;0
773;20853;9;55;29;4;25;.862;3409000;0
774;233;29;0;0;0;0;.00nan;0;0
774;500;4182;87;27;1;26;.963;3600000;0
774;18351;29;76;28;2;26;.929;3555000;0
774;25521;4182;0;0;0;0;.00nan;0;0
775;61;31;0;0;0;0;.00nan;0;0
775;738;27;0;0;0;0;.00nan;0;0
775;26623;27;79;43;4;39;.907;3600000;0
775;34797;31;78;30;2;28;.933;3600000;0
776;928;20;0;0;0;0;.00nan;0;0
776;1572;4838;0;0;0;0;.00nan;0;0
776;2328;4838;81;34;3;31;.912;3600000;0
776;18078;20;76;17;1;16;.941;3600000;0
777;724;11;68;35;4;31;.886;3600000;0
777;1251;14;0;0;0;0;.00nan;0;0
777;21522;11;0;0;0;0;.00nan;0;0
777;25584;14;83;16;0;16;1.000;3600000;0
778;51;21;70;36;3;33;.917;3556000;0
778;10103;24;0;0;0;0;.00nan;0;0
778;13979;24;63;21;2;19;.905;3600000;0
778;25843;21;0;0;0;0;.00nan;0;0
779;1796;16;69;27;3;24;.889;3687000;0
779;4506;33;68;37;4;33;.892;3687000;0
779;15437;16;0;0;0;0;.00nan;0;0
779;34740;33;0;0;0;0;.00nan;0;0
780;335;18;0;0;0;0;.00nan;0;0
780;544;19;0;0;0;0;.00nan;0;0
780;5001;18;76;45;5;40;.889;3640000;0
780;31124;19;29;29;6;23;.793;3640000;0
781;5385;17;84;42;4;38;.905;3817000;0
781;22601;26;0;0;0;0;.00nan;0;0
781;32754;26;65;38;5;33;.868;3817000;0
781;34006;17;0;0;0;0;.00nan;0;0
782;1074;0;66;30;3;27;.900;3512000;0
782;13842;34;100;37;1;36;.973;3600000;0
782;15502;34;0;0;0;0;.00nan;0;0
782;31035;0;0;0;0;0;.00nan;0;0
783;262;35;100;34;1;33;.971;3600000;0
783;928;20;42;31;5;26;.839;3600000;0
783;1430;35;0;0;0;0;.00nan;0;0
783;18078;20;0;0;0;0;.00nan;0;0
784;1572;4838;47;29;4;25;.862;3552000;0
784;2328;4838;0;0;0;0;.00nan;0;0
784;18104;10;76;29;2;27;.931;3600000;0
784;27488;10;0;0;0;0;.00nan;0;0
785;724;11;0;0;0;0;.00nan;0;0
785;2423;15;0;0;0;0;.00nan;0;0
785;4106;15;74;22;1;21;.955;3600000;0
785;21522;11;88;41;2;39;.951;3600000;0
786;738;27;0;0;0;0;.00nan;0;0
786;10103;24;66;28;3;25;.893;3600000;0
786;13979;24;0;0;0;0;.00nan;0;0
786;26623;27;73;49;5;44;.898;3555000;0
787;1796;16;0;0;0;0;.00nan;0;0
787;15437;16;99;42;1;41;.976;3600000;0
787;15505;8;31;31;6;25;.806;3362000;0
787;25076;8;50;1;0;1;1.000;238000;0
788;445;12;0;0;0;0;.00nan;0;0
788;4450;5;0;0;0;0;.00nan;0;0
788;19823;5;63;14;1;13;.929;3600000;0
788;34786;12;80;49;4;45;.918;3600000;0
789;1614;25;0;0;0;0;.00nan;0;0
789;5182;25;79;25;1;24;.960;3600000;0
789;5385;17;0;0;0;0;.00nan;0;0
789;34006;17;26;31;7;24;.774;3600000;0
790;823;23;0;0;0;0;.00nan;0;0
790;2058;28;29;10;3;7;.700;544000;0
790;10274;23;90;33;1;32;.970;3600000;0
790;14061;28;79;45;4;41;.911;3056000;0
791;323;9;0;0;0;0;.00nan;0;0
791;1913;30;0;0;0;0;.00nan;0;0
791;4826;30;100;50;0;50;1.000;3600000;0
791;20853;9;71;31;2;29;.935;3545000;0
792;61;31;0;0;0;0;.00nan;0;0
792;13842;34;0;0;0;0;.00nan;0;0
792;15502;34;92;34;2;32;.941;3615000;0
792;34797;31;69;29;3;26;.897;3615000;0
793;335;18;0;0;0;0;.00nan;0;0
793;5001;18;84;36;2;34;.944;3900000;0
793;15505;8;0;0;0;0;.00nan;0;0
793;25076;8;61;23;2;21;.913;3900000;0
794;1572;4838;0;0;0;0;.00nan;0;0
794;2328;4838;83;42;3;39;.929;3600000;0
794;4450;5;0;0;0;0;.00nan;0;0
794;19823;5;100;26;0;26;1.000;3600000;0
795;1074;0;0;0;0;0;.00nan;0;0
795;1796;16;60;6;0;6;1.000;880000;0
795;15437;16;27;26;6;20;.769;2670000;0
795;31035;0;36;29;5;24;.828;3600000;0
796;233;29;100;25;0;25;1.000;3600000;0
796;738;27;0;0;0;0;.00nan;0;0
796;18351;29;0;0;0;0;.00nan;0;0
796;26623;27;98;56;4;52;.929;3600000;0
797;51;21;34;23;6;17;.739;2203000;0
797;1821;3;84;42;4;38;.905;3600000;0
797;2054;3;0;0;0;0;.00nan;0;0
797;25843;21;50;7;1;6;.857;1397000;0
798;928;20;0;0;0;0;.00nan;0;0
798;2058;28;35;41;7;34;.829;3600000;0
798;14061;28;0;0;0;0;.00nan;0;0
798;18078;20;82;23;2;21;.913;3600000;0
799;61;31;23;23;6;17;.739;3600000;0
799;18104;10;64;35;4;31;.886;3600000;0
799;27488;10;0;0;0;0;.00nan;0;0
799;34797;31;0;0;0;0;.00nan;0;0
800;1251;14;64;8;0;8;1.000;826000;0
800;4506;33;56;22;3;19;.864;3600000;0
800;25584;14;13;18;6;12;.667;2774000;0
800;34740;33;0;0;0;0;.00nan;0;0
801;2423;15;0;0;0;0;.00nan;0;0
801;4106;15;56;31;4;27;.871;3544000;0
801;27739;22;99;57;3;54;.947;3600000;0
801;28026;22;0;0;0;0;.00nan;0;0
802;335;18;0;0;0;0;.00nan;0;0
802;5001;18;90;35;2;33;.943;3900000;0
802;15464;32;75;32;2;30;.938;3900000;0
802;16006;32;0;0;0;0;.00nan;0;0
803;445;12;75;45;5;40;.889;3600000;0
803;544;19;0;0;0;0;.00nan;0;0
803;31124;19;65;15;1;14;.933;3600000;0
803;34786;12;0;0;0;0;.00nan;0;0
804;1614;25;83;34;3;31;.912;3600000;0
804;5182;25;0;0;0;0;.00nan;0;0
804;22601;26;72;43;4;39;.907;3543000;0
804;32754;26;0;0;0;0;.00nan;0;0
805;500;4182;76;22;1;21;.955;3600000;0
805;5385;17;74;40;4;36;.900;3600000;0
805;25521;4182;0;0;0;0;.00nan;0;0
805;34006;17;0;0;0;0;.00nan;0;0
806;323;9;94;39;2;37;.949;3707000;0
806;724;11;67;28;3;25;.893;3707000;0
806;20853;9;0;0;0;0;.00nan;0;0
806;21522;11;0;0;0;0;.00nan;0;0
807;823;23;0;0;0;0;.00nan;0;0
807;10274;23;63;38;5;33;.868;3600000;0
807;27739;22;0;0;0;0;.00nan;0;0
807;28026;22;78;29;2;27;.931;3600000;0
808;262;35;77;22;1;21;.955;3600000;0
808;1430;35;0;0;0;0;.00nan;0;0
808;15505;8;35;18;4;14;.778;1163000;0
808;25076;8;63;27;3;24;.889;2437000;0
809;544;19;70;40;4;36;.900;3900000;0
809;22601;26;0;0;0;0;.00nan;0;0
809;31124;19;0;0;0;0;.00nan;0;0
809;32754;26;50;25;4;21;.840;3900000;0
810;323;9;65;22;2;20;.909;3600000;0
810;1251;14;0;0;0;0;.00nan;0;0
810;20853;9;0;0;0;0;.00nan;0;0
810;25584;14;37;35;6;29;.829;3600000;0
811;823;23;71;26;2;24;.923;2410000;0
811;7139;29;0;0;0;0;.00nan;0;0
811;10274;23;27;15;4;11;.733;1190000;0
811;18351;29;86;28;1;27;.964;3600000;0
812;445;12;91;37;2;35;.946;3600000;0
812;4506;33;64;33;3;30;.909;3593000;0
812;34740;33;0;0;0;0;.00nan;0;0
812;34786;12;0;0;0;0;.00nan;0;0
813;724;11;77;31;2;29;.935;3553000;0
813;21522;11;0;0;0;0;.00nan;0;0
813;22601;26;100;39;1;38;.974;3600000;0
813;32754;26;0;0;0;0;.00nan;0;0
814;262;35;65;40;4;36;.900;3600000;0
814;1430;35;0;0;0;0;.00nan;0;0
814;1821;3;0;0;0;0;.00nan;0;0
814;2054;3;83;28;1;27;.964;3600000;0
815;61;31;0;0;0;0;.00nan;0;0
815;13842;34;0;0;0;0;.00nan;0;0
815;15502;34;70;38;4;34;.895;3600000;0
815;34797;31;74;31;3;28;.903;3600000;0
816;51;21;67;27;3;24;.889;3633000;0
816;2423;15;0;0;0;0;.00nan;0;0
816;4106;15;49;27;4;23;.852;3633000;0
816;25843;21;0;0;0;0;.00nan;0;0
817;18104;10;38;24;5;19;.792;3600000;0
817;27488;10;0;0;0;0;.00nan;0;0
817;27739;22;0;0;0;0;.00nan;0;0
817;28026;22;100;38;1;37;.974;3600000;0
818;445;12;0;0;0;0;.00nan;0;0
818;15464;32;58;28;3;25;.893;3600000;0
818;16006;32;0;0;0;0;.00nan;0;0
818;34786;12;82;30;2;28;.933;3600000;0
819;335;18;45;30;4;26;.867;3560000;0
819;544;19;0;0;0;0;.00nan;0;0
819;5001;18;0;0;0;0;.00nan;0;0
819;31124;19;84;35;2;33;.943;3600000;0
820;738;27;86;35;2;33;.943;3900000;0
820;928;20;0;0;0;0;.00nan;0;0
820;18078;20;72;31;2;29;.935;3900000;0
820;26623;27;0;0;0;0;.00nan;0;0
821;1572;4838;0;0;0;0;.00nan;0;0
821;2328;4838;43;34;5;29;.853;3600000;0
821;4450;5;0;0;0;0;.00nan;0;0
821;19823;5;90;18;0;18;1.000;3600000;0
822;10103;24;0;0;0;0;.00nan;0;0
822;13842;34;100;26;0;26;1.000;3600000;0
822;13979;24;79;34;3;31;.912;3600000;0
822;15502;34;0;0;0;0;.00nan;0;0
823;51;21;100;39;0;39;1.000;3600000;0
823;15505;8;77;33;2;31;.939;3600000;0
823;25076;8;0;0;0;0;.00nan;0;0
823;25843;21;0;0;0;0;.00nan;0;0
824;1796;16;0;0;0;0;.00nan;0;0
824;5385;17;0;0;0;0;.00nan;0;0
824;15437;16;91;58;5;53;.914;3525000;0
824;34006;17;71;26;3;23;.885;3600000;0
825;1614;25;0;0;0;0;.00nan;0;0
825;4506;33;100;36;1;35;.972;3600000;0
825;5182;25;80;39;3;36;.923;3564000;0
825;34740;33;0;0;0;0;.00nan;0;0
826;500;4182;67;26;2;24;.923;3600000;0
826;22601;26;0;0;0;0;.00nan;0;0
826;25521;4182;0;0;0;0;.00nan;0;0
826;32754;26;81;55;5;50;.909;3600000;0
827;724;11;55;30;4;26;.867;3600000;0
827;1913;30;0;0;0;0;.00nan;0;0
827;4826;30;68;31;3;28;.903;3600000;0
827;21522;11;0;0;0;0;.00nan;0;0
828;323;9;31;9;3;6;.667;290000;0
828;1821;3;59;20;2;18;.900;3600000;0
828;2054;3;0;0;0;0;.00nan;0;0
828;20853;9;98;50;2;48;.960;3310000;0
829;1074;0;0;0;0;0;.00nan;0;0
829;2058;28;0;0;0;0;.00nan;0;0
829;14061;28;86;26;1;25;.962;3600000;0
829;31035;0;64;42;5;37;.881;3600000;0
830;61;31;0;0;0;0;.00nan;0;0
830;823;23;31;10;3;7;.700;543000;0
830;10274;23;81;33;2;31;.939;3183000;0
830;34797;31;83;45;4;41;.911;3726000;0
831;1251;14;0;0;0;0;.00nan;0;0
831;25584;14;94;37;1;36;.973;3600000;0
831;27739;22;0;0;0;0;.00nan;0;0
831;28026;22;51;27;5;22;.815;3600000;0
832;2423;15;0;0;0;0;.00nan;0;0
832;4106;15;63;28;3;25;.893;3576000;0
832;18104;10;100;43;1;42;.977;3600000;0
832;27488;10;0;0;0;0;.00nan;0;0
833;7139;29;0;0;0;0;.00nan;0;0
833;15464;32;75;30;3;27;.900;3600000;0
833;16006;32;0;0;0;0;.00nan;0;0
833;18351;29;47;24;4;20;.833;3546000;0
834;262;35;88;38;2;36;.947;3600000;0
834;544;19;0;0;0;0;.00nan;0;0
834;1430;35;0;0;0;0;.00nan;0;0
834;31124;19;71;17;1;16;.941;3600000;0
835;500;4182;74;37;4;33;.892;3600000;0
835;1614;25;49;33;5;28;.848;3543000;0
835;5182;25;0;0;0;0;.00nan;0;0
835;25521;4182;0;0;0;0;.00nan;0;0
836;724;11;0;0;0;0;.00nan;0;0
836;928;20;0;0;0;0;.00nan;0;0
836;18078;20;69;35;3;32;.914;3571000;0
836;21522;11;88;28;2;26;.929;3600000;0
837;738;27;0;0;0;0;.00nan;0;0
837;4450;5;0;0;0;0;.00nan;0;0
837;19823;5;90;31;1;30;.968;3881000;0
837;26623;27;100;47;0;47;1.000;3881000;0
838;335;18;0;0;0;0;.00nan;0;0
838;5001;18;60;27;3;24;.889;3760000;0
838;18104;10;0;0;0;0;.00nan;0;0
838;27488;10;46;26;4;22;.846;3760000;0
839;823;23;67;26;2;24;.923;3600000;0
839;10103;24;0;0;0;0;.00nan;0;0
839;10274;23;0;0;0;0;.00nan;0;0
839;13979;24;83;43;3;40;.930;3557000;0
840;2423;15;62;23;2;21;.913;3600000;0
840;4106;15;0;0;0;0;.00nan;0;0
840;13842;34;80;50;6;44;.880;3600000;0
840;15502;34;0;0;0;0;.00nan;0;0
841;1796;16;0;0;0;0;.00nan;0;0
841;15437;16;53;23;4;19;.826;3600000;0
841;15505;8;56;4;0;4;1.000;891000;0
841;25076;8;39;33;6;27;.818;2709000;0
842;445;12;64;32;3;29;.906;3600000;0
842;5385;17;0;0;0;0;.00nan;0;0
842;34006;17;53;40;5;35;.875;3597000;0
842;34786;12;0;0;0;0;.00nan;0;0
843;4506;33;100;46;0;46;1.000;3600000;0
843;22601;26;54;27;4;23;.852;3600000;0
843;32754;26;0;0;0;0;.00nan;0;0
843;34740;33;0;0;0;0;.00nan;0;0
844;928;20;96;20;0;20;1.000;3600000;0
844;1913;30;0;0;0;0;.00nan;0;0
844;4826;30;85;30;1;29;.967;3567000;0
844;18078;20;0;0;0;0;.00nan;0;0
845;738;27;0;0;0;0;.00nan;0;0
845;1572;4838;0;0;0;0;.00nan;0;0
845;2328;4838;75;43;4;39;.907;3582000;0
845;26623;27;68;30;3;27;.900;3600000;0
846;51;21;51;27;4;23;.852;3900000;0
846;335;18;0;0;0;0;.00nan;0;0
846;5001;18;78;44;4;40;.909;3900000;0
846;25843;21;0;0;0;0;.00nan;0;0
847;1251;14;0;0;0;0;.00nan;0;0
847;1796;16;65;43;5;38;.884;3600000;0
847;15437;16;0;0;0;0;.00nan;0;0
847;25584;14;73;18;1;17;.944;3600000;0
848;1821;3;98;20;0;20;1.000;3600000;0
848;2054;3;0;0;0;0;.00nan;0;0
848;27739;22;0;0;0;0;.00nan;0;0
848;28026;22;93;48;2;46;.958;3537000;0
849;724;11;0;0;0;0;.00nan;0;0
849;4450;5;0;0;0;0;.00nan;0;0
849;19823;5;98;21;0;21;1.000;3600000;0
849;21522;11;73;33;3;30;.909;3600000;0
850;323;9;0;0;0;0;.00nan;0;0
850;10103;24;0;0;0;0;.00nan;0;0
850;13979;24;53;21;4;17;.810;3900000;0
850;20853;9;69;43;4;39;.907;3900000;0
851;2058;28;0;0;0;0;.00nan;0;0
851;7139;29;89;38;2;36;.947;3900000;0
851;14061;28;78;28;2;26;.929;3900000;0
851;18351;29;0;0;0;0;.00nan;0;0
852;823;23;0;0;0;0;.00nan;0;0
852;1251;14;87;49;4;45;.918;3900000;0
852;10274;23;51;30;4;26;.867;3900000;0
852;25584;14;0;0;0;0;.00nan;0;0
853;51;21;64;15;1;14;.933;3600000;0
853;13842;34;70;41;4;37;.902;3600000;0
853;15502;34;0;0;0;0;.00nan;0;0
853;25843;21;0;0;0;0;.00nan;0;0
854;262;35;84;28;1;27;.964;3600000;0
854;544;19;0;0;0;0;.00nan;0;0
854;1430;35;0;0;0;0;.00nan;0;0
854;31124;19;100;33;0;33;1.000;3600000;0
855;1074;0;0;0;0;0;.00nan;0;0
855;4506;33;65;27;3;24;.889;3600000;0
855;31035;0;68;40;4;36;.900;3551000;0
855;34740;33;0;0;0;0;.00nan;0;0
856;928;20;73;47;4;43;.915;3600000;0
856;1614;25;0;0;0;0;.00nan;0;0
856;5182;25;77;23;1;22;.957;3600000;0
856;18078;20;0;0;0;0;.00nan;0;0
857;500;4182;63;22;2;20;.909;3600000;0
857;738;27;74;41;4;37;.902;2548000;0
857;25521;4182;0;0;0;0;.00nan;0;0
857;26623;27;39;23;4;19;.826;1052000;0
858;1913;30;86;54;5;49;.907;3600000;0
858;4450;5;0;0;0;0;.00nan;0;0
858;4826;30;0;0;0;0;.00nan;0;0
858;19823;5;60;22;2;20;.909;3600000;0
859;1821;3;84;23;1;22;.957;3600000;0
859;2054;3;0;0;0;0;.00nan;0;0
859;5385;17;0;0;0;0;.00nan;0;0
859;34006;17;70;41;4;37;.902;3600000;0
860;1796;16;0;0;0;0;.00nan;0;0
860;15437;16;69;24;2;22;.917;3600000;0
860;18104;10;72;30;3;27;.900;3586000;0
860;27488;10;0;0;0;0;.00nan;0;0
861;445;12;87;31;1;30;.968;3600000;0
861;724;11;79;38;3;35;.921;3511000;0
861;21522;11;0;0;0;0;.00nan;0;0
861;34786;12;0;0;0;0;.00nan;0;0
862;1572;4838;0;0;0;0;.00nan;0;0
862;2328;4838;72;32;3;29;.906;3600000;0
862;15464;32;59;36;6;30;.833;3317000;0
862;16006;32;58;3;0;3;1.000;283000;0
863;2423;15;0;0;0;0;.00nan;0;0
863;4106;15;65;35;4;31;.886;3600000;0
863;7139;29;0;0;0;0;.00nan;0;0
863;18351;29;68;20;1;19;.950;3600000;0
864;61;31;0;0;0;0;.00nan;0;0
864;2058;28;69;39;4;35;.897;3600000;0
864;14061;28;0;0;0;0;.00nan;0;0
864;34797;31;39;26;5;21;.808;3545000;0
865;335;18;0;0;0;0;.00nan;0;0
865;928;20;0;0;0;0;.00nan;0;0
865;5001;18;60;27;4;23;.852;3636000;0
865;18078;20;96;40;3;37;.925;3636000;0
866;262;35;66;39;4;35;.897;3574000;0
866;1251;14;0;0;0;0;.00nan;0;0
866;1430;35;0;0;0;0;.00nan;0;0
866;25584;14;73;33;3;30;.909;3600000;0
867;10103;24;54;43;6;37;.860;3600000;0
867;13979;24;0;0;0;0;.00nan;0;0
867;27739;22;0;0;0;0;.00nan;0;0
867;28026;22;99;43;2;41;.953;3600000;0
868;823;23;0;0;0;0;.00nan;0;0
868;10274;23;76;42;4;38;.905;3560000;0
868;15505;8;61;24;2;22;.917;3600000;0
868;25076;8;0;0;0;0;.00nan;0;0
869;544;19;0;0;0;0;.00nan;0;0
869;1074;0;0;0;0;0;.00nan;0;0
869;31035;0;86;48;4;44;.917;3600000;0
869;31124;19;86;25;1;24;.960;3600000;0
870;1614;25;100;25;0;25;1.000;3600000;0
870;5182;25;0;0;0;0;.00nan;0;0
870;22601;26;81;35;2;33;.943;3573000;0
870;32754;26;0;0;0;0;.00nan;0;0
871;500;4182;96;23;1;22;.957;3600000;0
871;4450;5;80;38;3;35;.921;3531000;0
871;19823;5;0;0;0;0;.00nan;0;0
871;25521;4182;0;0;0;0;.00nan;0;0
872;262;35;44;7;1;6;.857;646000;0
872;1430;35;51;44;6;38;.864;2954000;0
872;5385;17;78;12;0;12;1.000;3600000;0
872;34006;17;0;0;0;0;.00nan;0;0
873;323;9;0;0;0;0;.00nan;0;0
873;7139;29;98;42;2;40;.952;3545000;0
873;18351;29;0;0;0;0;.00nan;0;0
873;20853;9;70;17;1;16;.941;3600000;0
874;51;21;60;39;5;34;.872;3820000;0
874;18104;10;27;25;6;19;.760;3820000;0
874;25843;21;0;0;0;0;.00nan;0;0
874;27488;10;0;0;0;0;.00nan;0;0
875;2423;15;80;24;1;23;.958;3600000;0
875;4106;15;0;0;0;0;.00nan;0;0
875;10103;24;0;0;0;0;.00nan;0;0
875;13979;24;87;40;3;37;.925;3585000;0
876;724;11;100;31;0;31;1.000;3600000;0
876;13842;34;79;35;3;32;.914;3600000;0
876;15502;34;0;0;0;0;.00nan;0;0
876;21522;11;0;0;0;0;.00nan;0;0
877;445;12;98;57;3;54;.947;3600000;0
877;4506;33;100;32;0;32;1.000;3600000;0
877;34740;33;0;0;0;0;.00nan;0;0
877;34786;12;0;0;0;0;.00nan;0;0
878;500;4182;0;0;0;0;.00nan;0;0
878;1913;30;0;0;0;0;.00nan;0;0
878;4826;30;62;48;6;42;.875;3600000;0
878;25521;4182;61;27;3;24;.889;3600000;0
879;335;18;0;0;0;0;.00nan;0;0
879;1821;3;0;0;0;0;.00nan;0;0
879;2054;3;34;27;6;21;.778;3600000;0
879;5001;18;77;34;3;31;.912;3600000;0
880;61;31;0;0;0;0;.00nan;0;0
880;323;9;51;44;6;38;.864;3600000;0
880;20853;9;0;0;0;0;.00nan;0;0
880;34797;31;94;32;2;30;.938;3600000;0
881;928;20;0;0;0;0;.00nan;0;0
881;1796;16;0;0;0;0;.00nan;0;0
881;15437;16;64;28;3;25;.893;3563000;0
881;18078;20;74;31;2;29;.935;3600000;0
882;1251;14;0;0;0;0;.00nan;0;0
882;15505;8;66;39;4;35;.897;3600000;0
882;25076;8;0;0;0;0;.00nan;0;0
882;25584;14;58;42;5;37;.881;3597000;0
883;1572;4838;0;0;0;0;.00nan;0;0
883;2328;4838;49;35;5;30;.857;3600000;0
883;27739;22;0;0;0;0;.00nan;0;0
883;28026;22;53;16;2;14;.875;3600000;0
884;4450;5;53;23;3;20;.870;3551000;0
884;13842;34;0;0;0;0;.00nan;0;0
884;15502;34;99;42;2;40;.952;3600000;0
884;19823;5;0;0;0;0;.00nan;0;0
885;544;19;0;0;0;0;.00nan;0;0
885;1614;25;78;31;2;29;.935;3600000;0
885;5182;25;0;0;0;0;.00nan;0;0
885;31124;19;61;36;4;32;.889;3574000;0
886;823;23;0;0;0;0;.00nan;0;0
886;1074;0;0;0;0;0;.00nan;0;0
886;10274;23;71;33;3;30;.909;3600000;0
886;31035;0;46;42;6;36;.857;3600000;0
887;2058;28;0;0;0;0;.00nan;0;0
887;22601;26;42;43;7;36;.837;3600000;0
887;26824;28;99;29;0;29;1.000;3600000;0
887;32754;26;0;0;0;0;.00nan;0;0
888;738;27;0;0;0;0;.00nan;0;0
888;15464;32;58;31;4;27;.871;3900000;0
888;16006;32;0;0;0;0;.00nan;0;0
888;26623;27;70;31;4;27;.871;3900000;0
889;724;11;85;32;2;30;.938;3528000;0
889;5385;17;100;38;0;38;1.000;3600000;0
889;21522;11;0;0;0;0;.00nan;0;0
889;34006;17;0;0;0;0;.00nan;0;0
890;51;21;92;33;1;32;.970;3600000;0
890;1796;16;61;36;5;31;.861;3600000;0
890;15437;16;0;0;0;0;.00nan;0;0
890;25843;21;0;0;0;0;.00nan;0;0
891;1572;4838;0;0;0;0;.00nan;0;0
891;2328;4838;69;41;4;37;.902;3600000;0
891;10103;24;0;0;0;0;.00nan;0;0
891;13979;24;75;20;1;19;.950;3600000;0
892;7139;29;0;0;0;0;.00nan;0;0
892;15505;8;0;0;0;0;.00nan;0;0
892;18351;29;82;24;1;23;.958;3600000;0
892;25076;8;48;30;4;26;.867;3600000;0
893;262;35;93;19;0;19;1.000;3600000;0
893;445;12;78;29;3;26;.897;3600000;0
893;1430;35;0;0;0;0;.00nan;0;0
893;34786;12;0;0;0;0;.00nan;0;0
894;4506;33;46;40;6;34;.850;3600000;0
894;18104;10;97;39;1;38;.974;3600000;0
894;27488;10;0;0;0;0;.00nan;0;0
894;34740;33;0;0;0;0;.00nan;0;0
895;500;4182;56;29;3;26;.897;3900000;0
895;2058;28;0;0;0;0;.00nan;0;0
895;25521;4182;0;0;0;0;.00nan;0;0
895;26824;28;75;38;3;35;.921;3900000;0
896;738;27;77;37;3;34;.919;3758000;0
896;1913;30;0;0;0;0;.00nan;0;0
896;4826;30;66;25;2;23;.920;3758000;0
896;26623;27;0;0;0;0;.00nan;0;0
897;724;11;0;0;0;0;.00nan;0;0
897;4450;5;0;0;0;0;.00nan;0;0
897;19823;5;65;17;1;16;.941;3600000;0
897;21522;11;60;22;2;20;.909;3595000;0
898;61;31;0;0;0;0;.00nan;0;0
898;5385;17;81;37;3;34;.919;3600000;0
898;34006;17;0;0;0;0;.00nan;0;0
898;34797;31;69;36;4;32;.889;3541000;0
899;928;20;95;35;2;33;.943;3600000;0
899;1614;25;58;33;4;29;.879;3526000;0
899;5182;25;0;0;0;0;.00nan;0;0
899;18078;20;0;0;0;0;.00nan;0;0
900;1821;3;56;20;2;18;.900;3600000;0
900;2054;3;0;0;0;0;.00nan;0;0
900;13842;34;56;35;5;30;.857;3600000;0
900;15502;34;0;0;0;0;.00nan;0;0
901;1572;4838;0;0;0;0;.00nan;0;0
901;1821;3;0;0;0;0;.00nan;0;0
901;2054;3;68;20;2;18;.900;3600000;0
901;2328;4838;83;40;3;37;.925;3591000;0
902;323;9;62;8;0;8;1.000;1044000;0
902;20853;9;43;28;6;22;.786;2556000;0
902;22601;26;0;0;0;0;.00nan;0;0
902;32754;26;100;38;1;37;.974;3600000;0
903;51;21;91;42;3;39;.929;3600000;0
903;1614;25;66;17;2;15;.882;2977000;0
903;5182;25;25;6;3;3;.500;588000;0
903;25843;21;0;0;0;0;.00nan;0;0
904;500;4182;94;21;0;21;1.000;3600000;0
904;1251;14;51;3;0;3;1.000;623000;0
904;25521;4182;0;0;0;0;.00nan;0;0
904;25584;14;27;39;8;31;.795;2977000;0
905;61;31;90;32;1;31;.969;3600000;0
905;2423;15;0;0;0;0;.00nan;0;0
905;4106;15;86;35;2;33;.943;3543000;0
905;34797;31;0;0;0;0;.00nan;0;0
906;1913;30;0;0;0;0;.00nan;0;0
906;4826;30;100;34;0;34;1.000;3600000;0
906;15505;8;0;0;0;0;.00nan;0;0
906;25076;8;84;30;2;28;.933;3544000;0
907;1796;16;55;2;0;2;1.000;558000;0
907;2058;28;0;0;0;0;.00nan;0;0
907;15437;16;69;33;3;30;.909;3342000;0
907;26824;28;95;35;3;32;.914;3900000;0
908;445;12;75;29;2;27;.931;3600000;0
908;15464;32;74;34;3;31;.912;3568000;0
908;16006;32;0;0;0;0;.00nan;0;0
908;34786;12;0;0;0;0;.00nan;0;0
909;262;35;39;32;6;26;.813;3600000;0
909;1430;35;0;0;0;0;.00nan;0;0
909;18104;10;0;0;0;0;.00nan;0;0
909;27488;10;86;29;2;27;.931;3600000;0
910;4506;33;93;44;1;43;.977;3600000;0
910;7139;29;49;30;5;25;.833;3600000;0
910;18351;29;0;0;0;0;.00nan;0;0
910;34740;33;0;0;0;0;.00nan;0;0
911;544;19;0;0;0;0;.00nan;0;0
911;27739;22;0;0;0;0;.00nan;0;0
911;28026;22;91;37;2;35;.946;3600000;0
911;31124;19;65;27;3;24;.889;3600000;0
912;823;23;0;0;0;0;.00nan;0;0
912;10274;23;69;23;3;20;.870;3600000;0
912;27739;22;62;45;6;39;.867;3246000;0
912;28026;22;53;3;0;3;1.000;354000;0
913;335;18;0;0;0;0;.00nan;0;0
913;1074;0;0;0;0;0;.00nan;0;0
913;5001;18;60;38;5;33;.868;3577000;0
913;31035;0;71;31;3;28;.903;3600000;0
914;4450;5;0;0;0;0;.00nan;0;0
914;15505;8;0;0;0;0;.00nan;0;0
914;19823;5;92;32;1;31;.969;3600000;0
914;25076;8;57;27;3;24;.889;3540000;0
915;500;4182;47;27;5;22;.815;3569000;0
915;5385;17;71;33;3;30;.909;3600000;0
915;25521;4182;0;0;0;0;.00nan;0;0
915;34006;17;0;0;0;0;.00nan;0;0
916;1821;3;65;34;4;30;.882;3600000;0
916;2054;3;0;0;0;0;.00nan;0;0
916;22601;26;0;0;0;0;.00nan;0;0
916;32754;26;82;55;5;50;.909;3600000;0
917;1572;4838;0;0;0;0;.00nan;0;0
917;2058;28;0;0;0;0;.00nan;0;0
917;2328;4838;65;40;5;35;.875;3600000;0
917;26824;28;63;19;2;17;.895;3600000;0
918;262;35;70;24;2;22;.917;3600000;0
918;323;9;0;0;0;0;.00nan;0;0
918;1430;35;0;0;0;0;.00nan;0;0
918;20853;9;93;38;1;37;.974;3600000;0
919;61;31;0;0;0;0;.00nan;0;0
919;1251;14;0;0;0;0;.00nan;0;0
919;25584;14;100;27;0;27;1.000;3600000;0
919;34797;31;51;26;3;23;.885;3600000;0
920;51;21;35;34;7;27;.794;3600000;0
920;4506;33;85;33;2;31;.939;3600000;0
920;25843;21;0;0;0;0;.00nan;0;0
920;34740;33;0;0;0;0;.00nan;0;0
921;928;20;0;0;0;0;.00nan;0;0
921;2423;15;0;0;0;0;.00nan;0;0
921;4106;15;82;37;3;34;.919;3600000;0
921;18078;20;61;33;4;29;.879;3575000;0
922;1614;25;87;34;1;33;.971;3600000;0
922;5182;25;0;0;0;0;.00nan;0;0
922;10103;24;88;34;2;32;.941;3572000;0
922;13979;24;0;0;0;0;.00nan;0;0
923;1796;16;0;0;0;0;.00nan;0;0
923;15437;16;98;43;2;41;.953;3900000;0
923;18104;10;96;45;2;43;.956;3900000;0
923;27488;10;0;0;0;0;.00nan;0;0
924;1913;30;0;0;0;0;.00nan;0;0
924;4826;30;72;41;4;37;.902;3554000;0
924;15464;32;0;0;0;0;.00nan;0;0
924;16006;32;72;27;2;25;.926;3600000;0
925;544;19;0;0;0;0;.00nan;0;0
925;7139;29;40;21;4;17;.810;3600000;0
925;18351;29;0;0;0;0;.00nan;0;0
925;31124;19;83;39;3;36;.923;3600000;0
926;724;11;62;36;4;32;.889;3555000;0
926;738;27;83;35;3;32;.914;3600000;0
926;21522;11;0;0;0;0;.00nan;0;0
926;26623;27;0;0;0;0;.00nan;0;0
927;928;20;56;34;4;30;.882;3600000;0
927;4506;33;58;34;5;29;.853;3569000;0
927;18078;20;0;0;0;0;.00nan;0;0
927;34740;33;0;0;0;0;.00nan;0;0
928;500;4182;70;25;2;23;.920;3600000;0
928;2423;15;64;31;3;28;.903;3600000;0
928;4106;15;0;0;0;0;.00nan;0;0
928;25521;4182;0;0;0;0;.00nan;0;0
929;262;35;57;6;0;6;1.000;901000;0
929;1430;35;33;31;6;25;.806;2699000;0
929;13842;34;100;24;0;24;1.000;3600000;0
929;15502;34;0;0;0;0;.00nan;0;0
930;335;18;0;0;0;0;.00nan;0;0
930;5001;18;78;32;2;30;.938;3600000;0
930;27739;22;0;0;0;0;.00nan;0;0
930;28026;22;60;32;4;28;.875;3516000;0
931;4450;5;0;0;0;0;.00nan;0;0
931;19823;5;92;30;1;29;.967;3600000;0
931;22601;26;93;35;2;33;.943;3568000;0
931;32754;26;0;0;0;0;.00nan;0;0
932;1074;0;0;0;0;0;.00nan;0;0
932;1572;4838;0;0;0;0;.00nan;0;0
932;2328;4838;44;31;5;26;.839;3520000;0
932;31035;0;56;24;3;21;.875;3600000;0
933;2058;28;0;0;0;0;.00nan;0;0
933;15505;8;0;0;0;0;.00nan;0;0
933;25076;8;100;50;4;46;.920;3900000;0
933;26824;28;51;32;4;28;.875;3900000;0
934;51;21;75;22;2;20;.909;3558000;0
934;1913;30;99;35;1;34;.971;3600000;0
934;4826;30;0;0;0;0;.00nan;0;0
934;25843;21;0;0;0;0;.00nan;0;0
935;1251;14;56;11;1;10;.909;1643000;0
935;10103;24;0;0;0;0;.00nan;0;0
935;13979;24;50;34;5;29;.853;3600000;0
935;25584;14;16;22;6;16;.727;1957000;0
936;1796;16;100;36;0;36;1.000;3600000;0
936;15437;16;0;0;0;0;.00nan;0;0
936;15464;32;71;24;1;23;.958;3578000;0
936;16006;32;0;0;0;0;.00nan;0;0
937;445;12;0;0;0;0;.00nan;0;0
937;18104;10;73;29;3;26;.897;3600000;0
937;27488;10;0;0;0;0;.00nan;0;0
937;34786;12;56;27;4;23;.852;3545000;0
938;323;9;69;33;4;29;.879;3598000;0
938;544;19;0;0;0;0;.00nan;0;0
938;20853;9;0;0;0;0;.00nan;0;0
938;31124;19;76;32;2;30;.938;3600000;0
939;823;23;0;0;0;0;.00nan;0;0
939;7139;29;80;30;2;28;.933;3600000;0
939;10274;23;71;47;5;42;.894;3600000;0
939;18351;29;0;0;0;0;.00nan;0;0
940;724;11;93;49;4;45;.918;3600000;0
940;738;27;0;0;0;0;.00nan;0;0
940;21522;11;0;0;0;0;.00nan;0;0
940;26623;27;76;21;1;20;.952;3600000;0
941;1821;3;100;47;1;46;.979;3600000;0
941;2054;3;0;0;0;0;.00nan;0;0
941;5385;17;67;23;2;21;.913;3585000;0
941;34006;17;0;0;0;0;.00nan;0;0
942;928;20;0;0;0;0;.00nan;0;0
942;1913;30;0;0;0;0;.00nan;0;0
942;4826;30;100;32;1;31;.969;3900000;0
942;18078;20;78;27;1;26;.963;3900000;0
943;1074;0;75;23;2;21;.913;3671000;0
943;1251;14;65;28;3;25;.893;3671000;0
943;25584;14;0;0;0;0;.00nan;0;0
943;31035;0;0;0;0;0;.00nan;0;0
944;2423;15;0;0;0;0;.00nan;0;0
944;4106;15;54;42;7;35;.833;3600000;0
944;10103;24;85;29;1;28;.966;3600000;0
944;13979;24;0;0;0;0;.00nan;0;0
945;500;4182;62;24;3;21;.875;3600000;0
945;13842;34;39;20;4;16;.800;3560000;0
945;15502;34;0;0;0;0;.00nan;0;0
945;25521;4182;0;0;0;0;.00nan;0;0
946;1796;16;97;33;1;32;.970;3600000;0
946;4506;33;34;23;5;18;.783;3600000;0
946;15437;16;0;0;0;0;.00nan;0;0
946;34740;33;0;0;0;0;.00nan;0;0
947;262;35;73;28;2;26;.929;3600000;0
947;1430;35;0;0;0;0;.00nan;0;0
947;15464;32;0;0;0;0;.00nan;0;0
947;16006;32;58;32;5;27;.844;3600000;0
948;544;19;36;34;6;28;.824;3600000;0
948;1614;25;0;0;0;0;.00nan;0;0
948;5182;25;84;40;3;37;.925;3600000;0
948;31124;19;0;0;0;0;.00nan;0;0
949;335;18;0;0;0;0;.00nan;0;0
949;5001;18;51;22;3;19;.864;3600000;0
949;7139;29;0;0;0;0;.00nan;0;0
949;18351;29;68;44;5;39;.886;3556000;0
950;61;31;0;0;0;0;.00nan;0;0
950;724;11;0;0;0;0;.00nan;0;0
950;21522;11;95;36;1;35;.972;3600000;0
950;34797;31;90;35;2;33;.943;3600000;0
951;2058;28;0;0;0;0;.00nan;0;0
951;22601;26;0;0;0;0;.00nan;0;0
951;26824;28;100;34;0;34;1.000;3600000;0
951;32754;26;77;30;3;27;.900;3600000;0
952;445;12;97;37;2;35;.946;3600000;0
952;1821;3;0;0;0;0;.00nan;0;0
952;2054;3;79;24;1;23;.958;3600000;0
952;34786;12;0;0;0;0;.00nan;0;0
953;1074;0;0;0;0;0;.00nan;0;0
953;22601;26;68;32;3;29;.906;3900000;0
953;31035;0;76;29;3;26;.897;3900000;0
953;32754;26;0;0;0;0;.00nan;0;0
954;1913;30;0;0;0;0;.00nan;0;0
954;4826;30;78;30;2;28;.933;3600000;0
954;18104;10;82;42;3;39;.929;3555000;0
954;27488;10;0;0;0;0;.00nan;0;0
955;928;20;0;0;0;0;.00nan;0;0
955;18078;20;100;37;1;36;.973;3900000;0
955;27739;22;0;0;0;0;.00nan;0;0
955;28026;22;74;25;1;24;.960;3900000;0
956;4450;5;51;32;5;27;.844;3600000;0
956;15505;8;0;0;0;0;.00nan;0;0
956;19823;5;0;0;0;0;.00nan;0;0
956;25076;8;100;33;0;33;1.000;3600000;0
957;2423;15;0;0;0;0;.00nan;0;0
957;4106;15;78;38;3;35;.921;3600000;0
957;15464;32;40;34;7;27;.794;3600000;0
957;16006;32;0;0;0;0;.00nan;0;0
958;500;4182;50;24;4;20;.833;3522000;0
958;4506;33;0;0;0;0;.00nan;0;0
958;25521;4182;0;0;0;0;.00nan;0;0
958;34740;33;100;42;2;40;.952;3600000;0
959;323;9;59;39;4;35;.897;3900000;0
959;823;23;0;0;0;0;.00nan;0;0
959;10274;23;63;36;4;32;.889;3900000;0
959;20853;9;0;0;0;0;.00nan;0;0
960;51;21;72;39;4;35;.897;3600000;0
960;335;18;0;0;0;0;.00nan;0;0
960;5001;18;66;31;3;28;.903;3600000;0
960;25843;21;0;0;0;0;.00nan;0;0
961;724;11;0;0;0;0;.00nan;0;0
961;1614;25;64;19;1;18;.947;3600000;0
961;5182;25;0;0;0;0;.00nan;0;0
961;21522;11;97;55;4;51;.927;3600000;0
962;61;31;0;0;0;0;.00nan;0;0
962;738;27;0;0;0;0;.00nan;0;0
962;26623;27;100;22;0;22;1.000;3600000;0
962;34797;31;75;37;4;33;.892;3600000;0
963;2058;28;0;0;0;0;.00nan;0;0
963;13842;34;75;21;1;20;.952;3544000;0
963;15502;34;0;0;0;0;.00nan;0;0
963;26824;28;98;24;0;24;1.000;3600000;0
964;262;35;53;30;4;26;.867;3573000;0
964;1430;35;0;0;0;0;.00nan;0;0
964;4450;5;0;0;0;0;.00nan;0;0
964;19823;5;67;26;2;24;.923;3600000;0
965;51;21;0;0;0;0;.00nan;0;0
965;544;19;0;0;0;0;.00nan;0;0
965;25843;21;76;37;3;34;.919;3600000;0
965;31124;19;100;27;0;27;1.000;3600000;0
966;1572;4838;95;32;1;31;.969;3600000;0
966;2328;4838;0;0;0;0;.00nan;0;0
966;7139;29;53;23;3;20;.870;3542000;0
966;18351;29;0;0;0;0;.00nan;0;0
967;1821;3;100;42;2;40;.952;3900000;0
967;2054;3;0;0;0;0;.00nan;0;0
967;10103;24;88;38;2;36;.947;3900000;0
967;13979;24;0;0;0;0;.00nan;0;0
968;445;12;100;33;1;32;.970;3900000;0
968;1074;0;0;0;0;0;.00nan;0;0
968;31035;0;93;36;1;35;.972;3900000;0
968;34786;12;0;0;0;0;.00nan;0;0
969;1251;14;0;0;0;0;.00nan;0;0
969;15464;32;96;41;2;39;.951;3900000;0
969;16006;32;0;0;0;0;.00nan;0;0
969;25584;14;88;29;2;27;.931;3900000;0
970;13842;34;0;0;0;0;.00nan;0;0
970;15502;34;71;31;3;28;.903;3593000;0
970;27739;22;0;0;0;0;.00nan;0;0
970;28026;22;88;27;1;26;.963;3600000;0
971;1796;16;67;32;3;29;.906;3600000;0
971;2423;15;52;36;5;31;.861;3560000;0
971;4106;15;0;0;0;0;.00nan;0;0
971;15437;16;0;0;0;0;.00nan;0;0
972;823;23;0;0;0;0;.00nan;0;0
972;5385;17;66;28;3;25;.893;3600000;0
972;10274;23;54;38;5;33;.868;3533000;0
972;34006;17;0;0;0;0;.00nan;0;0
973;323;9;0;0;0;0;.00nan;0;0
973;335;18;94;28;1;27;.964;3600000;0
973;5001;18;0;0;0;0;.00nan;0;0
973;20853;9;83;44;3;41;.932;3515000;0
974;61;31;62;15;1;14;.933;1458000;0
974;500;4182;100;21;0;21;1.000;3600000;0
974;25521;4182;0;0;0;0;.00nan;0;0
974;34797;31;54;30;4;26;.867;2142000;0
975;724;11;0;0;0;0;.00nan;0;0
975;738;27;0;0;0;0;.00nan;0;0
975;21522;11;68;25;2;23;.920;3572000;0
975;26623;27;84;27;1;26;.963;3600000;0
976;1251;14;16;13;5;8;.615;914000;0
976;2058;28;0;0;0;0;.00nan;0;0
976;25584;14;46;25;4;21;.840;2686000;0
976;26824;28;89;32;1;31;.969;3600000;0
977;10103;24;0;0;0;0;.00nan;0;0
977;13979;24;73;33;3;30;.909;3600000;0
977;27739;22;49;30;4;26;.867;3583000;0
977;28026;22;0;0;0;0;.00nan;0;0
978;4450;5;58;25;3;22;.880;3600000;0
978;4506;33;89;64;5;59;.922;3600000;0
978;19823;5;0;0;0;0;.00nan;0;0
978;34740;33;0;0;0;0;.00nan;0;0
979;544;19;0;0;0;0;.00nan;0;0
979;5385;17;0;0;0;0;.00nan;0;0
979;31124;19;100;34;1;33;.971;3600000;0
979;34006;17;37;33;5;28;.848;3600000;0
980;61;31;0;0;0;0;.00nan;0;0
980;1913;30;0;0;0;0;.00nan;0;0
980;4826;30;100;46;2;44;.957;3600000;0
980;34797;31;47;22;4;18;.818;3517000;0
981;738;27;87;34;2;32;.941;3600000;0
981;1614;25;54;25;3;22;.880;3600000;0
981;5182;25;0;0;0;0;.00nan;0;0
981;26623;27;0;0;0;0;.00nan;0;0
982;1074;0;0;0;0;0;.00nan;0;0
982;2058;28;16;7;4;3;.429;509000;0
982;26824;28;67;20;1;19;.950;3091000;0
982;31035;0;79;33;2;31;.939;3600000;0
983;7139;29;0;0;0;0;.00nan;0;0
983;18104;10;44;38;6;32;.842;3600000;0
983;18351;29;88;30;2;28;.933;3600000;0
983;27488;10;0;0;0;0;.00nan;0;0
984;445;12;55;26;3;23;.885;3521000;0
984;928;20;0;0;0;0;.00nan;0;0
984;18078;20;76;22;1;21;.955;3600000;0
984;34786;12;0;0;0;0;.00nan;0;0
985;1796;16;79;32;2;30;.938;3600000;0
985;13842;34;62;31;3;28;.903;3596000;0
985;15437;16;0;0;0;0;.00nan;0;0
985;15502;34;0;0;0;0;.00nan;0;0
986;1821;3;0;0;0;0;.00nan;0;0
986;2054;3;88;16;0;16;1.000;3600000;0
986;15464;32;98;44;2;42;.955;3577000;0
986;16006;32;0;0;0;0;.00nan;0;0
987;262;35;85;29;1;28;.966;3600000;0
987;1430;35;0;0;0;0;.00nan;0;0
987;15505;8;0;0;0;0;.00nan;0;0
987;25076;8;81;44;4;40;.909;3600000;0
988;51;21;83;24;1;23;.958;3600000;0
988;823;23;0;0;0;0;.00nan;0;0
988;10274;23;76;42;4;38;.905;3600000;0
988;25843;21;0;0;0;0;.00nan;0;0
989;335;18;0;0;0;0;.00nan;0;0
989;544;19;44;36;6;30;.833;2594000;0
989;5001;18;74;38;4;34;.895;3600000;0
989;31124;19;40;10;2;8;.800;1006000;0
990;2423;15;0;0;0;0;.00nan;0;0
990;4106;15;93;13;0;13;1.000;3600000;0
990;22601;26;0;0;0;0;.00nan;0;0
990;32754;26;72;26;2;24;.923;3551000;0
991;500;4182;70;43;6;37;.860;3692000;0
991;724;11;57;36;5;31;.861;3692000;0
991;21522;11;0;0;0;0;.00nan;0;0
991;25521;4182;0;0;0;0;.00nan;0;0
992;323;9;73;23;1;22;.957;3600000;0
992;1572;4838;0;0;0;0;.00nan;0;0
992;2328;4838;82;37;2;35;.946;3600000;0
992;20853;9;0;0;0;0;.00nan;0;0
993;928;20;72;32;3;29;.906;3600000;0
993;1251;14;0;0;0;0;.00nan;0;0
993;18078;20;0;0;0;0;.00nan;0;0
993;25584;14;100;30;0;30;1.000;3600000;0
994;445;12;0;0;0;0;.00nan;0;0
994;27739;22;0;0;0;0;.00nan;0;0
994;28026;22;70;25;2;23;.920;3600000;0
994;34786;12;55;33;4;29;.879;3600000;0
995;10103;24;83;25;1;24;.960;3600000;0
995;13979;24;0;0;0;0;.00nan;0;0
995;18104;10;0;0;0;0;.00nan;0;0
995;27488;10;72;30;3;27;.900;3523000;0
996;4506;33;50;21;3;18;.857;3515000;0
996;15505;8;100;37;1;36;.973;3600000;0
996;25076;8;0;0;0;0;.00nan;0;0
996;34740;33;0;0;0;0;.00nan;0;0
997;335;18;0;0;0;0;.00nan;0;0
997;5001;18;76;20;1;19;.950;3600000;0
997;5385;17;59;43;5;38;.884;3600000;0
997;34006;17;0;0;0;0;.00nan;0;0
998;738;27;0;0;0;0;.00nan;0;0
998;22601;26;59;40;5;35;.875;3600000;0
998;26623;27;62;19;2;17;.895;3600000;0
998;32754;26;0;0;0;0;.00nan;0;0
999;1074;0;0;0;0;0;.00nan;0;0
999;4450;5;0;0;0;0;.00nan;0;0
999;19823;5;100;21;0;21;1.000;3600000;0
999;31035;0;45;42;7;35;.833;3600000;0
1000;262;35;81;29;1;28;.966;3600000;0
1000;500;4182;58;28;3;25;.893;3549000;0
1000;1430;35;0;0;0;0;.00nan;0;0
1000;25521;4182;0;0;0;0;.00nan;0;0
1001;823;23;0;0;0;0;.00nan;0;0
1001;1614;25;0;0;0;0;.00nan;0;0
1001;5182;25;68;21;2;19;.905;3600000;0
1001;10274;23;89;55;3;52;.945;3600000;0
1002;1913;30;0;0;0;0;.00nan;0;0
1002;4826;30;75;24;1;23;.958;3600000;0
1002;15464;32;63;31;4;27;.871;3600000;0
1002;16006;32;0;0;0;0;.00nan;0;0
1003;323;9;0;0;0;0;.00nan;0;0
1003;1251;14;0;0;0;0;.00nan;0;0
1003;20853;9;54;29;4;25;.862;3600000;0
1003;25584;14;53;36;5;31;.861;3554000;0
1004;51;21;91;21;0;21;1.000;3600000;0
1004;18104;10;74;26;2;24;.923;3559000;0
1004;25843;21;0;0;0;0;.00nan;0;0
1004;27488;10;0;0;0;0;.00nan;0;0
1005;928;20;52;29;4;25;.862;3283000;0
1005;4450;5;0;0;0;0;.00nan;0;0
1005;18078;20;23;5;3;2;.400;317000;0
1005;19823;5;70;20;1;19;.950;3600000;0
1006;2423;15;0;0;0;0;.00nan;0;0
1006;4106;15;54;30;4;26;.867;3515000;0
1006;13842;34;81;36;2;34;.944;3600000;0
1006;15502;34;0;0;0;0;.00nan;0;0
1007;1796;16;80;40;3;37;.925;3600000;0
1007;15437;16;0;0;0;0;.00nan;0;0
1007;27739;22;0;0;0;0;.00nan;0;0
1007;28026;22;39;24;4;20;.833;3592000;0
1008;7139;29;0;0;0;0;.00nan;0;0
1008;10103;24;75;40;4;36;.900;3600000;0
1008;13979;24;0;0;0;0;.00nan;0;0
1008;18351;29;87;27;1;26;.963;3600000;0
1009;445;12;66;30;3;27;.900;3553000;0
1009;823;23;0;0;0;0;.00nan;0;0
1009;10274;23;84;34;2;32;.941;3600000;0
1009;34786;12;0;0;0;0;.00nan;0;0
1010;500;4182;57;4;0;4;1.000;869000;0
1010;4506;33;100;35;1;34;.971;3600000;0
1010;25521;4182;17;24;6;18;.750;2731000;0
1010;34740;33;0;0;0;0;.00nan;0;0
1011;544;19;0;0;0;0;.00nan;0;0
1011;738;27;0;0;0;0;.00nan;0;0
1011;26623;27;99;30;1;29;.967;3900000;0
1011;31124;19;98;54;1;53;.981;3900000;0
1012;724;11;0;0;0;0;.00nan;0;0
1012;15464;32;0;0;0;0;.00nan;0;0
1012;16006;32;67;17;1;16;.941;3600000;0
1012;21522;11;38;22;4;18;.818;3600000;0
1013;2423;15;100;41;1;40;.976;3600000;0
1013;4106;15;0;0;0;0;.00nan;0;0
1013;5385;17;70;46;7;39;.848;3600000;0
1013;34006;17;0;0;0;0;.00nan;0;0
1014;51;21;46;26;4;22;.846;3534000;0
1014;1821;3;0;0;0;0;.00nan;0;0
1014;2054;3;90;42;3;39;.929;3600000;0
1014;25843;21;0;0;0;0;.00nan;0;0
1015;335;18;0;0;0;0;.00nan;0;0
1015;1614;25;91;29;1;28;.966;3600000;0
1015;5001;18;69;35;3;32;.914;3600000;0
1015;5182;25;0;0;0;0;.00nan;0;0
1016;1572;4838;67;12;0;12;1.000;1437000;0
1016;2328;4838;58;28;4;24;.857;2163000;0
1016;22601;26;0;0;0;0;.00nan;0;0
1016;32754;26;98;18;0;18;1.000;3600000;0
1017;1913;30;0;0;0;0;.00nan;0;0
1017;4826;30;97;37;1;36;.973;3600000;0
1017;15505;8;0;0;0;0;.00nan;0;0
1017;25076;8;61;38;4;34;.895;3600000;0
1018;4450;5;0;0;0;0;.00nan;0;0
1018;7139;29;89;52;2;50;.962;3878000;0
1018;18351;29;0;0;0;0;.00nan;0;0
1018;19823;5;80;24;1;23;.958;3878000;0
1019;61;31;0;0;0;0;.00nan;0;0
1019;717;0;96;43;3;40;.930;3600000;0
1019;1074;0;0;0;0;0;.00nan;0;0
1019;34797;31;64;28;4;24;.857;3582000;0
1020;928;20;0;0;0;0;.00nan;0;0
1020;2058;28;0;0;0;0;.00nan;0;0
1020;18078;20;63;24;2;22;.917;3671000;0
1020;26824;28;90;40;3;37;.925;3671000;0
1021;445;12;68;34;3;31;.912;3600000;0
1021;10103;24;0;0;0;0;.00nan;0;0
1021;13979;24;65;34;4;30;.882;3592000;0
1021;34786;12;0;0;0;0;.00nan;0;0
1022;1251;14;51;2;0;2;1.000;404000;0
1022;1796;16;98;40;2;38;.950;3600000;0
1022;15437;16;0;0;0;0;.00nan;0;0
1022;25584;14;25;32;7;25;.781;3196000;0
1023;262;35;50;23;3;20;.870;3600000;0
1023;335;18;70;38;4;34;.895;3600000;0
1023;1430;35;0;0;0;0;.00nan;0;0
1023;5001;18;0;0;0;0;.00nan;0;0
1024;738;27;63;42;4;38;.905;3600000;0
1024;823;23;83;14;0;14;1.000;3600000;0
1024;10274;23;0;0;0;0;.00nan;0;0
1024;26623;27;0;0;0;0;.00nan;0;0
1025;500;4182;55;28;4;24;.857;3574000;0
1025;15464;32;71;31;3;28;.903;3600000;0
1025;16006;32;0;0;0;0;.00nan;0;0
1025;25521;4182;0;0;0;0;.00nan;0;0
1026;724;11;49;27;4;23;.852;3676000;0
1026;15505;8;73;37;3;34;.919;3708000;0
1026;21522;11;0;0;0;0;.00nan;0;0
1026;25076;8;0;0;0;0;.00nan;0;0
1027;5385;17;86;30;1;29;.967;3600000;0
1027;27739;22;0;0;0;0;.00nan;0;0
1027;28026;22;68;25;3;22;.880;3512000;0
1027;34006;17;0;0;0;0;.00nan;0;0
1028;2423;15;71;29;3;26;.897;3558000;0
1028;4106;15;0;0;0;0;.00nan;0;0
1028;18104;10;85;29;1;28;.966;3600000;0
1028;27488;10;0;0;0;0;.00nan;0;0
1029;4506;33;70;26;2;24;.923;3600000;0
1029;13842;34;69;36;3;33;.917;3554000;0
1029;15502;34;0;0;0;0;.00nan;0;0
1029;34740;33;0;0;0;0;.00nan;0;0
1030;1251;14;97;46;3;43;.935;3900000;0
1030;1614;25;0;0;0;0;.00nan;0;0
1030;5182;25;78;41;3;38;.927;3900000;0
1030;25584;14;0;0;0;0;.00nan;0;0
1031;544;19;0;0;0;0;.00nan;0;0
1031;22601;26;0;0;0;0;.00nan;0;0
1031;31124;19;76;28;1;27;.964;3600000;0
1031;32754;26;78;32;2;30;.938;3590000;0
1032;1572;4838;0;0;0;0;.00nan;0;0
1032;1913;30;0;0;0;0;.00nan;0;0
1032;2328;4838;92;31;1;30;.968;3600000;0
1032;4826;30;74;37;3;34;.919;3513000;0
1033;928;20;0;0;0;0;.00nan;0;0
1033;4450;5;71;24;1;23;.958;3600000;0
1033;18078;20;56;32;5;27;.844;3600000;0
1033;19823;5;0;0;0;0;.00nan;0;0
1034;717;0;0;0;0;0;.00nan;0;0
1034;1074;0;73;38;5;33;.868;3600000;0
1034;1821;3;82;34;2;32;.941;3600000;0
1034;2054;3;0;0;0;0;.00nan;0;0
1035;61;31;0;0;0;0;.00nan;0;0
1035;2058;28;0;0;0;0;.00nan;0;0
1035;26824;28;92;36;1;35;.972;3600000;0
1035;34797;31;52;25;3;22;.880;3562000;0
1036;323;9;0;0;0;0;.00nan;0;0
1036;7139;29;0;0;0;0;.00nan;0;0
1036;18351;29;57;23;3;20;.870;3552000;0
1036;20853;9;86;30;1;29;.967;3600000;0
1037;51;21;79;38;3;35;.921;3613000;0
1037;25843;21;0;0;0;0;.00nan;0;0
1037;27739;22;80;31;2;29;.935;3613000;0
1037;28026;22;0;0;0;0;.00nan;0;0
1038;1796;16;89;29;1;28;.966;3600000;0
1038;10103;24;0;0;0;0;.00nan;0;0
1038;13979;24;66;27;3;24;.889;3526000;0
1038;15437;16;0;0;0;0;.00nan;0;0
1039;335;18;0;0;0;0;.00nan;0;0
1039;445;12;61;33;3;30;.909;3559000;0
1039;5001;18;80;26;1;25;.962;3600000;0
1039;34786;12;0;0;0;0;.00nan;0;0
1040;262;35;0;0;0;0;.00nan;0;0
1040;1430;35;87;35;2;33;.943;3600000;0
1040;13842;34;0;0;0;0;.00nan;0;0
1040;15502;34;60;33;4;29;.879;3563000;0
1041;544;19;73;36;3;33;.917;3570000;0
1041;823;23;99;27;1;26;.963;3600000;0
1041;10274;23;0;0;0;0;.00nan;0;0
1041;31124;19;0;0;0;0;.00nan;0;0
1042;500;4182;70;34;3;31;.912;3900000;0
1042;15505;8;0;0;0;0;.00nan;0;0
1042;25076;8;77;37;3;34;.919;3900000;0
1042;25521;4182;0;0;0;0;.00nan;0;0
1043;724;11;70;18;1;17;.944;3600000;0
1043;1572;4838;0;0;0;0;.00nan;0;0
1043;2328;4838;57;42;5;37;.881;3600000;0
1043;21522;11;0;0;0;0;.00nan;0;0
1044;738;27;0;0;0;0;.00nan;0;0
1044;1913;30;67;42;4;38;.905;3553000;0
1044;4826;30;0;0;0;0;.00nan;0;0
1044;26623;27;67;26;3;23;.885;3600000;0
1045;61;31;70;31;3;28;.903;3600000;0
1045;1821;3;0;0;0;0;.00nan;0;0
1045;2054;3;59;32;4;28;.875;3592000;0
1045;34797;31;0;0;0;0;.00nan;0;0
1046;51;21;0;0;0;0;.00nan;0;0
1046;717;0;98;34;1;33;.971;3900000;0
1046;1074;0;0;0;0;0;.00nan;0;0
1046;25843;21;72;20;1;19;.950;3900000;0
1047;928;20;64;21;2;19;.905;3600000;0
1047;7139;29;71;52;6;46;.885;3600000;0
1047;18078;20;0;0;0;0;.00nan;0;0
1047;18351;29;0;0;0;0;.00nan;0;0
1048;5385;17;41;22;4;18;.818;3600000;0
1048;18104;10;84;29;1;28;.966;3600000;0
1048;27488;10;0;0;0;0;.00nan;0;0
1048;34006;17;0;0;0;0;.00nan;0;0
1049;323;9;70;31;3;28;.903;3600000;0
1049;2423;15;54;1;0;1;1.000;431000;0
1049;4106;15;23;34;7;27;.794;3169000;0
1049;20853;9;0;0;0;0;.00nan;0;0
1050;1251;14;0;0;0;0;.00nan;0;0
1050;15464;32;100;26;0;26;1.000;3600000;0
1050;16006;32;0;0;0;0;.00nan;0;0
1050;25584;14;56;35;4;31;.886;3600000;0
1051;262;35;97;35;1;34;.971;3600000;0
1051;1430;35;0;0;0;0;.00nan;0;0
1051;1614;25;91;38;2;36;.947;3578000;0
1051;5182;25;0;0;0;0;.00nan;0;0
1052;4506;33;77;29;2;27;.931;3900000;0
1052;22601;26;0;0;0;0;.00nan;0;0
1052;32754;26;80;35;2;33;.943;3900000;0
1052;34740;33;0;0;0;0;.00nan;0;0
1053;10103;24;0;0;0;0;.00nan;0;0
1053;13979;24;89;35;3;32;.914;3600000;0
1053;27739;22;0;0;0;0;.00nan;0;0
1053;28026;22;63;36;4;32;.889;3600000;0
1054;5385;17;0;0;0;0;.00nan;0;0
1054;15505;8;0;0;0;0;.00nan;0;0
1054;25076;8;75;42;5;37;.881;3600000;0
1054;34006;17;72;29;2;27;.931;3600000;0
1055;335;18;0;0;0;0;.00nan;0;0
1055;1796;16;47;21;3;18;.857;3583000;0
1055;5001;18;100;44;2;42;.955;3600000;0
1055;15437;16;0;0;0;0;.00nan;0;0
1056;823;23;0;0;0;0;.00nan;0;0
1056;10274;23;51;30;5;25;.833;3632000;0
1056;22601;26;66;47;6;41;.872;3632000;0
1056;32754;26;0;0;0;0;.00nan;0;0
1057;724;11;77;25;1;24;.960;3600000;0
1057;1572;4838;0;0;0;0;.00nan;0;0
1057;2328;4838;63;29;3;26;.897;3563000;0
1057;21522;11;0;0;0;0;.00nan;0;0
1058;1821;3;46;16;3;13;.813;968000;0
1058;2054;3;37;28;6;22;.786;2632000;0
1058;4450;5;0;0;0;0;.00nan;0;0
1058;19823;5;55;19;2;17;.895;3600000;0
1059;7139;29;0;0;0;0;.00nan;0;0
1059;10103;24;80;39;2;37;.949;3574000;0
1059;13979;24;0;0;0;0;.00nan;0;0
1059;18351;29;92;31;1;30;.968;3600000;0
1060;61;31;0;0;0;0;.00nan;0;0
1060;717;0;0;0;0;0;.00nan;0;0
1060;1074;0;43;37;6;31;.838;3600000;0
1060;34797;31;81;29;1;28;.966;3600000;0
1061;2423;15;73;31;3;28;.903;3600000;0
1061;4106;15;0;0;0;0;.00nan;0;0
1061;18104;10;81;46;4;42;.913;3600000;0
1061;27488;10;0;0;0;0;.00nan;0;0
1062;928;20;0;0;0;0;.00nan;0;0
1062;13842;34;64;29;3;26;.897;3600000;0
1062;15502;34;0;0;0;0;.00nan;0;0
1062;18078;20;55;34;5;29;.853;3519000;0
1063;2058;28;0;0;0;0;.00nan;0;0
1063;15464;32;93;28;1;27;.964;3600000;0
1063;16006;32;0;0;0;0;.00nan;0;0
1063;26824;28;77;34;2;32;.941;3600000;0
1064;262;35;78;34;2;32;.941;3591000;0
1064;1251;14;95;30;1;29;.967;3600000;0
1064;1430;35;0;0;0;0;.00nan;0;0
1064;25584;14;0;0;0;0;.00nan;0;0
1065;544;19;0;0;0;0;.00nan;0;0
1065;1614;25;87;27;1;26;.963;3600000;0
1065;5182;25;0;0;0;0;.00nan;0;0
1065;31124;19;76;39;3;36;.923;3577000;0
1066;445;12;50;21;3;18;.857;3600000;0
1066;1913;30;0;0;0;0;.00nan;0;0
1066;4826;30;98;48;4;44;.917;3596000;0
1066;34786;12;0;0;0;0;.00nan;0;0
1067;4506;33;85;39;3;36;.923;3600000;0
1067;5385;17;66;38;4;34;.895;3579000;0
1067;34006;17;0;0;0;0;.00nan;0;0
1067;34740;33;0;0;0;0;.00nan;0;0
1068;323;9;0;0;0;0;.00nan;0;0
1068;18104;10;0;0;0;0;.00nan;0;0
1068;20853;9;66;32;3;29;.906;3600000;0
1068;27488;10;80;30;2;28;.933;3600000;0
1069;724;11;54;3;0;3;1.000;329000;0
1069;823;23;0;0;0;0;.00nan;0;0
1069;10274;23;80;36;3;33;.917;3600000;0
1069;21522;11;45;40;6;34;.850;3271000;0
1070;335;18;0;0;0;0;.00nan;0;0
1070;1796;16;86;32;2;30;.938;3600000;0
1070;5001;18;57;25;3;22;.880;3583000;0
1070;15437;16;0;0;0;0;.00nan;0;0
1071;738;27;66;21;2;19;.905;3600000;0
1071;22601;26;0;0;0;0;.00nan;0;0
1071;26623;27;0;0;0;0;.00nan;0;0
1071;32754;26;76;49;5;44;.898;3600000;0
1072;500;4182;70;25;2;23;.920;3600000;0
1072;1572;4838;0;0;0;0;.00nan;0;0
1072;2328;4838;82;50;4;46;.920;3567000;0
1072;25521;4182;0;0;0;0;.00nan;0;0
1073;51;21;28;40;7;33;.825;3600000;0
1073;4450;5;0;0;0;0;.00nan;0;0
1073;19823;5;72;26;2;24;.923;3600000;0
1073;25843;21;0;0;0;0;.00nan;0;0
1074;1821;3;65;23;2;21;.913;3600000;0
1074;2054;3;0;0;0;0;.00nan;0;0
1074;4506;33;0;0;0;0;.00nan;0;0
1074;34740;33;61;40;5;35;.875;3600000;0
1075;61;31;0;0;0;0;.00nan;0;0
1075;15505;8;46;13;2;11;.846;1897000;0
1075;25076;8;29;26;6;20;.769;1703000;0
1075;34797;31;40;22;4;18;.818;3600000;0
1076;928;20;0;0;0;0;.00nan;0;0
1076;13842;34;92;52;2;50;.962;3877000;0
1076;15502;34;0;0;0;0;.00nan;0;0
1076;18078;20;63;17;1;16;.941;3885000;0
1077;717;0;0;0;0;0;.00nan;0;0
1077;1074;0;93;31;2;29;.935;3583000;0
1077;10103;24;0;0;0;0;.00nan;0;0
1077;13979;24;100;39;1;38;.974;3600000;0
1078;262;35;100;44;0;44;1.000;3600000;0
1078;1430;35;0;0;0;0;.00nan;0;0
1078;2423;15;0;0;0;0;.00nan;0;0
1078;4106;15;57;31;5;26;.839;3600000;0
1079;738;27;0;0;0;0;.00nan;0;0
1079;1614;25;0;0;0;0;.00nan;0;0
1079;5182;25;72;36;3;33;.917;3540000;0
1079;26623;27;96;45;2;43;.956;3600000;0
1080;544;19;0;0;0;0;.00nan;0;0
1080;724;11;46;41;7;34;.829;3600000;0
1080;21522;11;0;0;0;0;.00nan;0;0
1080;31124;19;89;33;2;31;.939;3600000;0
1081;445;12;81;19;1;18;.947;3600000;0
1081;1913;30;0;0;0;0;.00nan;0;0
1081;4826;30;50;38;6;32;.842;3600000;0
1081;34786;12;0;0;0;0;.00nan;0;0
1082;5385;17;0;0;0;0;.00nan;0;0
1082;15464;32;92;30;1;29;.967;3600000;0
1082;16006;32;0;0;0;0;.00nan;0;0
1082;34006;17;50;37;5;32;.865;3600000;0
1083;323;9;86;43;2;41;.953;3545000;0
1083;2058;28;0;0;0;0;.00nan;0;0
1083;20853;9;0;0;0;0;.00nan;0;0
1083;26824;28;95;32;1;31;.969;3600000;0
1084;7139;29;0;0;0;0;.00nan;0;0
1084;15505;8;0;0;0;0;.00nan;0;0
1084;18351;29;100;29;0;29;1.000;3600000;0
1084;25076;8;52;27;4;23;.852;3600000;0
1085;928;20;91;34;2;32;.941;3600000;0
1085;18078;20;0;0;0;0;.00nan;0;0
1085;18104;10;79;35;3;32;.914;3550000;0
1085;27488;10;0;0;0;0;.00nan;0;0
1086;823;23;0;0;0;0;.00nan;0;0
1086;1796;16;87;33;2;31;.939;3600000;0
1086;10274;23;51;36;5;31;.861;3600000;0
1086;15437;16;0;0;0;0;.00nan;0;0
1087;1913;30;88;34;3;31;.912;3600000;0
1087;4826;30;0;0;0;0;.00nan;0;0
1087;22601;26;0;0;0;0;.00nan;0;0
1087;32754;26;43;31;5;26;.839;3520000;0
1088;500;4182;88;27;1;26;.963;3600000;0
1088;1572;4838;0;0;0;0;.00nan;0;0
1088;2328;4838;82;46;4;42;.913;3600000;0
1088;25521;4182;0;0;0;0;.00nan;0;0
1089;4450;5;0;0;0;0;.00nan;0;0
1089;13842;34;72;47;5;42;.894;3600000;0
1089;15502;34;0;0;0;0;.00nan;0;0
1089;19823;5;89;25;1;24;.960;3600000;0
1090;717;0;0;0;0;0;.00nan;0;0
1090;1074;0;68;55;6;49;.891;3600000;0
1090;7139;29;0;0;0;0;.00nan;0;0
1090;18351;29;67;26;3;23;.885;3600000;0
1091;51;21;56;30;4;26;.867;3600000;0
1091;61;31;0;0;0;0;.00nan;0;0
1091;25843;21;0;0;0;0;.00nan;0;0
1091;34797;31;53;33;5;28;.848;3600000;0
1092;1251;14;70;35;4;31;.886;3600000;0
1092;1821;3;85;30;1;29;.967;3600000;0
1092;2054;3;0;0;0;0;.00nan;0;0
1092;25584;14;0;0;0;0;.00nan;0;0
1093;262;35;63;41;5;36;.878;3551000;0
1093;1430;35;0;0;0;0;.00nan;0;0
1093;10103;24;64;37;4;33;.892;3600000;0
1093;13979;24;0;0;0;0;.00nan;0;0
1094;15464;32;99;40;1;39;.975;3600000;0
1094;16006;32;0;0;0;0;.00nan;0;0
1094;27739;22;0;0;0;0;.00nan;0;0
1094;28026;22;58;33;3;30;.909;3600000;0
1095;724;11;0;0;0;0;.00nan;0;0
1095;4506;33;76;49;4;45;.918;3600000;0
1095;21522;11;65;17;1;16;.941;3600000;0
1095;34740;33;0;0;0;0;.00nan;0;0
1096;1614;25;0;0;0;0;.00nan;0;0
1096;2423;15;70;30;3;27;.900;3600000;0
1096;4106;15;0;0;0;0;.00nan;0;0
1096;5182;25;67;25;2;23;.920;3600000;0
1097;544;19;0;0;0;0;.00nan;0;0
1097;1796;16;0;0;0;0;.00nan;0;0
1097;15437;16;88;38;2;36;.947;3600000;0
1097;31124;19;87;27;1;26;.963;3600000;0
1098;445;12;0;0;0;0;.00nan;0;0
1098;738;27;0;0;0;0;.00nan;0;0
1098;26623;27;76;28;2;26;.929;3591000;0
1098;34786;12;89;29;1;28;.966;3600000;0
1099;61;31;58;36;5;31;.861;3554000;0
1099;5385;17;63;37;4;33;.892;3600000;0
1099;34006;17;0;0;0;0;.00nan;0;0
1099;34797;31;0;0;0;0;.00nan;0;0
1100;323;9;93;43;3;40;.930;3560000;0
1100;2058;28;0;0;0;0;.00nan;0;0
1100;20853;9;0;0;0;0;.00nan;0;0
1100;26824;28;60;23;2;21;.913;3600000;0
1101;51;21;0;0;0;0;.00nan;0;0
1101;928;20;0;0;0;0;.00nan;0;0
1101;18078;20;100;36;1;35;.972;3600000;0
1101;25843;21;72;33;3;30;.909;3550000;0
1102;1251;14;0;0;0;0;.00nan;0;0
1102;18104;10;76;38;3;35;.921;3900000;0
1102;25584;14;91;31;3;28;.903;3900000;0
1102;27488;10;0;0;0;0;.00nan;0;0
1103;262;35;52;26;4;22;.846;3600000;0
1103;1430;35;0;0;0;0;.00nan;0;0
1103;27739;22;29;26;5;21;.808;2342000;0
1103;28026;22;62;8;0;8;1.000;1258000;0
1104;15505;8;53;31;5;26;.839;3547000;0
1104;22601;26;0;0;0;0;.00nan;0;0
1104;25076;8;0;0;0;0;.00nan;0;0
1104;32754;26;53;32;4;28;.875;3600000;0
1105;335;18;0;0;0;0;.00nan;0;0
1105;500;4182;82;34;2;32;.941;3600000;0
1105;5001;18;99;33;1;32;.970;3600000;0
1105;25521;4182;0;0;0;0;.00nan;0;0
1106;823;23;0;0;0;0;.00nan;0;0
1106;1913;30;0;0;0;0;.00nan;0;0
1106;4826;30;59;38;5;33;.868;3596000;0
1106;10274;23;51;24;4;20;.833;3600000;0
1107;445;12;60;25;3;22;.880;3571000;0
1107;1572;4838;76;29;2;27;.931;3600000;0
1107;2328;4838;0;0;0;0;.00nan;0;0
1107;34786;12;0;0;0;0;.00nan;0;0
1108;1821;3;73;26;2;24;.923;3600000;0
1108;2054;3;0;0;0;0;.00nan;0;0
1108;7139;29;59;29;3;26;.897;3562000;0
1108;18351;29;0;0;0;0;.00nan;0;0
1109;4450;5;0;0;0;0;.00nan;0;0
1109;13842;34;90;38;1;37;.974;3562000;0
1109;15502;34;0;0;0;0;.00nan;0;0
1109;19823;5;92;18;0;18;1.000;3600000;0
1110;1796;16;64;25;3;22;.880;3600000;0
1110;15437;16;0;0;0;0;.00nan;0;0
1110;22601;26;22;34;7;27;.794;3600000;0
1110;32754;26;0;0;0;0;.00nan;0;0
1111;544;19;0;0;0;0;.00nan;0;0
1111;724;11;0;0;0;0;.00nan;0;0
1111;21522;11;59;32;4;28;.875;3600000;0
1111;31124;19;95;26;0;26;1.000;3600000;0
1112;5385;17;0;0;0;0;.00nan;0;0
1112;10103;24;53;34;5;29;.853;3543000;0
1112;13979;24;0;0;0;0;.00nan;0;0
1112;34006;17;73;42;4;38;.905;3600000;0
1113;717;0;0;0;0;0;.00nan;0;0
1113;1074;0;100;31;0;31;1.000;3600000;0
1113;2058;28;54;31;4;27;.871;3600000;0
1113;26824;28;0;0;0;0;.00nan;0;0
1114;323;9;0;0;0;0;.00nan;0;0
1114;4450;5;0;0;0;0;.00nan;0;0
1114;19823;5;29;18;4;14;.778;3600000;0
1114;20853;9;100;47;1;46;.979;3600000;0
1115;61;31;0;0;0;0;.00nan;0;0
1115;1821;3;0;0;0;0;.00nan;0;0
1115;2054;3;72;32;3;29;.906;3600000;0
1115;34797;31;100;30;0;30;1.000;3600000;0
1116;51;21;49;33;5;28;.848;3900000;0
1116;18104;10;28;13;4;9;.692;1000000;0
1116;25843;21;0;0;0;0;.00nan;0;0
1116;27488;10;72;20;1;19;.950;2900000;0
1117;1251;14;0;0;0;0;.00nan;0;0
1117;13842;34;0;0;0;0;.00nan;0;0
1117;15502;34;74;33;3;30;.909;3569000;0
1117;25584;14;74;31;2;29;.935;3600000;0
1118;1614;25;0;0;0;0;.00nan;0;0
1118;2423;15;40;35;6;29;.829;3600000;0
1118;4106;15;0;0;0;0;.00nan;0;0
1118;5182;25;80;28;2;26;.929;3600000;0
1119;262;35;56;32;4;28;.875;3600000;0
1119;1430;35;0;0;0;0;.00nan;0;0
1119;15464;32;44;35;6;29;.829;3589000;0
1119;16006;32;0;0;0;0;.00nan;0;0
1120;445;12;0;0;0;0;.00nan;0;0
1120;928;20;0;0;0;0;.00nan;0;0
1120;18078;20;82;40;3;37;.925;3600000;0
1120;34786;12;47;32;5;27;.844;3600000;0
1121;738;27;35;16;4;12;.750;3600000;0
1121;823;23;0;0;0;0;.00nan;0;0
1121;10274;23;61;41;6;35;.854;3566000;0
1121;26623;27;0;0;0;0;.00nan;0;0
1122;7139;29;0;0;0;0;.00nan;0;0
1122;18351;29;73;32;3;29;.906;3600000;0
1122;27739;22;0;0;0;0;.00nan;0;0
1122;28026;22;84;30;2;28;.933;3600000;0
1123;1572;4838;0;0;0;0;.00nan;0;0
1123;1796;16;81;35;3;32;.914;3891000;0
1123;2328;4838;73;38;4;34;.895;3891000;0
1123;15437;16;0;0;0;0;.00nan;0;0
1124;323;9;59;32;4;28;.875;3600000;0
1124;4506;33;73;23;1;22;.957;3600000;0
1124;20853;9;0;0;0;0;.00nan;0;0
1124;34740;33;0;0;0;0;.00nan;0;0
1125;544;19;0;0;0;0;.00nan;0;0
1125;1913;30;0;0;0;0;.00nan;0;0
1125;4826;30;91;49;3;46;.939;3900000;0
1125;31124;19;58;23;3;20;.870;3900000;0
1126;335;18;0;0;0;0;.00nan;0;0
1126;500;4182;78;35;2;33;.943;3600000;0
1126;5001;18;41;34;6;28;.824;3600000;0
1126;25521;4182;0;0;0;0;.00nan;0;0
1127;51;21;73;27;2;25;.926;3600000;0
1127;2058;28;0;0;0;0;.00nan;0;0
1127;25843;21;0;0;0;0;.00nan;0;0
1127;26824;28;100;27;0;27;1.000;3600000;0
1128;2423;15;76;32;3;29;.906;3584000;0
1128;4106;15;0;0;0;0;.00nan;0;0
1128;18104;10;84;37;2;35;.946;3600000;0
1128;27488;10;0;0;0;0;.00nan;0;0
1129;5385;17;0;0;0;0;.00nan;0;0
1129;10103;24;0;0;0;0;.00nan;0;0
1129;13979;24;88;35;3;32;.914;3600000;0
1129;34006;17;72;38;4;34;.895;3600000;0
1130;1251;14;52;1;0;1;1.000;263000;0
1130;13842;34;63;49;6;43;.878;3213000;0
1130;15502;34;49;1;0;1;1.000;366000;0
1130;25584;14;37;25;4;21;.840;3337000;0
1131;1572;4838;80;38;3;35;.921;3600000;0
1131;2328;4838;0;0;0;0;.00nan;0;0
1131;15505;8;0;0;0;0;.00nan;0;0
1131;25076;8;100;25;0;25;1.000;3600000;0
1132;445;12;0;0;0;0;.00nan;0;0
1132;1821;3;49;35;5;30;.857;3600000;0
1132;2054;3;0;0;0;0;.00nan;0;0
1132;34786;12;69;21;1;20;.952;3600000;0
1133;335;18;0;0;0;0;.00nan;0;0
1133;5001;18;47;26;4;22;.846;3600000;0
1133;22601;26;0;0;0;0;.00nan;0;0
1133;32754;26;100;33;1;32;.970;3600000;0
1134;724;11;0;0;0;0;.00nan;0;0
1134;823;23;0;0;0;0;.00nan;0;0
1134;10274;23;33;33;6;27;.818;3585000;0
1134;21522;11;60;38;5;33;.868;3600000;0
1135;544;19;0;0;0;0;.00nan;0;0
1135;738;27;0;0;0;0;.00nan;0;0
1135;26623;27;93;21;0;21;1.000;3600000;0
1135;31124;19;76;43;4;39;.907;3600000;0
1136;4450;5;0;0;0;0;.00nan;0;0
1136;7139;29;0;0;0;0;.00nan;0;0
1136;18351;29;94;37;2;35;.946;3579000;0
1136;19823;5;86;31;1;30;.968;3600000;0
1137;61;31;0;0;0;0;.00nan;0;0
1137;5385;17;46;36;5;31;.861;3600000;0
1137;34006;17;0;0;0;0;.00nan;0;0
1137;34797;31;72;24;2;22;.917;3600000;0
1138;928;20;0;0;0;0;.00nan;0;0
1138;10103;24;77;56;6;50;.893;3600000;0
1138;13979;24;0;0;0;0;.00nan;0;0
1138;18078;20;53;17;2;15;.882;3600000;0
1139;262;35;23;26;7;19;.731;3545000;0
1139;1430;35;0;0;0;0;.00nan;0;0
1139;1796;16;22;16;5;11;.688;2033000;0
1139;15437;16;66;18;1;17;.944;1567000;0
1140;1614;25;0;0;0;0;.00nan;0;0
1140;4506;33;66;36;4;32;.889;3525000;0
1140;5182;25;78;31;2;29;.935;3600000;0
1140;34740;33;0;0;0;0;.00nan;0;0
1141;717;0;0;0;0;0;.00nan;0;0
1141;1074;0;90;46;4;42;.913;3554000;0
1141;1821;3;52;19;3;16;.842;3600000;0
1141;2054;3;0;0;0;0;.00nan;0;0
1142;323;9;0;0;0;0;.00nan;0;0
1142;13842;34;70;27;2;25;.926;3600000;0
1142;15502;34;0;0;0;0;.00nan;0;0
1142;20853;9;56;37;5;32;.865;3600000;0
1143;2058;28;0;0;0;0;.00nan;0;0
1143;18104;10;71;25;1;24;.960;3600000;0
1143;26824;28;75;31;2;29;.935;3600000;0
1143;27488;10;0;0;0;0;.00nan;0;0
1144;1251;14;0;0;0;0;.00nan;0;0
1144;1913;30;0;0;0;0;.00nan;0;0
1144;4826;30;100;38;1;37;.974;3600000;0
1144;25584;14;65;27;2;25;.926;3600000;0
1145;2423;15;0;0;0;0;.00nan;0;0
1145;4106;15;66;28;3;25;.893;3600000;0
1145;27739;22;0;0;0;0;.00nan;0;0
1145;28026;22;83;55;5;50;.909;3563000;0
1146;928;20;0;0;0;0;.00nan;0;0
1146;1796;16;75;28;3;25;.893;3600000;0
1146;15437;16;0;0;0;0;.00nan;0;0
1146;18078;20;49;28;4;24;.857;3600000;0
1147;61;31;27;7;3;4;.571;347000;0
1147;15464;32;84;25;1;24;.960;3600000;0
1147;16006;32;0;0;0;0;.00nan;0;0
1147;34797;31;68;25;2;23;.920;3253000;0
1148;51;21;63;36;4;32;.889;3600000;0
1148;445;12;90;29;1;28;.966;3600000;0
1148;25843;21;0;0;0;0;.00nan;0;0
1148;34786;12;0;0;0;0;.00nan;0;0
1149;262;35;73;15;0;15;1.000;890000;0
1149;724;11;55;26;4;22;.846;3600000;0
1149;1430;35;60;50;6;44;.880;2660000;0
1149;21522;11;0;0;0;0;.00nan;0;0
1150;823;23;8;11;5;6;.545;772000;0
1150;1614;25;73;36;3;33;.917;3600000;0
1150;5182;25;0;0;0;0;.00nan;0;0
1150;10274;23;55;41;6;35;.854;2828000;0
1151;335;18;0;0;0;0;.00nan;0;0
1151;738;27;0;0;0;0;.00nan;0;0
1151;5001;18;73;34;3;31;.912;3600000;0
1151;26623;27;78;31;2;29;.935;3600000;0
1152;500;4182;61;14;1;13;.929;3600000;0
1152;22601;26;74;41;4;37;.902;3600000;0
1152;25521;4182;0;0;0;0;.00nan;0;0
1152;32754;26;0;0;0;0;.00nan;0;0
1153;544;19;0;0;0;0;.00nan;0;0
1153;1572;4838;0;0;0;0;.00nan;0;0
1153;2328;4838;73;46;4;42;.913;3550000;0
1153;31124;19;69;24;2;22;.917;3600000;0
1154;2058;28;70;23;2;21;.913;3600000;0
1154;4506;33;50;37;6;31;.838;3600000;0
1154;26824;28;0;0;0;0;.00nan;0;0
1154;34740;33;0;0;0;0;.00nan;0;0
1155;5385;17;92;40;2;38;.950;3600000;0
1155;7139;29;0;0;0;0;.00nan;0;0
1155;18351;29;98;47;3;44;.936;3566000;0
1155;34006;17;0;0;0;0;.00nan;0;0
1156;2423;15;56;30;4;26;.867;3597000;0
1156;4106;15;0;0;0;0;.00nan;0;0
1156;15464;32;88;36;3;33;.917;3600000;0
1156;16006;32;0;0;0;0;.00nan;0;0
1157;4450;5;0;0;0;0;.00nan;0;0
1157;19823;5;59;27;3;24;.889;3600000;0
1157;27739;22;100;44;0;44;1.000;3600000;0
1157;28026;22;0;0;0;0;.00nan;0;0
1158;1913;30;73;53;4;49;.925;3900000;0
1158;4826;30;0;0;0;0;.00nan;0;0
1158;10103;24;0;0;0;0;.00nan;0;0
1158;13979;24;65;32;4;28;.875;3900000;0
1159;445;12;0;0;0;0;.00nan;0;0
1159;15505;8;0;0;0;0;.00nan;0;0
1159;25076;8;71;24;2;22;.917;3600000;0
1159;34786;12;57;45;5;40;.889;3600000;0
1160;500;4182;69;30;2;28;.933;3600000;0
1160;738;27;74;37;3;34;.919;3568000;0
1160;25521;4182;0;0;0;0;.00nan;0;0
1160;26623;27;0;0;0;0;.00nan;0;0
1161;717;0;0;0;0;0;.00nan;0;0
1161;1074;0;98;49;2;47;.959;3600000;0
1161;4506;33;99;37;1;36;.973;3600000;0
1161;34740;33;0;0;0;0;.00nan;0;0
1162;262;35;97;32;1;31;.969;3571000;0
1162;823;23;0;0;0;0;.00nan;0;0
1162;1430;35;0;0;0;0;.00nan;0;0
1162;10274;23;100;28;0;28;1.000;3600000;0
1163;1796;16;89;45;2;43;.956;3820000;0
1163;4450;5;0;0;0;0;.00nan;0;0
1163;15437;16;0;0;0;0;.00nan;0;0
1163;19823;5;80;21;1;20;.952;3820000;0
1164;1821;3;46;31;5;26;.839;3900000;0
1164;2054;3;0;0;0;0;.00nan;0;0
1164;5385;17;63;43;5;38;.884;3900000;0
1164;34006;17;0;0;0;0;.00nan;0;0
1165;323;9;61;39;5;34;.872;3541000;0
1165;2058;28;0;0;0;0;.00nan;0;0
1165;20853;9;0;0;0;0;.00nan;0;0
1165;26824;28;62;25;3;22;.880;3600000;0
1166;61;31;0;0;0;0;.00nan;0;0
1166;1913;30;93;52;4;48;.923;3567000;0
1166;4826;30;0;0;0;0;.00nan;0;0
1166;34797;31;67;24;2;22;.917;3600000;0
1167;10103;24;0;0;0;0;.00nan;0;0
1167;13979;24;71;47;6;41;.872;3600000;0
1167;18104;10;69;26;2;24;.923;3600000;0
1167;27488;10;0;0;0;0;.00nan;0;0
1168;2423;15;77;28;2;26;.929;3600000;0
1168;4106;15;0;0;0;0;.00nan;0;0
1168;13842;34;75;47;4;43;.915;3558000;0
1168;15502;34;0;0;0;0;.00nan;0;0
1169;1251;14;0;0;0;0;.00nan;0;0
1169;25584;14;55;38;5;33;.868;3900000;0
1169;27739;22;61;41;5;36;.878;3900000;0
1169;28026;22;0;0;0;0;.00nan;0;0
1170;738;27;0;0;0;0;.00nan;0;0
1170;15505;8;0;0;0;0;.00nan;0;0
1170;25076;8;97;45;2;43;.956;3600000;0
1170;26623;27;75;30;3;27;.900;3550000;0
1171;823;23;0;0;0;0;.00nan;0;0
1171;10274;23;67;42;5;37;.881;3543000;0
1171;15464;32;58;34;4;30;.882;3600000;0
1171;16006;32;0;0;0;0;.00nan;0;0
1172;445;12;82;37;3;34;.919;3900000;0
1172;7139;29;0;0;0;0;.00nan;0;0
1172;18351;29;70;32;3;29;.906;3900000;0
1172;34786;12;0;0;0;0;.00nan;0;0
1173;544;19;0;0;0;0;.00nan;0;0
1173;1572;4838;0;0;0;0;.00nan;0;0
1173;2328;4838;74;35;3;32;.914;3600000;0
1173;31124;19;61;28;4;24;.857;3577000;0
1174;335;18;67;35;3;32;.914;3600000;0
1174;500;4182;56;30;4;26;.867;3593000;0
1174;5001;18;0;0;0;0;.00nan;0;0
1174;25521;4182;0;0;0;0;.00nan;0;0
1175;51;21;25;21;5;16;.762;3516000;0
1175;22601;26;0;0;0;0;.00nan;0;0
1175;25843;21;0;0;0;0;.00nan;0;0
1175;32754;26;63;30;3;27;.900;3600000;0
1176;1251;14;76;38;3;35;.921;3562000;0
1176;18104;10;0;0;0;0;.00nan;0;0
1176;25584;14;0;0;0;0;.00nan;0;0
1176;27488;10;78;32;2;30;.938;3600000;0
1177;717;0;0;0;0;0;.00nan;0;0
1177;1074;0;100;40;2;38;.950;3900000;0
1177;13842;34;0;0;0;0;.00nan;0;0
1177;15502;34;89;34;2;32;.941;3900000;0
1178;1572;4838;86;46;4;42;.913;3600000;0
1178;2328;4838;0;0;0;0;.00nan;0;0
1178;4506;33;90;21;0;21;1.000;3600000;0
1178;34740;33;0;0;0;0;.00nan;0;0
1179;724;11;68;33;4;29;.879;3579000;0
1179;1614;25;0;0;0;0;.00nan;0;0
1179;5182;25;80;31;2;29;.935;3600000;0
1179;21522;11;0;0;0;0;.00nan;0;0
1180;2058;28;75;48;4;44;.917;3600000;0
1180;4450;5;0;0;0;0;.00nan;0;0
1180;19823;5;76;22;1;21;.955;3600000;0
1180;26824;28;0;0;0;0;.00nan;0;0
1181;1796;16;83;35;2;33;.943;3600000;0
1181;5385;17;71;38;3;35;.921;3546000;0
1181;15437;16;0;0;0;0;.00nan;0;0
1181;34006;17;0;0;0;0;.00nan;0;0
1182;1821;3;86;38;3;35;.921;3816000;0
1182;2054;3;0;0;0;0;.00nan;0;0
1182;27739;22;0;0;0;0;.00nan;0;0
1182;28026;22;86;36;2;34;.944;3816000;0
1183;1913;30;62;26;3;23;.885;2594000;0
1183;4826;30;47;21;4;17;.810;1006000;0
1183;7139;29;47;34;6;28;.824;3600000;0
1183;18351;29;0;0;0;0;.00nan;0;0
1184;928;20;0;0;0;0;.00nan;0;0
1184;2423;15;100;36;2;34;.944;3900000;0
1184;4106;15;0;0;0;0;.00nan;0;0
1184;18078;20;84;32;2;30;.938;3900000;0
1185;323;9;0;0;0;0;.00nan;0;0
1185;10103;24;100;30;0;30;1.000;3600000;0
1185;13979;24;0;0;0;0;.00nan;0;0
1185;20853;9;69;34;3;31;.912;3600000;0
1186;724;11;0;0;0;0;.00nan;0;0
1186;15505;8;67;22;2;20;.909;3600000;0
1186;21522;11;57;32;4;28;.875;3559000;0
1186;25076;8;0;0;0;0;.00nan;0;0
1187;738;27;55;12;1;11;.917;1359000;0
1187;15464;32;90;29;1;28;.966;3600000;0
1187;16006;32;0;0;0;0;.00nan;0;0
1187;26623;27;17;21;6;15;.714;2241000;0
1188;262;35;64;33;4;29;.879;3600000;0
1188;445;12;94;30;1;29;.967;3600000;0
1188;1430;35;0;0;0;0;.00nan;0;0
1188;34786;12;0;0;0;0;.00nan;0;0
1189;51;21;62;41;6;35;.854;2620000;0
1189;1614;25;98;23;0;23;1.000;3600000;0
1189;5182;25;0;0;0;0;.00nan;0;0
1189;25843;21;57;8;0;8;1.000;980000;0
1190;500;4182;74;24;2;22;.917;3600000;0
1190;544;19;0;0;0;0;.00nan;0;0
1190;25521;4182;0;0;0;0;.00nan;0;0
1190;31124;19;50;28;4;24;.857;3571000;0
1191;335;18;0;0;0;0;.00nan;0;0
1191;5001;18;91;30;1;29;.967;3600000;0
1191;22601;26;84;42;3;39;.929;3548000;0
1191;32754;26;0;0;0;0;.00nan;0;0
1192;717;0;86;26;1;25;.962;3081000;0
1192;928;20;0;0;0;0;.00nan;0;0
1192;1074;0;25;13;4;9;.692;519000;0
1192;18078;20;80;31;2;29;.935;3600000;0
1193;61;31;0;0;0;0;.00nan;0;0
1193;4506;33;100;25;0;25;1.000;3600000;0
1193;34740;33;0;0;0;0;.00nan;0;0
1193;34797;31;78;35;3;32;.914;3600000;0
1194;500;4182;0;0;0;0;.00nan;0;0
1194;823;23;0;0;0;0;.00nan;0;0
1194;10274;23;77;32;3;29;.906;3600000;0
1194;25521;4182;70;40;5;35;.875;3558000;0
1195;2423;15;84;35;2;33;.943;3600000;0
1195;4106;15;0;0;0;0;.00nan;0;0
1195;4450;5;0;0;0;0;.00nan;0;0
1195;19823;5;63;33;4;29;.879;3533000;0
1196;1251;14;0;0;0;0;.00nan;0;0
1196;5385;17;58;39;5;34;.872;3557000;0
1196;25584;14;65;38;4;34;.895;3600000;0
1196;34006;17;0;0;0;0;.00nan;0;0
1197;717;0;0;0;0;0;.00nan;0;0
1197;1074;0;100;43;1;42;.977;3600000;0
1197;27739;22;45;29;4;25;.862;3600000;0
1197;28026;22;0;0;0;0;.00nan;0;0
1198;1821;3;62;40;5;35;.875;3573000;0
1198;2054;3;0;0;0;0;.00nan;0;0
1198;2058;28;0;0;0;0;.00nan;0;0
1198;26824;28;91;38;3;35;.921;3600000;0
1199;4506;33;48;29;5;24;.828;3552000;0
1199;7139;29;0;0;0;0;.00nan;0;0
1199;18351;29;73;30;3;27;.900;3600000;0
1199;34740;33;0;0;0;0;.00nan;0;0
1200;323;9;62;21;2;19;.905;1365000;0
1200;18104;10;70;25;2;23;.920;3600000;0
1200;20853;9;38;28;6;22;.786;2235000;0
1200;27488;10;0;0;0;0;.00nan;0;0
1201;262;35;68;37;3;34;.919;3515000;0
1201;1430;35;0;0;0;0;.00nan;0;0
1201;1796;16;99;43;1;42;.977;3600000;0
1201;15437;16;0;0;0;0;.00nan;0;0
1202;15464;32;78;26;1;25;.962;3600000;0
1202;15505;8;58;19;3;16;.842;3544000;0
1202;16006;32;0;0;0;0;.00nan;0;0
1202;25076;8;0;0;0;0;.00nan;0;0
1203;445;12;69;32;3;29;.906;3600000;0
1203;738;27;58;3;0;3;1.000;468000;0
1203;26623;27;41;32;6;26;.813;3132000;0
1203;34786;12;0;0;0;0;.00nan;0;0
1204;1614;25;65;35;4;31;.886;3600000;0
1204;5182;25;0;0;0;0;.00nan;0;0
1204;10103;24;83;25;1;24;.960;3600000;0
1204;13979;24;0;0;0;0;.00nan;0;0
1205;544;19;0;0;0;0;.00nan;0;0
1205;22601;26;0;0;0;0;.00nan;0;0
1205;31124;19;55;28;4;24;.857;3600000;0
1205;32754;26;50;43;6;37;.860;3558000;0
1206;335;18;0;0;0;0;.00nan;0;0
1206;823;23;77;33;2;31;.939;3600000;0
1206;5001;18;54;32;4;28;.875;3549000;0
1206;10274;23;0;0;0;0;.00nan;0;0
1207;724;11;92;32;1;31;.969;3600000;0
1207;13842;34;58;25;3;22;.880;3524000;0
1207;15502;34;0;0;0;0;.00nan;0;0
1207;21522;11;0;0;0;0;.00nan;0;0
1208;51;21;84;24;1;23;.958;3600000;0
1208;1572;4838;0;0;0;0;.00nan;0;0
1208;2328;4838;75;34;3;31;.912;3600000;0
1208;25843;21;0;0;0;0;.00nan;0;0
1209;61;31;0;0;0;0;.00nan;0;0
1209;323;9;0;0;0;0;.00nan;0;0
1209;20853;9;57;27;3;24;.889;3600000;0
1209;34797;31;99;23;0;23;1.000;3600000;0
1210;928;20;0;0;0;0;.00nan;0;0
1210;1821;3;0;0;0;0;.00nan;0;0
1210;2054;3;63;39;5;34;.872;3600000;0
1210;18078;20;79;22;1;21;.955;3600000;0
1211;1251;14;92;29;1;28;.966;3600000;0
1211;5385;17;0;0;0;0;.00nan;0;0
1211;25584;14;0;0;0;0;.00nan;0;0
1211;34006;17;67;26;2;24;.923;3583000;0
1212;1796;16;0;0;0;0;.00nan;0;0
1212;15437;16;52;25;3;22;.880;3600000;0
1212;15464;32;0;0;0;0;.00nan;0;0
1212;16006;32;59;32;4;28;.875;3586000;0
1213;262;35;0;0;0;0;.00nan;0;0
1213;738;27;0;0;0;0;.00nan;0;0
1213;1430;35;57;28;3;25;.893;3597000;0
1213;26623;27;95;43;2;41;.953;3600000;0
1214;1913;30;0;0;0;0;.00nan;0;0
1214;4826;30;100;32;0;32;1.000;3600000;0
1214;13842;34;0;0;0;0;.00nan;0;0
1214;15502;34;56;25;3;22;.880;3600000;0
1215;1614;25;100;26;0;26;1.000;3600000;0
1215;5182;25;0;0;0;0;.00nan;0;0
1215;27739;22;89;44;3;41;.932;3239000;0
1215;28026;22;30;9;3;6;.667;361000;0
1216;335;18;0;0;0;0;.00nan;0;0
1216;445;12;0;0;0;0;.00nan;0;0
1216;5001;18;100;43;0;43;1.000;3600000;0
1216;34786;12;61;32;4;28;.875;3600000;0
1217;10103;24;0;0;0;0;.00nan;0;0
1217;13979;24;71;48;5;43;.896;3600000;0
1217;22601;26;0;0;0;0;.00nan;0;0
1217;32754;26;97;23;0;23;1.000;3600000;0
1218;51;21;99;60;2;58;.967;3600000;0
1218;500;4182;48;19;3;16;.842;3545000;0
1218;25521;4182;0;0;0;0;.00nan;0;0
1218;25843;21;0;0;0;0;.00nan;0;0
1219;1251;14;0;0;0;0;.00nan;0;0
1219;1821;3;82;35;3;32;.914;3648000;0
1219;2054;3;0;0;0;0;.00nan;0;0
1219;25584;14;78;44;4;40;.909;3663000;0
1220;262;35;31;12;4;8;.667;1003000;0
1220;717;0;0;0;0;0;.00nan;0;0
1220;1074;0;100;43;2;41;.953;3600000;0
1220;1430;35;72;20;1;19;.950;2597000;0
1221;323;9;89;43;3;40;.930;3598000;0
1221;7139;29;0;0;0;0;.00nan;0;0
1221;18351;29;70;23;2;21;.913;3600000;0
1221;20853;9;0;0;0;0;.00nan;0;0
1222;61;31;0;0;0;0;.00nan;0;0
1222;928;20;0;0;0;0;.00nan;0;0
1222;18078;20;81;26;2;24;.923;3667000;0
1222;34797;31;86;26;1;25;.962;3667000;0
1223;4506;33;43;32;5;27;.844;3600000;0
1223;18104;10;100;40;1;39;.975;3600000;0
1223;27488;10;0;0;0;0;.00nan;0;0
1223;34740;33;0;0;0;0;.00nan;0;0
1224;1796;16;79;36;4;32;.889;3537000;0
1224;4450;5;0;0;0;0;.00nan;0;0
1224;15437;16;0;0;0;0;.00nan;0;0
1224;19823;5;97;40;2;38;.950;3600000;0
1225;724;11;0;0;0;0;.00nan;0;0
1225;1913;30;0;0;0;0;.00nan;0;0
1225;4826;30;63;34;5;29;.853;3693000;0
1225;21522;11;50;29;4;25;.862;3693000;0
1226;738;27;0;0;0;0;.00nan;0;0
1226;13842;34;36;31;6;25;.806;3600000;0
1226;15502;34;0;0;0;0;.00nan;0;0
1226;26623;27;79;34;3;31;.912;3600000;0
1227;2058;28;96;35;1;34;.971;3600000;0
1227;5385;17;87;37;2;35;.946;3589000;0
1227;26824;28;0;0;0;0;.00nan;0;0
1227;34006;17;0;0;0;0;.00nan;0;0
1228;445;12;0;0;0;0;.00nan;0;0
1228;823;23;0;0;0;0;.00nan;0;0
1228;10274;23;98;32;1;31;.969;3600000;0
1228;34786;12;63;44;5;39;.886;3600000;0
1229;15505;8;43;28;4;24;.857;3552000;0
1229;22601;26;0;0;0;0;.00nan;0;0
1229;25076;8;0;0;0;0;.00nan;0;0
1229;32754;26;67;30;3;27;.900;3600000;0
1230;500;4182;55;24;3;21;.875;3900000;0
1230;25521;4182;0;0;0;0;.00nan;0;0
1230;27739;22;0;0;0;0;.00nan;0;0
1230;28026;22;76;39;3;36;.923;3900000;0
1231;1572;4838;0;0;0;0;.00nan;0;0
1231;1614;25;65;18;1;17;.944;3548000;0
1231;2328;4838;100;44;0;44;1.000;3600000;0
1231;5182;25;0;0;0;0;.00nan;0;0
1232;717;0;0;0;0;0;.00nan;0;0
1232;1074;0;91;41;2;39;.951;3600000;0
1232;1251;14;0;0;0;0;.00nan;0;0
1232;25584;14;55;23;3;20;.870;3578000;0
1233;1821;3;77;44;5;39;.886;3600000;0
1233;2054;3;0;0;0;0;.00nan;0;0
1233;7139;29;0;0;0;0;.00nan;0;0
1233;18351;29;89;28;1;27;.964;3600000;0
1234;61;31;0;0;0;0;.00nan;0;0
1234;323;9;33;19;4;15;.789;860000;0
1234;20853;9;64;38;4;34;.895;2740000;0
1234;34797;31;56;18;2;16;.889;3600000;0
1235;51;21;57;21;2;19;.905;3587000;0
1235;5385;17;0;0;0;0;.00nan;0;0
1235;25843;21;0;0;0;0;.00nan;0;0
1235;34006;17;99;49;1;48;.980;3600000;0
1236;928;20;0;0;0;0;.00nan;0;0
1236;18078;20;80;30;2;28;.933;3900000;0
1236;18104;10;87;35;2;33;.943;3900000;0
1236;27488;10;0;0;0;0;.00nan;0;0
1237;2423;15;94;37;2;35;.946;3600000;0
1237;4106;15;0;0;0;0;.00nan;0;0
1237;4450;5;0;0;0;0;.00nan;0;0
1237;19823;5;67;18;1;17;.944;3600000;0
1238;4506;33;70;28;3;25;.893;3600000;0
1238;10103;24;42;29;6;23;.793;2522000;0
1238;13979;24;42;3;1;2;.667;1078000;0
1238;34740;33;0;0;0;0;.00nan;0;0
1239;262;35;56;34;4;30;.882;3600000;0
1239;335;18;0;0;0;0;.00nan;0;0
1239;1430;35;0;0;0;0;.00nan;0;0
1239;5001;18;73;19;1;18;.947;3600000;0
1240;445;12;29;33;7;26;.788;3068000;0
1240;544;19;73;20;1;19;.950;3160000;0
1240;31124;19;30;8;3;5;.625;440000;0
1240;34786;12;41;2;1;1;.500;532000;0
1241;724;11;0;0;0;0;.00nan;0;0
1241;15505;8;0;0;0;0;.00nan;0;0
1241;21522;11;81;33;2;31;.939;3600000;0
1241;25076;8;43;27;5;22;.815;3600000;0
1242;738;27;70;21;1;20;.952;2714000;0
1242;1796;16;29;25;6;19;.760;3600000;0
1242;15437;16;0;0;0;0;.00nan;0;0
1242;26623;27;17;9;4;5;.556;886000;0
1243;2058;28;0;0;0;0;.00nan;0;0
1243;13842;34;84;30;1;29;.967;3600000;0
1243;15502;34;0;0;0;0;.00nan;0;0
1243;26824;28;57;24;3;21;.875;3582000;0
1244;262;35;92;28;1;27;.964;3600000;0
1244;1430;35;0;0;0;0;.00nan;0;0
1244;1572;4838;0;0;0;0;.00nan;0;0
1244;2328;4838;56;26;3;23;.885;3595000;0
1245;823;23;0;0;0;0;.00nan;0;0
1245;1614;25;62;19;2;17;.895;3600000;0
1245;5182;25;0;0;0;0;.00nan;0;0
1245;10274;23;66;43;5;38;.884;3600000;0
1246;22601;26;0;0;0;0;.00nan;0;0
1246;27739;22;66;25;2;23;.920;3600000;0
1246;28026;22;0;0;0;0;.00nan;0;0
1246;32754;26;77;49;4;45;.918;3600000;0
1247;4450;5;0;0;0;0;.00nan;0;0
1247;18104;10;84;31;2;29;.935;3549000;0
1247;19823;5;76;22;1;21;.955;3600000;0
1247;27488;10;0;0;0;0;.00nan;0;0
1248;928;20;0;0;0;0;.00nan;0;0
1248;5385;17;67;34;3;31;.912;3600000;0
1248;18078;20;52;27;4;23;.852;3600000;0
1248;34006;17;0;0;0;0;.00nan;0;0
1249;717;0;0;0;0;0;.00nan;0;0
1249;1074;0;69;23;2;21;.913;3600000;0
1249;2058;28;57;29;4;25;.862;3524000;0
1249;26824;28;0;0;0;0;.00nan;0;0
1250;323;9;46;32;5;27;.844;2660000;0
1250;2423;15;42;32;5;27;.844;3600000;0
1250;4106;15;0;0;0;0;.00nan;0;0
1250;20853;9;26;14;4;10;.714;940000;0
1251;7139;29;0;0;0;0;.00nan;0;0
1251;15464;32;56;29;4;25;.862;3600000;0
1251;16006;32;0;0;0;0;.00nan;0;0
1251;18351;29;85;28;1;27;.964;3600000;0
1252;61;31;0;0;0;0;.00nan;0;0
1252;1821;3;77;46;4;42;.913;3900000;0
1252;2054;3;0;0;0;0;.00nan;0;0
1252;34797;31;47;24;4;20;.833;3900000;0
1253;51;21;89;30;1;29;.967;3600000;0
1253;10103;24;0;0;0;0;.00nan;0;0
1253;13979;24;91;37;2;35;.946;3600000;0
1253;25843;21;0;0;0;0;.00nan;0;0
1254;445;12;91;35;1;34;.971;3900000;0
1254;1572;4838;97;50;1;49;.980;3900000;0
1254;2328;4838;0;0;0;0;.00nan;0;0
1254;34786;12;0;0;0;0;.00nan;0;0
1255;335;18;0;0;0;0;.00nan;0;0
1255;544;19;0;0;0;0;.00nan;0;0
1255;5001;18;59;34;4;30;.882;3600000;0
1255;31124;19;75;22;1;21;.955;3600000;0
1256;1796;16;99;19;0;19;1.000;3600000;0
1256;15437;16;0;0;0;0;.00nan;0;0
1256;22601;26;82;31;1;30;.968;3557000;0
1256;32754;26;0;0;0;0;.00nan;0;0
1257;724;11;58;37;4;33;.892;3858000;0
1257;1913;30;44;29;5;24;.828;3858000;0
1257;4826;30;0;0;0;0;.00nan;0;0
1257;21522;11;0;0;0;0;.00nan;0;0
1258;738;27;0;0;0;0;.00nan;0;0
1258;15505;8;0;0;0;0;.00nan;0;0
1258;25076;8;52;28;4;24;.857;3600000;0
1258;26623;27;89;32;1;31;.969;3600000;0
1259;61;31;34;35;6;29;.829;3246000;0
1259;7139;29;100;34;0;34;1.000;3600000;0
1259;18351;29;0;0;0;0;.00nan;0;0
1259;34797;31;52;2;0;2;1.000;354000;0
1260;51;21;0;0;0;0;.00nan;0;0
1260;323;9;0;0;0;0;.00nan;0;0
1260;20853;9;84;40;2;38;.950;3560000;0
1260;25843;21;80;23;1;22;.957;3600000;0
1261;928;20;66;26;3;23;.885;3600000;0
1261;10103;24;87;34;2;32;.941;3600000;0
1261;13979;24;0;0;0;0;.00nan;0;0
1261;18078;20;0;0;0;0;.00nan;0;0
1262;4450;5;65;31;3;28;.903;3600000;0
1262;18104;10;0;0;0;0;.00nan;0;0
1262;19823;5;0;0;0;0;.00nan;0;0
1262;27488;10;89;52;5;47;.904;3559000;0
1263;1251;14;40;9;2;7;.778;732000;0
1263;2423;15;0;0;0;0;.00nan;0;0
1263;4106;15;74;28;1;27;.964;3600000;0
1263;25584;14;21;25;6;19;.760;2868000;0
1264;1821;3;0;0;0;0;.00nan;0;0
1264;2054;3;96;31;1;30;.968;3600000;0
1264;27739;22;0;0;0;0;.00nan;0;0
1264;28026;22;74;30;2;28;.933;3558000;0
1265;823;23;0;0;0;0;.00nan;0;0
1265;10274;23;97;44;2;42;.955;3550000;0
1265;13842;34;69;14;1;13;.929;3600000;0
1265;15502;34;0;0;0;0;.00nan;0;0
1266;262;35;0;0;0;0;.00nan;0;0
1266;1430;35;55;35;5;30;.857;3600000;0
1266;15464;32;28;30;6;24;.800;3600000;0
1266;16006;32;0;0;0;0;.00nan;0;0
1267;1614;25;0;0;0;0;.00nan;0;0
1267;4506;33;0;0;0;0;.00nan;0;0
1267;5182;25;41;33;5;28;.848;3600000;0
1267;34740;33;77;28;2;26;.929;3600000;0
1268;500;4182;88;28;1;27;.964;3600000;0
1268;738;27;40;34;6;28;.824;2241000;0
1268;25521;4182;0;0;0;0;.00nan;0;0
1268;26623;27;83;27;1;26;.963;1359000;0
1269;1796;16;73;23;1;22;.957;3600000;0
1269;1913;30;0;0;0;0;.00nan;0;0
1269;4826;30;78;53;5;48;.906;3600000;0
1269;15437;16;0;0;0;0;.00nan;0;0
1270;1251;14;89;38;2;36;.947;3900000;0
1270;15505;8;82;32;2;30;.938;3900000;0
1270;25076;8;0;0;0;0;.00nan;0;0
1270;25584;14;0;0;0;0;.00nan;0;0
1271;61;31;73;15;0;15;1.000;2419000;0
1271;4450;5;0;0;0;0;.00nan;0;0
1271;19823;5;91;35;2;33;.943;3600000;0
1271;34797;31;27;14;4;10;.714;1177000;0
1272;717;0;0;0;0;0;.00nan;0;0
1272;1074;0;65;24;2;22;.917;3600000;0
1272;5385;17;93;31;1;30;.968;3600000;0
1272;34006;17;0;0;0;0;.00nan;0;0
1273;51;21;77;38;3;35;.921;3587000;0
1273;2058;28;0;0;0;0;.00nan;0;0
1273;25843;21;0;0;0;0;.00nan;0;0
1273;26824;28;66;22;2;20;.909;3600000;0
1274;323;9;0;0;0;0;.00nan;0;0
1274;1821;3;74;39;4;35;.897;3600000;0
1274;2054;3;0;0;0;0;.00nan;0;0
1274;20853;9;63;44;5;39;.886;3587000;0
1275;7139;29;75;25;1;24;.960;3600000;0
1275;13842;34;48;50;7;43;.860;3600000;0
1275;15502;34;0;0;0;0;.00nan;0;0
1275;18351;29;0;0;0;0;.00nan;0;0
1276;10103;24;0;0;0;0;.00nan;0;0
1276;13979;24;96;43;2;41;.953;3900000;0
1276;18104;10;89;42;2;40;.952;3900000;0
1276;27488;10;0;0;0;0;.00nan;0;0
1277;823;23;0;0;0;0;.00nan;0;0
1277;2423;15;59;27;3;24;.889;3600000;0
1277;4106;15;0;0;0;0;.00nan;0;0
1277;10274;23;55;38;5;33;.868;3578000;0
1278;928;20;0;0;0;0;.00nan;0;0
1278;18078;20;100;32;0;32;1.000;3600000;0
1278;27739;22;0;0;0;0;.00nan;0;0
1278;28026;22;59;35;4;31;.886;3600000;0
1279;544;19;0;0;0;0;.00nan;0;0
1279;15464;32;76;34;3;31;.912;3600000;0
1279;16006;32;0;0;0;0;.00nan;0;0
1279;31124;19;95;47;2;45;.957;3600000;0
1280;445;12;81;27;1;26;.963;3595000;0
1280;500;4182;97;19;0;19;1.000;3600000;0
1280;25521;4182;0;0;0;0;.00nan;0;0
1280;34786;12;0;0;0;0;.00nan;0;0
1281;262;35;68;38;4;34;.895;3900000;0
1281;1430;35;0;0;0;0;.00nan;0;0
1281;22601;26;0;0;0;0;.00nan;0;0
1281;32754;26;55;27;4;23;.852;3884000;0
1282;1614;25;88;21;0;21;1.000;3600000;0
1282;1796;16;63;37;4;33;.892;3600000;0
1282;5182;25;0;0;0;0;.00nan;0;0
1282;15437;16;0;0;0;0;.00nan;0;0
1283;335;18;0;0;0;0;.00nan;0;0
1283;1572;4838;84;40;3;37;.925;3564000;0
1283;2328;4838;0;0;0;0;.00nan;0;0
1283;5001;18;85;25;1;24;.960;3600000;0
1284;738;27;0;0;0;0;.00nan;0;0
1284;1913;30;72;42;5;37;.881;3900000;0
1284;4826;30;0;0;0;0;.00nan;0;0
1284;26623;27;63;38;5;33;.868;3900000;0
1285;500;4182;82;33;2;31;.939;3825000;0
1285;15505;8;0;0;0;0;.00nan;0;0
1285;25076;8;76;26;1;25;.962;3825000;0
1285;25521;4182;0;0;0;0;.00nan;0;0
1286;445;12;0;0;0;0;.00nan;0;0
1286;22601;26;88;35;2;33;.943;3600000;0
1286;32754;26;0;0;0;0;.00nan;0;0
1286;34786;12;92;32;1;31;.969;3600000;0
1287;1251;14;0;0;0;0;.00nan;0;0
1287;4506;33;36;25;5;20;.800;3515000;0
1287;25584;14;80;41;3;38;.927;3600000;0
1287;34740;33;0;0;0;0;.00nan;0;0
1288;724;11;0;0;0;0;.00nan;0;0
1288;1572;4838;0;0;0;0;.00nan;0;0
1288;2328;4838;100;38;1;37;.974;3600000;0
1288;21522;11;65;29;3;26;.897;3528000;0
1289;4450;5;0;0;0;0;.00nan;0;0
1289;5385;17;0;0;0;0;.00nan;0;0
1289;19823;5;89;19;0;19;1.000;3600000;0
1289;34006;17;81;46;4;42;.913;3600000;0
1290;61;31;0;0;0;0;.00nan;0;0
1290;2058;28;0;0;0;0;.00nan;0;0
1290;26824;28;89;27;1;26;.963;3600000;0
1290;34797;31;81;34;2;32;.941;3588000;0
1291;928;20;0;0;0;0;.00nan;0;0
1291;7139;29;0;0;0;0;.00nan;0;0
1291;18078;20;96;31;1;30;.968;3600000;0
1291;18351;29;55;33;5;28;.848;3600000;0
1292;13842;34;69;30;3;27;.900;3549000;0
1292;15502;34;0;0;0;0;.00nan;0;0
1292;27739;22;0;0;0;0;.00nan;0;0
1292;28026;22;76;25;2;23;.920;3600000;0
1293;51;21;95;47;3;44;.936;3570000;0
1293;10103;24;90;31;1;30;.968;3600000;0
1293;13979;24;0;0;0;0;.00nan;0;0
1293;25843;21;0;0;0;0;.00nan;0;0
1294;262;35;81;50;4;46;.920;3583000;0
1294;544;19;0;0;0;0;.00nan;0;0
1294;1430;35;0;0;0;0;.00nan;0;0
1294;31124;19;74;34;3;31;.912;3600000;0
1295;1614;25;75;32;2;30;.938;3600000;0
1295;5182;25;0;0;0;0;.00nan;0;0
1295;15464;32;59;30;4;26;.867;3600000;0
1295;16006;32;0;0;0;0;.00nan;0;0
1296;738;27;0;0;0;0;.00nan;0;0
1296;823;23;0;0;0;0;.00nan;0;0
1296;10274;23;88;40;4;36;.900;3555000;0
1296;26623;27;66;30;3;27;.900;3600000;0
1297;5385;17;55;46;6;40;.870;3600000;0
1297;15505;8;82;33;2;31;.939;3600000;0
1297;25076;8;0;0;0;0;.00nan;0;0
1297;34006;17;0;0;0;0;.00nan;0;0
1298;1821;3;99;23;0;23;1.000;3600000;0
1298;2054;3;0;0;0;0;.00nan;0;0
1298;4450;5;0;0;0;0;.00nan;0;0
1298;19823;5;53;31;4;27;.871;3600000;0
1299;61;31;75;21;1;20;.952;3600000;0
1299;717;0;0;0;0;0;.00nan;0;0
1299;1074;0;76;44;5;39;.886;3600000;0
1299;34797;31;0;0;0;0;.00nan;0;0
1300;51;21;0;0;0;0;.00nan;0;0
1300;323;9;0;0;0;0;.00nan;0;0
1300;20853;9;66;36;4;32;.889;3600000;0
1300;25843;21;65;26;3;23;.885;3600000;0
1301;18104;10;72;33;3;30;.909;3523000;0
1301;27488;10;0;0;0;0;.00nan;0;0
1301;27739;22;72;23;1;22;.957;3600000;0
1301;28026;22;0;0;0;0;.00nan;0;0
1302;1251;14;0;0;0;0;.00nan;0;0
1302;2058;28;33;36;6;30;.833;3600000;0
1302;25584;14;81;33;2;31;.939;3600000;0
1302;26824;28;0;0;0;0;.00nan;0;0
1303;2423;15;62;36;3;33;.917;3900000;0
1303;4106;15;0;0;0;0;.00nan;0;0
1303;10103;24;0;0;0;0;.00nan;0;0
1303;13979;24;100;48;3;45;.938;3858000;0
1304;7139;29;59;33;4;29;.879;3900000;0
1304;13842;34;0;0;0;0;.00nan;0;0
1304;15502;34;81;49;4;45;.918;3900000;0
1304;18351;29;0;0;0;0;.00nan;0;0
1305;500;4182;100;39;1;38;.974;3600000;0
1305;1796;16;70;29;3;26;.897;3515000;0
1305;15437;16;0;0;0;0;.00nan;0;0
1305;25521;4182;0;0;0;0;.00nan;0;0
1306;445;12;95;33;1;32;.970;3576000;0
1306;1913;30;97;22;0;22;1.000;3600000;0
1306;4826;30;0;0;0;0;.00nan;0;0
1306;34786;12;0;0;0;0;.00nan;0;0
1307;262;35;0;0;0;0;.00nan;0;0
1307;1430;35;20;20;6;14;.700;3600000;0
1307;1614;25;0;0;0;0;.00nan;0;0
1307;5182;25;97;36;2;34;.944;3600000;0
1308;544;19;0;0;0;0;.00nan;0;0
1308;4506;33;55;27;3;24;.889;3542000;0
1308;31124;19;91;42;2;40;.952;3600000;0
1308;34740;33;0;0;0;0;.00nan;0;0
1309;335;18;0;0;0;0;.00nan;0;0
1309;724;11;0;0;0;0;.00nan;0;0
1309;5001;18;78;27;2;25;.926;3592000;0
1309;21522;11;90;39;1;38;.974;3605000;0
1310;15464;32;42;23;4;19;.826;2383000;0
1310;16006;32;42;12;2;10;.833;1217000;0
1310;22601;26;0;0;0;0;.00nan;0;0
1310;32754;26;65;19;2;17;.895;3600000;0
1311;738;27;0;0;0;0;.00nan;0;0
1311;1572;4838;0;0;0;0;.00nan;0;0
1311;2328;4838;63;32;3;29;.906;3600000;0
1311;26623;27;79;13;0;13;1.000;3600000;0
2701;1251;14;18;23;6;17;.739;2133000;0
2701;1614;25;82;25;2;23;.920;3600000;0
2701;5182;25;0;0;0;0;.00nan;0;0
2701;25584;14;53;21;2;19;.905;1467000;0
2703;544;19;100;34;1;33;.971;3600000;0
2703;15464;32;0;0;0;0;.00nan;0;0
2703;16006;32;80;30;2;28;.933;3542000;0
2703;31124;19;0;0;0;0;.00nan;0;0
2705;262;35;71;27;2;25;.926;3900000;0
2705;1430;35;0;0;0;0;.00nan;0;0
2705;4506;33;95;42;2;40;.952;3900000;0
2705;34740;33;0;0;0;0;.00nan;0;0
2707;445;12;0;0;0;0;.00nan;0;0
2707;15505;8;0;0;0;0;.00nan;0;0
2707;25076;8;84;36;2;34;.944;3600000;0
2707;34786;12;32;31;6;25;.806;3600000;0
2709;738;27;0;0;0;0;.00nan;0;0
2709;13842;34;99;32;1;31;.969;3600000;0
2709;15502;34;0;0;0;0;.00nan;0;0
2709;26623;27;72;28;2;26;.929;3569000;0
2711;2423;15;97;51;2;49;.961;3588000;0
2711;4106;15;0;0;0;0;.00nan;0;0
2711;18104;10;0;0;0;0;.00nan;0;0
2711;27488;10;76;25;1;24;.960;3600000;0
2713;323;9;65;37;4;33;.892;3526000;0
2713;724;11;0;0;0;0;.00nan;0;0
2713;20853;9;0;0;0;0;.00nan;0;0
2713;21522;11;66;19;2;17;.895;3600000;0
2715;500;4182;68;19;2;17;.895;3527000;0
2715;18078;20;95;21;0;21;1.000;3600000;0
2715;25521;4182;0;0;0;0;.00nan;0;0
2715;32146;20;0;0;0;0;.00nan;0;0
2717;1074;0;0;0;0;0;.00nan;0;0
2717;4450;5;0;0;0;0;.00nan;0;0
2717;19823;5;66;24;2;22;.917;3600000;0
2717;31035;0;42;34;6;28;.824;3600000;0
2719;1913;30;0;0;0;0;.00nan;0;0
2719;4826;30;65;46;5;41;.891;3768000;0
2719;22601;26;0;0;0;0;.00nan;0;0
2719;32754;26;61;35;4;31;.886;3768000;0
2721;1821;3;70;22;2;20;.909;3600000;0
2721;2054;3;0;0;0;0;.00nan;0;0
2721;2058;28;56;41;5;36;.878;3600000;0
2721;14061;28;0;0;0;0;.00nan;0;0
2723;823;23;0;0;0;0;.00nan;0;0
2723;10103;24;64;37;4;33;.892;3620000;0
2723;10274;23;49;19;3;16;.842;3620000;0
2723;13979;24;0;0;0;0;.00nan;0;0
2725;51;21;0;0;0;0;.00nan;0;0
2725;1796;16;0;0;0;0;.00nan;0;0
2725;15437;16;47;27;4;23;.852;3600000;0
2725;25843;21;93;31;1;30;.968;3600000;0
2727;233;29;25;24;6;18;.750;3600000;0
2727;1572;4838;78;29;2;27;.931;3600000;0
2727;2328;4838;0;0;0;0;.00nan;0;0
2727;18351;29;0;0;0;0;.00nan;0;0
2729;61;31;0;0;0;0;.00nan;0;0
2729;335;18;85;37;2;35;.946;3600000;0
2729;5001;18;0;0;0;0;.00nan;0;0
2729;34797;31;78;43;4;39;.907;3588000;0
2731;5385;17;0;0;0;0;.00nan;0;0
2731;27739;22;80;31;2;29;.935;3600000;0
2731;28026;22;0;0;0;0;.00nan;0;0
2731;34006;17;78;38;3;35;.921;3553000;0
2733;500;4182;79;36;3;33;.917;3600000;0
2733;22601;26;51;2;0;2;1.000;355000;0
2733;25521;4182;0;0;0;0;.00nan;0;0
2733;32754;26;31;28;6;22;.786;3245000;0
2735;738;27;40;34;6;28;.824;2776000;0
2735;18104;10;79;22;1;21;.955;3600000;0
2735;26623;27;46;13;2;11;.846;824000;0
2735;27488;10;0;0;0;0;.00nan;0;0
2737;262;35;100;42;1;41;.976;3900000;0
2737;1430;35;0;0;0;0;.00nan;0;0
2737;1913;30;86;27;1;26;.963;3900000;0
2737;4826;30;0;0;0;0;.00nan;0;0
2739;4506;33;61;29;3;26;.897;3900000;0
2739;10103;24;90;44;3;41;.932;3900000;0
2739;13979;24;0;0;0;0;.00nan;0;0
2739;34740;33;0;0;0;0;.00nan;0;0
2741;1074;0;69;38;4;34;.895;3600000;0
2741;1572;4838;0;0;0;0;.00nan;0;0
2741;2328;4838;38;30;5;25;.833;3555000;0
2741;31035;0;0;0;0;0;.00nan;0;0
2743;1821;3;76;41;2;39;.951;3900000;0
2743;2054;3;0;0;0;0;.00nan;0;0
2743;15505;8;0;0;0;0;.00nan;0;0
2743;25076;8;73;25;2;23;.920;3900000;0
2745;2423;15;0;0;0;0;.00nan;0;0
2745;4106;15;74;34;3;31;.912;3600000;0
2745;18078;20;37;15;4;11;.733;1070000;0
2745;32146;20;55;18;2;16;.889;2530000;0
2747;445;12;0;0;0;0;.00nan;0;0
2747;5385;17;0;0;0;0;.00nan;0;0
2747;34006;17;75;25;2;23;.920;3694000;0
2747;34786;12;64;30;3;27;.900;3694000;0
2749;51;21;0;0;0;0;.00nan;0;0
2749;1251;14;0;0;0;0;.00nan;0;0
2749;25584;14;76;44;4;40;.909;3900000;0
2749;25843;21;53;36;4;32;.889;3900000;0
2751;1614;25;91;33;1;32;.970;3600000;0
2751;5182;25;0;0;0;0;.00nan;0;0
2751;27739;22;0;0;0;0;.00nan;0;0
2751;28026;22;79;41;4;37;.902;3600000;0
2753;823;23;0;0;0;0;.00nan;0;0
2753;10274;23;96;31;2;29;.935;3600000;0
2753;13842;34;0;0;0;0;.00nan;0;0
2753;15502;34;92;43;3;40;.930;3600000;0
2755;61;31;0;0;0;0;.00nan;0;0
2755;2058;28;57;38;6;32;.842;3600000;0
2755;14061;28;0;0;0;0;.00nan;0;0
2755;34797;31;76;39;3;36;.923;3600000;0
2757;544;19;18;26;7;19;.731;1931000;0
2757;15464;32;0;0;0;0;.00nan;0;0
2757;16006;32;88;29;1;28;.966;3600000;0
2757;31124;19;55;5;0;5;1.000;1669000;0
2759;335;18;97;42;2;40;.952;3600000;0
2759;4450;5;52;32;4;28;.875;3543000;0
2759;5001;18;0;0;0;0;.00nan;0;0
2759;19823;5;0;0;0;0;.00nan;0;0
2761;233;29;0;0;0;0;.00nan;0;0
2761;1796;16;99;21;0;21;1.000;3600000;0
2761;15437;16;0;0;0;0;.00nan;0;0
2761;18351;29;64;44;5;39;.886;3600000;0
2763;323;9;53;3;0;3;1.000;319000;0
2763;724;11;61;13;1;12;.923;3600000;0
2763;20853;9;40;30;6;24;.800;3281000;0
2763;21522;11;0;0;0;0;.00nan;0;0
2765;724;11;0;0;0;0;.00nan;0;0
2765;823;23;61;37;5;32;.865;3600000;0
2765;10274;23;0;0;0;0;.00nan;0;0
2765;21522;11;82;34;2;32;.941;3600000;0
2767;1251;14;53;30;4;26;.867;3513000;0
2767;2058;28;0;0;0;0;.00nan;0;0
2767;14061;28;100;43;2;41;.953;3600000;0
2767;25584;14;0;0;0;0;.00nan;0;0
2769;15464;32;43;30;5;25;.833;3600000;0
2769;16006;32;0;0;0;0;.00nan;0;0
2769;18104;10;0;0;0;0;.00nan;0;0
2769;27488;10;81;33;2;31;.939;3600000;0
2771;738;27;0;0;0;0;.00nan;0;0
2771;5385;17;23;24;6;18;.750;2634000;0
2771;26623;27;70;28;2;26;.929;3600000;0
2771;34006;17;61;6;0;6;1.000;966000;0
2773;61;31;81;37;3;34;.919;3559000;0
2773;233;29;74;26;2;24;.923;3600000;0
2773;18351;29;0;0;0;0;.00nan;0;0
2773;34797;31;0;0;0;0;.00nan;0;0
2775;500;4182;0;0;0;0;.00nan;0;0
2775;1913;30;0;0;0;0;.00nan;0;0
2775;4826;30;73;36;3;33;.917;3600000;0
2775;25521;4182;37;17;4;13;.765;3566000;0
2777;51;21;54;20;3;17;.850;3600000;0
2777;13842;34;50;40;6;34;.850;2813000;0
2777;15502;34;52;9;1;8;.889;787000;0
2777;25843;21;0;0;0;0;.00nan;0;0
2779;335;18;0;0;0;0;.00nan;0;0
2779;544;19;84;30;2;28;.933;3900000;0
2779;5001;18;78;34;2;32;.941;3900000;0
2779;31124;19;0;0;0;0;.00nan;0;0
2781;1572;4838;84;33;1;32;.970;3600000;0
2781;2328;4838;0;0;0;0;.00nan;0;0
2781;4506;33;0;0;0;0;.00nan;0;0
2781;34740;33;78;27;2;25;.926;3553000;0
2783;1796;16;38;34;6;28;.824;3600000;0
2783;15437;16;0;0;0;0;.00nan;0;0
2783;18078;20;100;30;0;30;1.000;3600000;0
2783;32146;20;0;0;0;0;.00nan;0;0
2785;1821;3;0;0;0;0;.00nan;0;0
2785;2054;3;97;51;3;48;.941;3900000;0
2785;4450;5;0;0;0;0;.00nan;0;0
2785;19823;5;71;31;3;28;.903;3900000;0
2787;262;35;0;0;0;0;.00nan;0;0
2787;445;12;78;38;3;35;.921;3600000;0
2787;1430;35;99;23;0;23;1.000;3600000;0
2787;34786;12;0;0;0;0;.00nan;0;0
2789;15505;8;72;25;2;23;.920;3600000;0
2789;22601;26;54;32;4;28;.875;3540000;0
2789;25076;8;0;0;0;0;.00nan;0;0
2789;32754;26;0;0;0;0;.00nan;0;0
2791;323;9;77;43;5;38;.884;3600000;0
2791;2423;15;86;26;2;24;.923;3600000;0
2791;4106;15;0;0;0;0;.00nan;0;0
2791;20853;9;0;0;0;0;.00nan;0;0
2793;1614;25;0;0;0;0;.00nan;0;0
2793;5182;25;75;27;2;25;.926;3600000;0
2793;27739;22;30;40;8;32;.800;3600000;0
2793;28026;22;0;0;0;0;.00nan;0;0
2795;1074;0;0;0;0;0;.00nan;0;0
2795;10103;24;0;0;0;0;.00nan;0;0
2795;13979;24;78;27;2;25;.926;3900000;0
2795;31035;0;72;27;2;25;.926;3900000;0
2797;233;29;81;32;2;30;.938;3600000;0
2797;18104;10;39;22;4;18;.818;1793000;0
2797;18351;29;0;0;0;0;.00nan;0;0
2797;27488;10;34;29;6;23;.793;1807000;0
2799;724;11;0;0;0;0;.00nan;0;0
2799;1796;16;88;32;2;30;.938;3900000;0
2799;15437;16;0;0;0;0;.00nan;0;0
2799;21522;11;78;34;2;32;.941;3900000;0
2801;544;19;63;24;2;22;.917;3900000;0
2801;22601;26;100;42;2;40;.952;3900000;0
2801;31124;19;0;0;0;0;.00nan;0;0
2801;32754;26;0;0;0;0;.00nan;0;0
2803;5385;17;0;0;0;0;.00nan;0;0
2803;27739;22;0;0;0;0;.00nan;0;0
2803;28026;22;60;20;3;17;.850;3517000;0
2803;34006;17;100;42;1;41;.976;3600000;0
2805;1251;14;0;0;0;0;.00nan;0;0
2805;15464;32;0;0;0;0;.00nan;0;0
2805;16006;32;54;30;4;26;.867;3767000;0
2805;25584;14;40;30;5;25;.833;3767000;0
2807;51;21;0;0;0;0;.00nan;0;0
2807;2058;28;91;41;4;37;.902;3900000;0
2807;14061;28;0;0;0;0;.00nan;0;0
2807;25843;21;66;34;4;30;.882;3900000;0
2809;335;18;63;33;4;29;.879;3600000;0
2809;5001;18;0;0;0;0;.00nan;0;0
2809;10103;24;0;0;0;0;.00nan;0;0
2809;13979;24;58;34;5;29;.853;3600000;0
2811;1821;3;0;0;0;0;.00nan;0;0
2811;2054;3;60;29;3;26;.897;3600000;0
2811;4506;33;66;38;5;33;.868;3514000;0
2811;34740;33;0;0;0;0;.00nan;0;0
2813;61;31;0;0;0;0;.00nan;0;0
2813;2423;15;52;30;5;25;.833;3552000;0
2813;4106;15;0;0;0;0;.00nan;0;0
2813;34797;31;45;20;3;17;.850;3600000;0
2815;262;35;0;0;0;0;.00nan;0;0
2815;1430;35;74;25;2;23;.920;3600000;0
2815;1913;30;69;49;5;44;.898;3600000;0
2815;4826;30;0;0;0;0;.00nan;0;0
2817;323;9;89;31;1;30;.968;3546000;0
2817;500;4182;94;17;0;17;1.000;3600000;0
2817;20853;9;0;0;0;0;.00nan;0;0
2817;25521;4182;0;0;0;0;.00nan;0;0
2819;1074;0;88;32;3;29;.906;3900000;0
2819;4450;5;0;0;0;0;.00nan;0;0
2819;19823;5;56;23;3;20;.870;3900000;0
2819;31035;0;0;0;0;0;.00nan;0;0
2821;445;12;54;31;4;27;.871;3587000;0
2821;18078;20;97;37;2;35;.946;3600000;0
2821;32146;20;0;0;0;0;.00nan;0;0
2821;34786;12;0;0;0;0;.00nan;0;0
2823;1572;4838;0;0;0;0;.00nan;0;0
2823;2328;4838;91;42;2;40;.952;3600000;0
2823;13842;34;56;30;3;27;.900;3561000;0
2823;15502;34;0;0;0;0;.00nan;0;0
2825;823;23;84;30;2;28;.933;3600000;0
2825;10274;23;0;0;0;0;.00nan;0;0
2825;15505;8;16;7;4;3;.429;436000;0
2825;25076;8;63;30;3;27;.900;3164000;0
2827;738;27;77;36;3;33;.917;3600000;0
2827;1614;25;73;43;4;39;.907;3561000;0
2827;5182;25;0;0;0;0;.00nan;0;0
2827;26623;27;0;0;0;0;.00nan;0;0
2829;1796;16;0;0;0;0;.00nan;0;0
2829;15437;16;89;35;2;33;.943;3600000;0
2829;18078;20;0;0;0;0;.00nan;0;0
2829;32146;20;51;24;3;21;.875;3600000;0
2831;5385;17;90;31;1;30;.968;3600000;0
2831;10103;24;79;30;2;28;.933;3580000;0
2831;13979;24;0;0;0;0;.00nan;0;0
2831;34006;17;0;0;0;0;.00nan;0;0
2833;2058;28;0;0;0;0;.00nan;0;0
2833;13842;34;0;0;0;0;.00nan;0;0
2833;14061;28;56;31;4;27;.871;3900000;0
2833;15502;34;91;50;4;46;.920;3900000;0
2835;335;18;0;0;0;0;.00nan;0;0
2835;4506;33;17;20;6;14;.700;1754000;0
2835;5001;18;71;22;1;21;.955;3600000;0
2835;34740;33;66;21;2;19;.905;1846000;0
2837;500;4182;47;18;3;15;.833;3900000;0
2837;1074;0;0;0;0;0;.00nan;0;0
2837;25521;4182;0;0;0;0;.00nan;0;0
2837;31035;0;88;50;3;47;.940;3900000;0
2839;2423;15;0;0;0;0;.00nan;0;0
2839;4106;15;50;29;4;25;.862;3600000;0
2839;15464;32;90;30;1;29;.967;3600000;0
2839;16006;32;0;0;0;0;.00nan;0;0
2841;262;35;0;0;0;0;.00nan;0;0
2841;1251;14;71;22;2;20;.909;3600000;0
2841;1430;35;83;41;3;38;.927;3600000;0
2841;25584;14;0;0;0;0;.00nan;0;0
2843;233;29;0;0;0;0;.00nan;0;0
2843;724;11;96;41;2;39;.951;3600000;0
2843;18351;29;38;21;4;17;.810;3548000;0
2843;21522;11;0;0;0;0;.00nan;0;0
2845;544;19;0;0;0;0;.00nan;0;0
2845;823;23;0;0;0;0;.00nan;0;0
2845;10274;23;86;28;1;27;.964;3600000;0
2845;31124;19;65;30;4;26;.867;3600000;0
2847;323;9;0;0;0;0;.00nan;0;0
2847;15505;8;74;30;2;28;.933;3600000;0
2847;20853;9;73;38;4;34;.895;3571000;0
2847;25076;8;0;0;0;0;.00nan;0;0
2849;51;21;98;46;1;45;.978;3600000;0
2849;4450;5;56;26;3;23;.885;3559000;0
2849;19823;5;0;0;0;0;.00nan;0;0
2849;25843;21;0;0;0;0;.00nan;0;0
2851;445;12;0;0;0;0;.00nan;0;0
2851;18104;10;72;28;2;26;.929;3600000;0
2851;27488;10;0;0;0;0;.00nan;0;0
2851;34786;12;53;18;3;15;.833;3600000;0
2853;1821;3;83;14;0;14;1.000;3600000;0
2853;2054;3;0;0;0;0;.00nan;0;0
2853;22601;26;0;0;0;0;.00nan;0;0
2853;32754;26;42;25;4;21;.840;3600000;0
2855;1614;25;0;0;0;0;.00nan;0;0
2855;5182;25;64;20;2;18;.900;3574000;0
2855;27739;22;91;34;1;33;.971;3600000;0
2855;28026;22;0;0;0;0;.00nan;0;0
2857;738;27;0;0;0;0;.00nan;0;0
2857;1913;30;0;0;0;0;.00nan;0;0
2857;4826;30;51;37;5;32;.865;3562000;0
2857;26623;27;60;30;3;27;.900;3600000;0
2859;61;31;59;22;2;20;.909;3600000;0
2859;1572;4838;81;49;5;44;.898;3600000;0
2859;2328;4838;0;0;0;0;.00nan;0;0
2859;34797;31;0;0;0;0;.00nan;0;0
2861;500;4182;0;0;0;0;.00nan;0;0
2861;1074;0;97;52;1;51;.981;3900000;0
2861;25521;4182;83;22;1;21;.955;3900000;0
2861;31035;0;0;0;0;0;.00nan;0;0
2863;1821;3;53;46;6;40;.870;3600000;0
2863;2054;3;0;0;0;0;.00nan;0;0
2863;15505;8;64;32;3;29;.906;3600000;0
2863;25076;8;0;0;0;0;.00nan;0;0
2865;262;35;78;34;2;32;.941;3600000;0
2865;823;23;11;25;7;18;.720;1668000;0
2865;1430;35;0;0;0;0;.00nan;0;0
2865;10274;23;44;17;3;14;.824;1932000;0
2867;4450;5;67;17;1;16;.941;3600000;0
2867;4506;33;41;46;8;38;.826;3600000;0
2867;19823;5;0;0;0;0;.00nan;0;0
2867;34740;33;0;0;0;0;.00nan;0;0
2869;5385;17;0;0;0;0;.00nan;0;0
2869;22601;26;12;11;5;6;.545;1108000;0
2869;32754;26;67;28;4;24;.857;2492000;0
2869;34006;17;100;30;0;30;1.000;3600000;0
2871;51;21;100;37;0;37;1.000;3600000;0
2871;738;27;78;32;2;30;.938;3513000;0
2871;25843;21;0;0;0;0;.00nan;0;0
2871;26623;27;0;0;0;0;.00nan;0;0
2873;233;29;74;21;1;20;.952;3600000;0
2873;15464;32;0;0;0;0;.00nan;0;0
2873;16006;32;64;35;3;32;.914;3547000;0
2873;18351;29;0;0;0;0;.00nan;0;0
2875;323;9;0;0;0;0;.00nan;0;0
2875;1251;14;42;20;4;16;.800;3600000;0
2875;20853;9;100;35;0;35;1.000;3600000;0
2875;25584;14;0;0;0;0;.00nan;0;0
2877;724;11;72;30;3;27;.900;3583000;0
2877;1913;30;0;0;0;0;.00nan;0;0
2877;4826;30;100;35;1;34;.971;3600000;0
2877;21522;11;0;0;0;0;.00nan;0;0
2879;445;12;75;34;2;32;.941;3600000;0
2879;1572;4838;0;0;0;0;.00nan;0;0
2879;2328;4838;75;33;3;30;.909;3600000;0
2879;34786;12;0;0;0;0;.00nan;0;0
2881;2423;15;63;35;4;31;.886;3577000;0
2881;4106;15;0;0;0;0;.00nan;0;0
2881;18078;20;72;31;3;28;.903;3600000;0
2881;32146;20;0;0;0;0;.00nan;0;0
2883;2058;28;62;28;3;25;.893;3589000;0
2883;13842;34;0;0;0;0;.00nan;0;0
2883;14061;28;0;0;0;0;.00nan;0;0
2883;15502;34;67;27;2;25;.926;3600000;0
2885;1614;25;71;19;1;18;.947;3600000;0
2885;5182;25;0;0;0;0;.00nan;0;0
2885;10103;24;0;0;0;0;.00nan;0;0
2885;13979;24;91;35;2;33;.943;3565000;0
2887;335;18;54;28;4;24;.857;3900000;0
2887;544;19;0;0;0;0;.00nan;0;0
2887;5001;18;0;0;0;0;.00nan;0;0
2887;31124;19;70;44;4;40;.909;3900000;0
2889;61;31;0;0;0;0;.00nan;0;0
2889;1796;16;86;37;2;35;.946;3592000;0
2889;15437;16;0;0;0;0;.00nan;0;0
2889;34797;31;88;28;1;27;.964;3600000;0
2891;18104;10;63;29;3;26;.897;3600000;0
2891;27488;10;0;0;0;0;.00nan;0;0
2891;27739;22;28;27;6;21;.778;2710000;0
2891;28026;22;66;10;0;10;1.000;890000;0
2893;823;23;0;0;0;0;.00nan;0;0
2893;10274;23;69;27;2;25;.926;3600000;0
2893;18078;20;50;27;4;23;.852;3558000;0
2893;32146;20;0;0;0;0;.00nan;0;0
2895;233;29;0;0;0;0;.00nan;0;0
2895;4450;5;0;0;0;0;.00nan;0;0
2895;18351;29;63;41;5;36;.878;3600000;0
2895;19823;5;52;15;2;13;.867;3600000;0
2897;724;11;0;0;0;0;.00nan;0;0
2897;1913;30;69;35;3;32;.914;3600000;0
2897;4826;30;0;0;0;0;.00nan;0;0
2897;21522;11;35;26;5;21;.808;3600000;0
2899;1614;25;0;0;0;0;.00nan;0;0
2899;1821;3;0;0;0;0;.00nan;0;0
2899;2054;3;94;39;2;37;.949;3581000;0
2899;5182;25;88;33;1;32;.970;3600000;0
2901;4506;33;0;0;0;0;.00nan;0;0
2901;27739;22;54;25;3;22;.880;3009000;0
2901;28026;22;27;8;3;5;.625;591000;0
2901;34740;33;89;38;2;36;.947;3600000;0
2903;445;12;0;0;0;0;.00nan;0;0
2903;10103;24;42;29;5;24;.828;3519000;0
2903;13979;24;0;0;0;0;.00nan;0;0
2903;34786;12;84;41;3;38;.927;3600000;0
2905;1074;0;0;0;0;0;.00nan;0;0
2905;1796;16;0;0;0;0;.00nan;0;0
2905;15437;16;73;23;1;22;.957;3561000;0
2905;31035;0;100;53;0;53;1.000;3600000;0
2907;13842;34;90;42;1;41;.976;3600000;0
2907;15464;32;46;25;4;21;.840;3600000;0
2907;15502;34;0;0;0;0;.00nan;0;0
2907;16006;32;0;0;0;0;.00nan;0;0
2909;500;4182;60;29;3;26;.897;3900000;0
2909;2058;28;0;0;0;0;.00nan;0;0
2909;14061;28;99;51;3;48;.941;3897000;0
2909;25521;4182;0;0;0;0;.00nan;0;0
2911;15505;8;0;0;0;0;.00nan;0;0
2911;22601;26;83;30;2;28;.933;3600000;0
2911;25076;8;47;27;4;23;.852;3582000;0
2911;32754;26;0;0;0;0;.00nan;0;0
2913;5385;17;0;0;0;0;.00nan;0;0
2913;18104;10;0;0;0;0;.00nan;0;0
2913;27488;10;72;24;1;23;.958;3600000;0
2913;34006;17;82;31;2;29;.935;3543000;0
2915;323;9;67;12;0;12;1.000;1283000;0
2915;738;27;0;0;0;0;.00nan;0;0
2915;20853;9;32;18;4;14;.778;2284000;0
2915;26623;27;67;27;2;25;.926;3600000;0
2917;544;19;52;23;3;20;.870;3600000;0
2917;2423;15;0;0;0;0;.00nan;0;0
2917;4106;15;84;49;4;45;.918;3571000;0
2917;31124;19;0;0;0;0;.00nan;0;0
2919;262;35;0;0;0;0;.00nan;0;0
2919;1251;14;0;0;0;0;.00nan;0;0
2919;1430;35;95;32;1;31;.969;3600000;0
2919;25584;14;65;24;2;22;.917;3550000;0
2921;51;21;91;46;3;43;.935;3600000;0
2921;61;31;83;13;0;13;1.000;3600000;0
2921;25843;21;0;0;0;0;.00nan;0;0
2921;34797;31;0;0;0;0;.00nan;0;0
2923;335;18;0;0;0;0;.00nan;0;0
2923;1572;4838;80;37;2;35;.946;3582000;0
2923;2328;4838;0;0;0;0;.00nan;0;0
2923;5001;18;93;13;0;13;1.000;3600000;0
1312;780;52;64;18;2;16;.889;3600000;0
1312;23255;52;0;0;0;0;.00nan;0;0
1312;28772;53;0;0;0;0;.00nan;0;0
1312;31156;53;55;26;3;23;.885;3544000;0
1313;1486;43;0;0;0;0;.00nan;0;0
1313;2900;36;76;29;2;27;.931;3635000;0
1313;3625;43;78;21;1;20;.952;3635000;0
1313;14874;36;0;0;0;0;.00nan;0;0
1314;6081;56;57;34;5;29;.853;3569000;0
1314;23493;51;67;32;3;29;.906;3600000;0
1314;26824;56;0;0;0;0;.00nan;0;0
1314;31822;51;0;0;0;0;.00nan;0;0
1315;37;46;100;23;0;23;1.000;3600000;0
1315;2553;46;0;0;0;0;.00nan;0;0
1315;34788;42;0;0;0;0;.00nan;0;0
1315;37416;42;63;33;4;29;.879;3600000;0
1316;1051;44;0;0;0;0;.00nan;0;0
1316;3281;44;68;20;1;19;.950;3897000;0
1316;14351;40;91;34;2;32;.941;3897000;0
1316;26840;40;0;0;0;0;.00nan;0;0
1317;3626;48;90;40;2;38;.950;3600000;0
1317;4716;4619;34;28;5;23;.821;3600000;0
1317;35210;4619;0;0;0;0;.00nan;0;0
1317;38547;48;0;0;0;0;.00nan;0;0
1318;1592;63;0;0;0;0;.00nan;0;0
1318;2296;37;0;0;0;0;.00nan;0;0
1318;5883;37;71;34;3;31;.912;3600000;0
1318;26967;63;100;41;0;41;1.000;3600000;0
1319;2796;59;0;0;0;0;.00nan;0;0
1319;8046;57;50;33;4;29;.879;3600000;0
1319;26865;57;0;0;0;0;.00nan;0;0
1319;31858;59;76;26;1;25;.962;3600000;0
1320;4338;65;0;0;0;0;.00nan;0;0
1320;4987;65;56;40;6;34;.850;3793000;0
1320;19640;41;0;0;0;0;.00nan;0;0
1320;23075;41;26;32;7;25;.781;3793000;0
1321;1486;43;62;21;2;19;.905;3600000;0
1321;2900;36;0;0;0;0;.00nan;0;0
1321;3625;43;0;0;0;0;.00nan;0;0
1321;14874;36;81;44;3;41;.932;3546000;0
1322;6081;56;0;0;0;0;.00nan;0;0
1322;23493;51;0;0;0;0;.00nan;0;0
1322;26824;56;79;25;1;24;.960;3600000;0
1322;31822;51;65;29;3;26;.897;3525000;0
1323;37;46;0;0;0;0;.00nan;0;0
1323;2553;46;89;33;2;31;.939;3600000;0
1323;4447;54;0;0;0;0;.00nan;0;0
1323;31643;54;60;25;3;22;.880;3600000;0
1324;780;52;0;0;0;0;.00nan;0;0
1324;3847;38;61;8;0;8;1.000;1301000;0
1324;23255;52;79;32;2;30;.938;3600000;0
1324;31021;38;38;24;5;19;.792;2299000;0
1325;5137;58;0;0;0;0;.00nan;0;0
1325;14321;58;53;29;4;25;.862;3571000;0
1325;28772;53;0;0;0;0;.00nan;0;0
1325;31156;53;97;38;2;36;.947;3600000;0
1326;5146;64;0;0;0;0;.00nan;0;0
1326;28845;64;100;28;0;28;1.000;3600000;0
1326;34788;42;90;41;2;39;.951;3537000;0
1326;37416;42;0;0;0;0;.00nan;0;0
1327;3;50;59;30;4;26;.867;3815000;0
1327;376;45;0;0;0;0;.00nan;0;0
1327;2198;45;96;49;3;46;.939;3815000;0
1327;5048;50;0;0;0;0;.00nan;0;0
1328;2152;49;78;34;2;32;.941;3600000;0
1328;4435;49;0;0;0;0;.00nan;0;0
1328;6572;62;0;0;0;0;.00nan;0;0
1328;26919;62;54;21;3;18;.857;3567000;0
1329;1051;44;26;12;4;8;.667;1200000;0
1329;3281;44;62;19;1;18;.947;2400000;0
1329;14351;40;0;0;0;0;.00nan;0;0
1329;26840;40;85;30;2;28;.933;3600000;0
1330;2016;61;0;0;0;0;.00nan;0;0
1330;7049;47;88;31;1;30;.968;3552000;0
1330;30971;61;100;31;0;31;1.000;3600000;0
1330;33654;47;0;0;0;0;.00nan;0;0
1331;3847;38;0;0;0;0;.00nan;0;0
1331;28772;53;59;34;4;30;.882;3568000;0
1331;31021;38;77;40;3;37;.925;3600000;0
1331;31156;53;0;0;0;0;.00nan;0;0
1332;4338;65;71;29;2;27;.931;3600000;0
1332;4987;65;0;0;0;0;.00nan;0;0
1332;8046;57;55;5;0;5;1.000;659000;0
1332;26865;57;44;32;6;26;.813;2941000;0
1333;2163;39;0;0;0;0;.00nan;0;0
1333;5298;55;0;0;0;0;.00nan;0;0
1333;9238;39;97;26;1;25;.962;3600000;0
1333;34770;55;87;42;4;38;.905;3600000;0
1334;2796;59;33;21;4;17;.810;3600000;0
1334;19640;41;34;11;3;8;.727;519000;0
1334;23075;41;69;37;4;33;.892;3081000;0
1334;31858;59;0;0;0;0;.00nan;0;0
1335;780;52;77;25;2;23;.920;3600000;0
1335;5137;58;46;36;5;31;.861;3600000;0
1335;14321;58;0;0;0;0;.00nan;0;0
1335;23255;52;0;0;0;0;.00nan;0;0
1336;1592;63;51;30;4;26;.867;3600000;0
1336;2296;37;0;0;0;0;.00nan;0;0
1336;5883;37;73;28;2;26;.929;3600000;0
1336;26967;63;0;0;0;0;.00nan;0;0
1337;3;50;0;0;0;0;.00nan;0;0
1337;376;45;88;37;3;34;.919;3522000;0
1337;2198;45;0;0;0;0;.00nan;0;0
1337;5048;50;92;32;1;31;.969;3600000;0
1338;7049;47;0;0;0;0;.00nan;0;0
1338;20717;60;0;0;0;0;.00nan;0;0
1338;33654;47;73;34;3;31;.912;3583000;0
1338;35536;60;61;21;2;19;.905;3600000;0
1339;2016;61;0;0;0;0;.00nan;0;0
1339;2152;49;0;0;0;0;.00nan;0;0
1339;4435;49;56;26;3;23;.885;3557000;0
1339;30971;61;56;20;2;18;.900;3600000;0
1340;3626;48;84;32;2;30;.938;3600000;0
1340;4716;4619;65;29;3;26;.897;3543000;0
1340;35210;4619;0;0;0;0;.00nan;0;0
1340;38547;48;0;0;0;0;.00nan;0;0
1341;2016;61;0;0;0;0;.00nan;0;0
1341;2152;49;0;0;0;0;.00nan;0;0
1341;4435;49;85;18;0;18;1.000;3600000;0
1341;30971;61;85;40;3;37;.925;3600000;0
1342;2296;37;0;0;0;0;.00nan;0;0
1342;5883;37;40;28;5;23;.821;3594000;0
1342;23493;51;0;0;0;0;.00nan;0;0
1342;31822;51;62;28;3;25;.893;3600000;0
1343;4338;65;29;25;5;20;.800;3513000;0
1343;4987;65;0;0;0;0;.00nan;0;0
1343;19640;41;61;28;3;25;.893;3600000;0
1343;23075;41;0;0;0;0;.00nan;0;0
1344;3847;38;0;0;0;0;.00nan;0;0
1344;5298;55;52;38;5;33;.868;3600000;0
1344;31021;38;20;20;6;14;.700;3542000;0
1344;34770;55;0;0;0;0;.00nan;0;0
1345;1486;43;0;0;0;0;.00nan;0;0
1345;3625;43;64;19;2;17;.895;3900000;0
1345;6081;56;67;27;2;25;.926;3900000;0
1345;26824;56;0;0;0;0;.00nan;0;0
1346;2796;59;0;0;0;0;.00nan;0;0
1346;28772;53;44;10;2;8;.800;916000;0
1346;31156;53;17;27;7;20;.741;2684000;0
1346;31858;59;64;27;3;24;.889;3600000;0
1347;780;52;0;0;0;0;.00nan;0;0
1347;5137;58;0;0;0;0;.00nan;0;0
1347;14321;58;75;21;1;20;.952;3600000;0
1347;23255;52;78;37;3;34;.919;3582000;0
1348;2163;39;0;0;0;0;.00nan;0;0
1348;2900;36;67;20;1;19;.950;3551000;0
1348;9238;39;100;33;0;33;1.000;3600000;0
1348;14874;36;0;0;0;0;.00nan;0;0
1349;37;46;71;36;4;32;.889;3600000;0
1349;2296;37;87;21;1;20;.952;3600000;0
1349;2553;46;0;0;0;0;.00nan;0;0
1349;5883;37;0;0;0;0;.00nan;0;0
1350;4447;54;62;16;1;15;.938;3600000;0
1350;5146;64;0;0;0;0;.00nan;0;0
1350;28845;64;66;34;4;30;.882;3600000;0
1350;31643;54;0;0;0;0;.00nan;0;0
1351;3;50;0;0;0;0;.00nan;0;0
1351;5048;50;50;24;3;21;.875;3600000;0
1351;34788;42;58;35;4;31;.886;3582000;0
1351;37416;42;0;0;0;0;.00nan;0;0
1352;4716;4619;0;0;0;0;.00nan;0;0
1352;20717;60;96;31;1;30;.968;3600000;0
1352;35210;4619;48;44;6;38;.864;3600000;0
1352;35536;60;0;0;0;0;.00nan;0;0
1353;2152;49;0;0;0;0;.00nan;0;0
1353;4435;49;98;22;0;22;1.000;3600000;0
1353;7049;47;49;11;2;9;.818;1043000;0
1353;33654;47;23;22;6;16;.727;2557000;0
1354;6572;62;0;0;0;0;.00nan;0;0
1354;14351;40;0;0;0;0;.00nan;0;0
1354;26840;40;99;27;0;27;1.000;3600000;0
1354;26919;62;65;20;1;19;.950;3567000;0
1355;2016;61;41;21;4;17;.810;3600000;0
1355;3626;48;82;26;1;25;.962;3600000;0
1355;30971;61;0;0;0;0;.00nan;0;0
1355;38547;48;0;0;0;0;.00nan;0;0
1356;1592;63;62;41;4;37;.902;3600000;0
1356;2163;39;0;0;0;0;.00nan;0;0
1356;9238;39;72;21;1;20;.952;3600000;0
1356;26967;63;0;0;0;0;.00nan;0;0
1357;4338;65;0;0;0;0;.00nan;0;0
1357;4987;65;83;26;1;25;.962;3600000;0
1357;19640;41;0;0;0;0;.00nan;0;0
1357;23075;41;79;40;3;37;.925;3515000;0
1358;780;52;96;22;0;22;1.000;3600000;0
1358;5137;58;83;43;3;40;.930;3600000;0
1358;14321;58;0;0;0;0;.00nan;0;0
1358;23255;52;0;0;0;0;.00nan;0;0
1359;2900;36;0;0;0;0;.00nan;0;0
1359;5298;55;0;0;0;0;.00nan;0;0
1359;14874;36;88;32;1;31;.969;3600000;0
1359;34770;55;33;34;7;27;.794;3600000;0
1360;1486;43;29;21;5;16;.762;3600000;0
1360;3625;43;0;0;0;0;.00nan;0;0
1360;6081;56;0;0;0;0;.00nan;0;0
1360;26824;56;74;33;3;30;.909;3600000;0
1361;3;50;90;19;0;19;1.000;3600000;0
1361;5048;50;0;0;0;0;.00nan;0;0
1361;34788;42;0;0;0;0;.00nan;0;0
1361;37416;42;48;35;5;30;.857;3600000;0
1362;3847;38;41;24;5;19;.792;3900000;0
1362;23493;51;0;0;0;0;.00nan;0;0
1362;31021;38;0;0;0;0;.00nan;0;0
1362;31822;51;56;38;5;33;.868;3900000;0
1363;8046;57;0;0;0;0;.00nan;0;0
1363;26865;57;100;33;0;33;1.000;3600000;0
1363;28772;53;0;0;0;0;.00nan;0;0
1363;31156;53;76;23;1;22;.957;3593000;0
1364;4447;54;0;0;0;0;.00nan;0;0
1364;5146;64;84;43;3;40;.930;3600000;0
1364;28845;64;0;0;0;0;.00nan;0;0
1364;31643;54;39;18;4;14;.778;3568000;0
1365;2152;49;0;0;0;0;.00nan;0;0
1365;4435;49;88;31;1;30;.968;3600000;0
1365;6572;62;68;25;2;23;.920;3557000;0
1365;26919;62;0;0;0;0;.00nan;0;0
1366;4716;4619;91;31;1;30;.968;3600000;0
1366;20717;60;0;0;0;0;.00nan;0;0
1366;35210;4619;0;0;0;0;.00nan;0;0
1366;35536;60;55;25;3;22;.880;3543000;0
1367;7049;47;87;24;2;22;.917;3600000;0
1367;14351;40;65;4;0;4;1.000;317000;0
1367;26840;40;58;39;6;33;.846;3283000;0
1367;33654;47;0;0;0;0;.00nan;0;0
1368;376;45;62;36;4;32;.889;3600000;0
1368;1051;44;72;33;3;30;.909;3600000;0
1368;2198;45;0;0;0;0;.00nan;0;0
1368;3281;44;0;0;0;0;.00nan;0;0
1369;780;52;78;24;1;23;.958;3600000;0
1369;23255;52;0;0;0;0;.00nan;0;0
1369;23493;51;85;34;2;32;.941;3556000;0
1369;31822;51;0;0;0;0;.00nan;0;0
1370;37;46;76;23;1;22;.957;3600000;0
1370;2296;37;0;0;0;0;.00nan;0;0
1370;2553;46;0;0;0;0;.00nan;0;0
1370;5883;37;61;27;3;24;.889;3556000;0
1371;3847;38;0;0;0;0;.00nan;0;0
1371;5137;58;0;0;0;0;.00nan;0;0
1371;14321;58;95;42;2;40;.952;3625000;0
1371;31021;38;80;29;3;26;.897;3625000;0
1372;2796;59;0;0;0;0;.00nan;0;0
1372;8046;57;76;33;3;30;.909;3550000;0
1372;26865;57;0;0;0;0;.00nan;0;0
1372;31858;59;66;19;1;18;.947;3600000;0
1373;1486;43;0;0;0;0;.00nan;0;0
1373;1592;63;0;0;0;0;.00nan;0;0
1373;3625;43;100;51;1;50;.980;3900000;0
1373;26967;63;73;22;1;21;.955;3900000;0
1374;376;45;0;0;0;0;.00nan;0;0
1374;1051;44;0;0;0;0;.00nan;0;0
1374;2198;45;63;27;3;24;.889;3579000;0
1374;3281;44;72;25;2;23;.920;3600000;0
1375;2016;61;0;0;0;0;.00nan;0;0
1375;3626;48;85;33;2;31;.939;3820000;0
1375;30971;61;70;33;3;30;.909;3820000;0
1375;38547;48;0;0;0;0;.00nan;0;0
1376;2900;36;100;51;0;51;1.000;3600000;0
1376;4338;65;80;29;2;27;.931;3576000;0
1376;4987;65;0;0;0;0;.00nan;0;0
1376;14874;36;0;0;0;0;.00nan;0;0
1377;2163;39;0;0;0;0;.00nan;0;0
1377;6081;56;92;36;1;35;.972;3600000;0
1377;9238;39;52;16;2;14;.875;3600000;0
1377;26824;56;0;0;0;0;.00nan;0;0
1378;37;46;0;0;0;0;.00nan;0;0
1378;2553;46;81;25;2;23;.920;3600000;0
1378;5146;64;0;0;0;0;.00nan;0;0
1378;28845;64;74;36;3;33;.917;3557000;0
1379;2796;59;0;0;0;0;.00nan;0;0
1379;8046;57;75;15;0;15;1.000;1570000;0
1379;26865;57;61;32;5;27;.844;2030000;0
1379;31858;59;100;34;0;34;1.000;3600000;0
1380;1592;63;65;36;4;32;.889;3600000;0
1380;23493;51;0;0;0;0;.00nan;0;0
1380;26967;63;0;0;0;0;.00nan;0;0
1380;31822;51;43;30;5;25;.833;3600000;0
1381;4716;4619;82;45;4;41;.911;3600000;0
1381;7049;47;0;0;0;0;.00nan;0;0
1381;33654;47;40;29;5;24;.828;3571000;0
1381;35210;4619;0;0;0;0;.00nan;0;0
1382;376;45;83;24;1;23;.958;3900000;0
1382;2198;45;0;0;0;0;.00nan;0;0
1382;34788;42;0;0;0;0;.00nan;0;0
1382;37416;42;87;33;1;32;.970;3900000;0
1383;3626;48;93;50;3;47;.940;3900000;0
1383;7049;47;0;0;0;0;.00nan;0;0
1383;33654;47;58;25;3;22;.880;3900000;0
1383;38547;48;0;0;0;0;.00nan;0;0
1384;2796;59;0;0;0;0;.00nan;0;0
1384;28772;53;0;0;0;0;.00nan;0;0
1384;31156;53;92;20;0;20;1.000;3600000;0
1384;31858;59;80;47;4;43;.915;3600000;0
1385;1486;43;0;0;0;0;.00nan;0;0
1385;2900;36;78;34;2;32;.941;3591000;0
1385;3625;43;100;28;0;28;1.000;3600000;0
1385;14874;36;0;0;0;0;.00nan;0;0
1386;5298;55;75;30;2;28;.933;3600000;0
1386;8046;57;0;0;0;0;.00nan;0;0
1386;26865;57;42;37;6;31;.838;3600000;0
1386;34770;55;0;0;0;0;.00nan;0;0
1387;1592;63;0;0;0;0;.00nan;0;0
1387;6081;56;0;0;0;0;.00nan;0;0
1387;26824;56;86;14;0;14;1.000;3600000;0
1387;26967;63;50;31;5;26;.839;3600000;0
1388;2163;39;0;0;0;0;.00nan;0;0
1388;9238;39;81;21;1;20;.952;3600000;0
1388;23493;51;0;0;0;0;.00nan;0;0
1388;31822;51;80;35;2;33;.943;3542000;0
1389;3847;38;0;0;0;0;.00nan;0;0
1389;19640;41;0;0;0;0;.00nan;0;0
1389;23075;41;82;27;2;25;.926;3853000;0
1389;31021;38;70;30;3;27;.900;3853000;0
1390;4447;54;0;0;0;0;.00nan;0;0
1390;5146;64;81;37;3;34;.919;3538000;0
1390;28845;64;0;0;0;0;.00nan;0;0
1390;31643;54;88;24;1;23;.958;3600000;0
1391;4716;4619;60;37;5;32;.865;3546000;0
1391;20717;60;47;28;4;24;.857;3600000;0
1391;35210;4619;0;0;0;0;.00nan;0;0
1391;35536;60;0;0;0;0;.00nan;0;0
1392;1051;44;65;25;2;23;.920;3600000;0
1392;3281;44;0;0;0;0;.00nan;0;0
1392;6572;62;0;0;0;0;.00nan;0;0
1392;26919;62;54;30;4;26;.867;3580000;0
1393;2016;61;65;24;2;22;.917;3600000;0
1393;2152;49;0;0;0;0;.00nan;0;0
1393;4435;49;82;40;3;37;.925;3600000;0
1393;30971;61;0;0;0;0;.00nan;0;0
1394;2163;39;83;16;0;16;1.000;3600000;0
1394;9238;39;0;0;0;0;.00nan;0;0
1394;23493;51;79;49;5;44;.898;3600000;0
1394;31822;51;0;0;0;0;.00nan;0;0
1395;3;50;54;27;4;23;.852;3575000;0
1395;2296;37;0;0;0;0;.00nan;0;0
1395;5048;50;0;0;0;0;.00nan;0;0
1395;5883;37;83;33;2;31;.939;3600000;0
1396;1592;63;93;28;1;27;.964;3600000;0
1396;6081;56;0;0;0;0;.00nan;0;0
1396;26824;56;87;37;2;35;.946;3600000;0
1396;26967;63;0;0;0;0;.00nan;0;0
1397;19640;41;61;27;3;24;.889;3579000;0
1397;23075;41;0;0;0;0;.00nan;0;0
1397;28772;53;0;0;0;0;.00nan;0;0
1397;31156;53;81;31;2;29;.935;3600000;0
1398;780;52;0;0;0;0;.00nan;0;0
1398;3847;38;83;28;1;27;.964;3900000;0
1398;31021;38;0;0;0;0;.00nan;0;0
1398;32146;52;85;33;1;32;.970;3900000;0
1399;1486;43;0;0;0;0;.00nan;0;0
1399;3625;43;27;27;6;21;.778;3670000;0
1399;4338;65;60;37;5;32;.865;3670000;0
1399;4987;65;0;0;0;0;.00nan;0;0
1400;37;46;70;32;3;29;.906;3600000;0
1400;2553;46;0;0;0;0;.00nan;0;0
1400;4447;54;31;28;6;22;.786;3237000;0
1400;31643;54;58;6;0;6;1.000;363000;0
1401;2900;36;0;0;0;0;.00nan;0;0
1401;8046;57;76;24;1;23;.958;3600000;0
1401;14874;36;52;29;4;25;.862;3600000;0
1401;26865;57;0;0;0;0;.00nan;0;0
1402;2796;59;48;36;5;31;.861;3600000;0
1402;5137;58;0;0;0;0;.00nan;0;0
1402;14321;58;67;32;3;29;.906;3600000;0
1402;31858;59;0;0;0;0;.00nan;0;0
1403;376;45;0;0;0;0;.00nan;0;0
1403;2198;45;82;39;3;36;.923;3559000;0
1403;34788;42;0;0;0;0;.00nan;0;0
1403;37416;42;85;42;2;40;.952;3600000;0
1404;4716;4619;0;0;0;0;.00nan;0;0
1404;14351;40;33;27;6;21;.778;2219000;0
1404;26840;40;36;6;2;4;.667;1381000;0
1404;35210;4619;75;30;2;28;.933;3600000;0
1405;1051;44;0;0;0;0;.00nan;0;0
1405;3281;44;89;29;2;27;.931;3854000;0
1405;6572;62;73;34;3;31;.912;3854000;0
1405;26919;62;0;0;0;0;.00nan;0;0
1406;3626;48;0;0;0;0;.00nan;0;0
1406;7049;47;65;30;3;27;.900;3600000;0
1406;33654;47;0;0;0;0;.00nan;0;0
1406;38547;48;31;29;6;23;.793;3600000;0
1407;2016;61;0;0;0;0;.00nan;0;0
1407;2152;49;60;30;4;26;.867;3900000;0
1407;4435;49;0;0;0;0;.00nan;0;0
1407;30971;61;82;36;4;32;.889;3900000;0
1408;5137;58;40;32;5;27;.844;3600000;0
1408;14321;58;0;0;0;0;.00nan;0;0
1408;19640;41;0;0;0;0;.00nan;0;0
1408;23075;41;72;24;2;22;.917;3600000;0
1409;780;52;87;26;1;25;.962;3897000;0
1409;28772;53;90;37;1;36;.973;3900000;0
1409;31156;53;0;0;0;0;.00nan;0;0
1409;32146;52;0;0;0;0;.00nan;0;0
1410;3;50;0;0;0;0;.00nan;0;0
1410;2296;37;64;36;3;33;.917;3600000;0
1410;5048;50;32;29;5;24;.828;3553000;0
1410;5883;37;0;0;0;0;.00nan;0;0
1411;37;46;0;0;0;0;.00nan;0;0
1411;2553;46;40;28;5;23;.821;3600000;0
1411;5146;64;0;0;0;0;.00nan;0;0
1411;28845;64;99;36;1;35;.972;3600000;0
1412;1486;43;40;29;5;24;.828;3600000;0
1412;3625;43;0;0;0;0;.00nan;0;0
1412;4338;65;0;0;0;0;.00nan;0;0
1412;4987;65;100;27;0;27;1.000;3600000;0
1413;14351;40;0;0;0;0;.00nan;0;0
1413;20717;60;87;15;0;15;1.000;3600000;0
1413;26840;40;68;36;3;33;.917;3600000;0
1413;35536;60;0;0;0;0;.00nan;0;0
1414;376;45;0;0;0;0;.00nan;0;0
1414;2198;45;78;36;3;33;.917;3687000;0
1414;4716;4619;94;35;2;33;.943;3687000;0
1414;35210;4619;0;0;0;0;.00nan;0;0
1415;2796;59;0;0;0;0;.00nan;0;0
1415;8046;57;0;0;0;0;.00nan;0;0
1415;26865;57;51;36;5;31;.861;3600000;0
1415;31858;59;71;36;4;32;.889;3600000;0
1416;2163;39;86;32;2;30;.938;3900000;0
1416;6081;56;86;46;2;44;.957;3900000;0
1416;9238;39;0;0;0;0;.00nan;0;0
1416;26824;56;0;0;0;0;.00nan;0;0
1417;376;45;53;20;2;18;.900;3550000;0
1417;2198;45;0;0;0;0;.00nan;0;0
1417;4716;4619;0;0;0;0;.00nan;0;0
1417;35210;4619;83;30;1;29;.967;3600000;0
1418;14351;40;65;33;3;30;.909;3600000;0
1418;20717;60;49;25;4;21;.840;3566000;0
1418;26840;40;0;0;0;0;.00nan;0;0
1418;35536;60;0;0;0;0;.00nan;0;0
1419;2152;49;0;0;0;0;.00nan;0;0
1419;3626;48;76;30;2;28;.933;3600000;0
1419;4435;49;58;30;4;26;.867;3558000;0
1419;38547;48;0;0;0;0;.00nan;0;0
1420;780;52;0;0;0;0;.00nan;0;0
1420;28772;53;0;0;0;0;.00nan;0;0
1420;31156;53;59;28;3;25;.893;3600000;0
1420;32146;52;61;36;4;32;.889;3572000;0
1421;2900;36;53;19;2;17;.895;3551000;0
1421;5298;55;0;0;0;0;.00nan;0;0
1421;14874;36;0;0;0;0;.00nan;0;0
1421;34770;55;87;30;1;29;.967;3600000;0
1422;1486;43;0;0;0;0;.00nan;0;0
1422;3625;43;62;21;2;19;.905;3600000;0
1422;6081;56;84;40;3;37;.925;3553000;0
1422;26824;56;0;0;0;0;.00nan;0;0
1423;3;50;0;0;0;0;.00nan;0;0
1423;37;46;86;24;1;23;.958;3600000;0
1423;2553;46;0;0;0;0;.00nan;0;0
1423;5048;50;79;34;2;32;.941;3600000;0
1424;2796;59;0;0;0;0;.00nan;0;0
1424;3847;38;0;0;0;0;.00nan;0;0
1424;31021;38;37;34;6;28;.824;3600000;0
1424;31858;59;87;36;3;33;.917;3600000;0
1425;4338;65;0;0;0;0;.00nan;0;0
1425;4987;65;90;32;1;31;.969;3600000;0
1425;5137;58;0;0;0;0;.00nan;0;0
1425;14321;58;84;34;2;32;.941;3584000;0
1426;1592;63;0;0;0;0;.00nan;0;0
1426;2163;39;0;0;0;0;.00nan;0;0
1426;9238;39;54;20;2;18;.900;3600000;0
1426;26967;63;75;28;3;25;.893;3600000;0
1427;2296;37;77;29;2;27;.931;3574000;0
1427;4447;54;0;0;0;0;.00nan;0;0
1427;5883;37;0;0;0;0;.00nan;0;0
1427;31643;54;76;19;1;18;.947;3600000;0
1428;6572;62;52;31;4;27;.871;3673000;0
1428;7049;47;0;0;0;0;.00nan;0;0
1428;26919;62;0;0;0;0;.00nan;0;0
1428;33654;47;63;36;5;31;.861;3673000;0
1429;2016;61;0;0;0;0;.00nan;0;0
1429;14351;40;25;29;6;23;.793;3600000;0
1429;26840;40;0;0;0;0;.00nan;0;0
1429;30971;61;76;29;2;27;.931;3600000;0
1430;1051;44;49;37;5;32;.865;3900000;0
1430;3281;44;0;0;0;0;.00nan;0;0
1430;3626;48;55;32;5;27;.844;3900000;0
1430;38547;48;0;0;0;0;.00nan;0;0
1431;376;45;0;0;0;0;.00nan;0;0
1431;2198;45;86;44;3;41;.932;3900000;0
1431;20717;60;0;0;0;0;.00nan;0;0
1431;35536;60;58;22;3;19;.864;3884000;0
1432;3533;57;100;33;0;33;1.000;3600000;0
1432;19640;41;0;0;0;0;.00nan;0;0
1432;23075;41;60;35;5;30;.857;3600000;0
1432;26865;57;0;0;0;0;.00nan;0;0
1433;2796;59;93;36;2;34;.944;3600000;0
1433;28772;53;67;30;3;27;.900;3544000;0
1433;31156;53;0;0;0;0;.00nan;0;0
1433;31858;59;0;0;0;0;.00nan;0;0
1434;780;52;87;32;2;30;.938;3600000;0
1434;5137;58;21;11;4;7;.636;767000;0
1434;14321;58;54;25;3;22;.880;2833000;0
1434;32146;52;0;0;0;0;.00nan;0;0
1435;3847;38;22;20;6;14;.700;1756000;0
1435;4338;65;74;40;4;36;.900;3600000;0
1435;4987;65;0;0;0;0;.00nan;0;0
1435;31021;38;51;10;1;9;.900;1844000;0
1436;2900;36;69;19;1;18;.947;3048000;0
1436;14874;36;31;10;3;7;.700;552000;0
1436;23493;51;56;18;2;16;.889;3600000;0
1436;31822;51;0;0;0;0;.00nan;0;0
1437;1486;43;93;20;0;20;1.000;3600000;0
1437;3625;43;0;0;0;0;.00nan;0;0
1437;6081;56;0;0;0;0;.00nan;0;0
1437;26824;56;97;37;1;36;.973;3579000;0
1438;5298;55;99;39;2;37;.949;3600000;0
1438;26967;63;0;0;0;0;.00nan;0;0
1438;31994;63;69;40;5;35;.875;3600000;0
1438;34770;55;0;0;0;0;.00nan;0;0
1439;3;50;84;34;3;31;.912;3900000;0
1439;4447;54;71;36;3;33;.917;3900000;0
1439;5048;50;0;0;0;0;.00nan;0;0
1439;31643;54;0;0;0;0;.00nan;0;0
1440;37;46;0;0;0;0;.00nan;0;0
1440;2553;46;79;36;2;34;.944;3600000;0
1440;34788;42;89;26;1;25;.962;3600000;0
1440;37416;42;0;0;0;0;.00nan;0;0
1441;2296;37;18;8;4;4;.500;480000;0
1441;5146;64;47;27;4;23;.852;3600000;0
1441;5883;37;33;28;6;22;.786;3120000;0
1441;28845;64;0;0;0;0;.00nan;0;0
1442;2016;61;44;17;3;14;.824;3600000;0
1442;14351;40;0;0;0;0;.00nan;0;0
1442;26840;40;56;37;5;32;.865;3560000;0
1442;30971;61;0;0;0;0;.00nan;0;0
1443;2152;49;0;0;0;0;.00nan;0;0
1443;4435;49;76;22;1;21;.955;3600000;0
1443;7049;47;50;25;4;21;.840;3600000;0
1443;33654;47;0;0;0;0;.00nan;0;0
1444;6572;62;0;0;0;0;.00nan;0;0
1444;26919;62;77;27;1;26;.963;3600000;0
1444;35210;4619;0;0;0;0;.00nan;0;0
1444;40296;4619;40;18;3;15;.833;3514000;0
1445;1051;44;0;0;0;0;.00nan;0;0
1445;3281;44;63;22;2;20;.909;3600000;0
1445;3626;48;0;0;0;0;.00nan;0;0
1445;38547;48;45;26;4;22;.846;3583000;0
1446;3533;57;35;21;4;17;.810;1184000;0
1446;19640;41;69;17;1;16;.941;3600000;0
1446;23075;41;0;0;0;0;.00nan;0;0
1446;26865;57;69;22;2;20;.909;2416000;0
1447;780;52;0;0;0;0;.00nan;0;0
1447;28772;53;0;0;0;0;.00nan;0;0
1447;31156;53;42;33;5;28;.848;3600000;0
1447;32146;52;52;24;4;20;.833;3600000;0
1448;4338;65;0;0;0;0;.00nan;0;0
1448;4987;65;48;36;5;31;.861;3900000;0
1448;5137;58;45;28;5;23;.821;3900000;0
1448;14321;58;0;0;0;0;.00nan;0;0
1449;4447;54;0;0;0;0;.00nan;0;0
1449;5146;64;0;0;0;0;.00nan;0;0
1449;28845;64;70;24;2;22;.917;3600000;0
1449;31643;54;80;34;3;31;.912;3600000;0
1450;5298;55;0;0;0;0;.00nan;0;0
1450;23493;51;46;12;2;10;.833;3892000;0
1450;31822;51;0;0;0;0;.00nan;0;0
1450;34770;55;53;24;3;21;.875;3892000;0
1451;2296;37;72;39;4;35;.897;3600000;0
1451;5883;37;0;0;0;0;.00nan;0;0
1451;34788;42;0;0;0;0;.00nan;0;0
1451;37416;42;70;28;2;26;.929;3600000;0
1452;2152;49;100;35;1;34;.971;3600000;0
1452;4435;49;0;0;0;0;.00nan;0;0
1452;35210;4619;55;43;6;37;.860;3600000;0
1452;40296;4619;0;0;0;0;.00nan;0;0
1453;376;45;63;36;5;31;.861;3600000;0
1453;2198;45;0;0;0;0;.00nan;0;0
1453;20717;60;91;39;1;38;.974;3600000;0
1453;35536;60;0;0;0;0;.00nan;0;0
1454;3533;57;0;0;0;0;.00nan;0;0
1454;4338;65;95;39;2;37;.949;3600000;0
1454;4987;65;0;0;0;0;.00nan;0;0
1454;26865;57;56;31;4;27;.871;3529000;0
1455;780;52;0;0;0;0;.00nan;0;0
1455;2900;36;41;31;5;26;.839;3516000;0
1455;14874;36;0;0;0;0;.00nan;0;0
1455;32146;52;67;31;3;28;.903;3600000;0
1456;3847;38;0;0;0;0;.00nan;0;0
1456;5137;58;0;0;0;0;.00nan;0;0
1456;14321;58;51;36;5;31;.861;3600000;0
1456;31021;38;85;28;1;27;.964;3600000;0
1457;2163;39;60;36;4;32;.889;3600000;0
1457;2796;59;0;0;0;0;.00nan;0;0
1457;9238;39;0;0;0;0;.00nan;0;0
1457;31858;59;54;35;5;30;.857;3584000;0
1458;6081;56;54;29;4;25;.862;3600000;0
1458;23493;51;0;0;0;0;.00nan;0;0
1458;26824;56;0;0;0;0;.00nan;0;0
1458;31822;51;53;21;3;18;.857;3600000;0
1459;2296;37;75;27;2;25;.926;3600000;0
1459;4447;54;0;0;0;0;.00nan;0;0
1459;5883;37;0;0;0;0;.00nan;0;0
1459;31643;54;54;26;3;23;.885;3543000;0
1460;3;50;0;0;0;0;.00nan;0;0
1460;5048;50;63;24;2;22;.917;3583000;0
1460;34788;42;97;32;1;31;.969;3600000;0
1460;37416;42;0;0;0;0;.00nan;0;0
1461;7049;47;59;24;3;21;.875;3546000;0
1461;14351;40;73;25;2;23;.920;3600000;0
1461;26840;40;0;0;0;0;.00nan;0;0
1461;33654;47;0;0;0;0;.00nan;0;0
1462;3626;48;75;33;3;30;.909;3726000;0
1462;6572;62;0;0;0;0;.00nan;0;0
1462;26919;62;97;38;2;36;.947;3726000;0
1462;38547;48;0;0;0;0;.00nan;0;0
1463;2900;36;0;0;0;0;.00nan;0;0
1463;5298;55;67;29;2;27;.931;3600000;0
1463;14874;36;72;36;3;33;.917;3589000;0
1463;34770;55;0;0;0;0;.00nan;0;0
1464;780;52;73;24;1;23;.958;3792000;0
1464;23493;51;75;25;2;23;.920;3792000;0
1464;31822;51;0;0;0;0;.00nan;0;0
1464;32146;52;0;0;0;0;.00nan;0;0
1465;37;46;79;38;4;34;.895;3600000;0
1465;2296;37;0;0;0;0;.00nan;0;0
1465;2553;46;0;0;0;0;.00nan;0;0
1465;5883;37;25;24;6;18;.750;3600000;0
1466;3847;38;0;0;0;0;.00nan;0;0
1466;8046;57;87;30;1;29;.967;3600000;0
1466;26865;57;0;0;0;0;.00nan;0;0
1466;31021;38;73;33;2;31;.939;3600000;0
1467;2796;59;0;0;0;0;.00nan;0;0
1467;19640;41;0;0;0;0;.00nan;0;0
1467;23075;41;67;35;3;32;.914;3600000;0
1467;31858;59;45;31;5;26;.839;3575000;0
1468;5137;58;0;0;0;0;.00nan;0;0
1468;14321;58;73;32;2;30;.938;3600000;0
1468;28772;53;0;0;0;0;.00nan;0;0
1468;31156;53;74;34;3;31;.912;3551000;0
1469;1486;43;89;34;2;32;.941;3600000;0
1469;2163;39;81;25;1;24;.960;3600000;0
1469;3625;43;0;0;0;0;.00nan;0;0
1469;9238;39;0;0;0;0;.00nan;0;0
1470;5146;64;73;37;4;33;.892;3600000;0
1470;28845;64;0;0;0;0;.00nan;0;0
1470;34788;42;0;0;0;0;.00nan;0;0
1470;37416;42;64;30;3;27;.900;3600000;0
1471;376;45;0;0;0;0;.00nan;0;0
1471;2198;45;78;28;1;27;.964;3600000;0
1471;35210;4619;0;0;0;0;.00nan;0;0
1471;40296;4619;48;19;3;16;.842;3540000;0
1472;1051;44;0;0;0;0;.00nan;0;0
1472;2152;49;0;0;0;0;.00nan;0;0
1472;3281;44;68;24;2;22;.917;3600000;0
1472;4435;49;50;22;3;19;.864;3589000;0
1473;6572;62;0;0;0;0;.00nan;0;0
1473;7049;47;100;31;0;31;1.000;3600000;0
1473;26919;62;74;36;3;33;.917;3600000;0
1473;33654;47;0;0;0;0;.00nan;0;0
1474;3626;48;52;36;5;31;.861;3591000;0
1474;14351;40;0;0;0;0;.00nan;0;0
1474;26840;40;52;22;3;19;.864;3600000;0
1474;38547;48;0;0;0;0;.00nan;0;0
1475;2016;61;0;0;0;0;.00nan;0;0
1475;20717;60;93;36;1;35;.972;3600000;0
1475;30971;61;80;31;2;29;.935;3574000;0
1475;35536;60;0;0;0;0;.00nan;0;0
1476;5298;55;0;0;0;0;.00nan;0;0
1476;23493;51;78;27;2;25;.926;3600000;0
1476;31822;51;0;0;0;0;.00nan;0;0
1476;34770;55;42;23;4;19;.826;3525000;0
1477;2796;59;100;42;1;41;.976;3600000;0
1477;19640;41;0;0;0;0;.00nan;0;0
1477;23075;41;62;28;3;25;.893;3600000;0
1477;31858;59;0;0;0;0;.00nan;0;0
1478;1486;43;0;0;0;0;.00nan;0;0
1478;2163;39;0;0;0;0;.00nan;0;0
1478;3625;43;95;42;2;40;.952;3600000;0
1478;9238;39;62;34;3;31;.912;3586000;0
1479;2900;36;60;37;4;33;.892;3560000;0
1479;4338;65;98;42;2;40;.952;3600000;0
1479;4987;65;0;0;0;0;.00nan;0;0
1479;14874;36;0;0;0;0;.00nan;0;0
1480;780;52;0;0;0;0;.00nan;0;0
1480;6081;56;85;35;2;33;.943;3900000;0
1480;26824;56;0;0;0;0;.00nan;0;0
1480;32146;52;87;36;2;34;.944;3900000;0
1481;37;46;0;0;0;0;.00nan;0;0
1481;2296;37;85;47;3;44;.936;3566000;0
1481;2553;46;60;22;2;20;.909;3600000;0
1481;5883;37;0;0;0;0;.00nan;0;0
1482;3;50;0;0;0;0;.00nan;0;0
1482;4447;54;0;0;0;0;.00nan;0;0
1482;5048;50;48;38;6;32;.842;3600000;0
1482;31643;54;94;45;3;42;.933;3600000;0
1483;3847;38;60;28;3;25;.893;3600000;0
1483;28772;53;67;33;4;29;.879;3587000;0
1483;31021;38;0;0;0;0;.00nan;0;0
1483;31156;53;0;0;0;0;.00nan;0;0
1484;5137;58;0;0;0;0;.00nan;0;0
1484;8046;57;0;0;0;0;.00nan;0;0
1484;14321;58;79;34;2;32;.941;3600000;0
1484;26865;57;77;39;4;35;.897;3547000;0
1485;5146;64;0;0;0;0;.00nan;0;0
1485;26967;63;72;31;3;28;.903;3537000;0
1485;28845;64;100;37;1;36;.973;3600000;0
1485;34814;63;0;0;0;0;.00nan;0;0
1486;376;45;83;29;1;28;.966;3600000;0
1486;2198;45;0;0;0;0;.00nan;0;0
1486;35210;4619;66;28;2;26;.929;3560000;0
1486;40296;4619;0;0;0;0;.00nan;0;0
1487;3626;48;0;0;0;0;.00nan;0;0
1487;14351;40;93;40;2;38;.950;3600000;0
1487;26840;40;0;0;0;0;.00nan;0;0
1487;38547;48;78;40;3;37;.925;3545000;0
1488;1051;44;64;23;2;21;.913;3845000;0
1488;2152;49;54;22;3;19;.864;3845000;0
1488;3281;44;0;0;0;0;.00nan;0;0
1488;4435;49;0;0;0;0;.00nan;0;0
1489;6572;62;85;34;2;32;.941;3600000;0
1489;7049;47;43;20;3;17;.850;3572000;0
1489;26919;62;0;0;0;0;.00nan;0;0
1489;33654;47;0;0;0;0;.00nan;0;0
1490;5298;55;100;32;0;32;1.000;3600000;0
1490;6081;56;0;0;0;0;.00nan;0;0
1490;26824;56;73;34;2;32;.941;3600000;0
1490;34770;55;0;0;0;0;.00nan;0;0
1491;5146;64;100;30;0;30;1.000;3600000;0
1491;26967;63;0;0;0;0;.00nan;0;0
1491;28845;64;0;0;0;0;.00nan;0;0
1491;34814;63;47;27;4;23;.852;3600000;0
1492;3;50;91;33;1;32;.970;3600000;0
1492;4447;54;0;0;0;0;.00nan;0;0
1492;5048;50;0;0;0;0;.00nan;0;0
1492;31643;54;54;30;4;26;.867;3600000;0
1493;4338;65;0;0;0;0;.00nan;0;0
1493;4987;65;57;37;5;32;.865;3557000;0
1493;19640;41;0;0;0;0;.00nan;0;0
1493;23075;41;49;30;4;26;.867;3600000;0
1494;2016;61;0;0;0;0;.00nan;0;0
1494;20717;60;83;28;1;27;.964;3600000;0
1494;30971;61;72;37;3;34;.919;3584000;0
1494;35536;60;0;0;0;0;.00nan;0;0
1495;37;46;55;22;3;19;.864;3600000;0
1495;2553;46;0;0;0;0;.00nan;0;0
1495;5146;64;41;44;8;36;.818;3600000;0
1495;28845;64;0;0;0;0;.00nan;0;0
1496;780;52;0;0;0;0;.00nan;0;0
1496;28772;53;0;0;0;0;.00nan;0;0
1496;31156;53;83;33;2;31;.939;3852000;0
1496;32146;52;100;39;1;38;.974;3852000;0
1497;23493;51;60;29;3;26;.897;3600000;0
1497;26967;63;40;34;5;29;.853;3543000;0
1497;31822;51;0;0;0;0;.00nan;0;0
1497;34814;63;0;0;0;0;.00nan;0;0
1498;1486;43;72;18;1;17;.944;3600000;0
1498;2900;36;0;0;0;0;.00nan;0;0
1498;3625;43;0;0;0;0;.00nan;0;0
1498;14874;36;52;33;5;28;.848;3600000;0
1499;8046;57;73;36;2;34;.944;3560000;0
1499;19640;41;0;0;0;0;.00nan;0;0
1499;23075;41;64;14;1;13;.929;3600000;0
1499;26865;57;0;0;0;0;.00nan;0;0
1500;2163;39;92;22;0;22;1.000;3600000;0
1500;5298;55;60;29;4;25;.862;3600000;0
1500;9238;39;0;0;0;0;.00nan;0;0
1500;34770;55;0;0;0;0;.00nan;0;0
1501;7049;47;0;0;0;0;.00nan;0;0
1501;20717;60;71;18;2;16;.889;3900000;0
1501;33654;47;93;44;2;42;.955;3900000;0
1501;35536;60;0;0;0;0;.00nan;0;0
1502;2296;37;0;0;0;0;.00nan;0;0
1502;4447;54;0;0;0;0;.00nan;0;0
1502;5883;37;60;42;5;37;.881;3562000;0
1502;31643;54;46;20;3;17;.850;3600000;0
1503;1486;43;68;21;1;20;.952;3600000;0
1503;2900;36;0;0;0;0;.00nan;0;0
1503;3625;43;0;0;0;0;.00nan;0;0
1503;14874;36;72;36;4;32;.889;3600000;0
1504;5298;55;0;0;0;0;.00nan;0;0
1504;19640;41;0;0;0;0;.00nan;0;0
1504;23075;41;71;27;3;24;.889;3600000;0
1504;34770;55;58;33;4;29;.879;3569000;0
1505;3847;38;0;0;0;0;.00nan;0;0
1505;28772;53;0;0;0;0;.00nan;0;0
1505;31021;38;52;20;3;17;.850;3725000;0
1505;31156;53;61;33;4;29;.879;3725000;0
1506;2796;59;80;39;3;36;.923;3600000;0
1506;5137;58;0;0;0;0;.00nan;0;0
1506;14321;58;34;26;5;21;.808;3513000;0
1506;31858;59;0;0;0;0;.00nan;0;0
1507;2163;39;70;30;2;28;.933;3900000;0
1507;8046;57;0;0;0;0;.00nan;0;0
1507;9238;39;0;0;0;0;.00nan;0;0
1507;26865;57;90;36;2;34;.944;3900000;0
1508;2296;37;62;25;3;22;.880;3600000;0
1508;4447;54;0;0;0;0;.00nan;0;0
1508;5883;37;0;0;0;0;.00nan;0;0
1508;31643;54;95;23;0;23;1.000;3600000;0
1509;5146;64;89;37;3;34;.919;3600000;0
1509;28845;64;0;0;0;0;.00nan;0;0
1509;34788;42;57;26;4;22;.846;3245000;0
1509;37416;42;50;1;0;1;1.000;329000;0
1510;37;46;0;0;0;0;.00nan;0;0
1510;376;45;0;0;0;0;.00nan;0;0
1510;2198;45;89;47;4;43;.915;3900000;0
1510;2553;46;59;26;4;22;.846;3900000;0
1511;3;50;0;0;0;0;.00nan;0;0
1511;1051;44;91;37;2;35;.946;3900000;0
1511;3281;44;0;0;0;0;.00nan;0;0
1511;5048;50;66;17;2;15;.882;3899000;0
1512;3626;48;61;35;4;31;.886;3560000;0
1512;10698;4619;0;0;0;0;.00nan;0;0
1512;35210;4619;76;31;2;29;.935;3600000;0
1512;38547;48;0;0;0;0;.00nan;0;0
1513;6572;62;0;0;0;0;.00nan;0;0
1513;20717;60;59;20;2;18;.900;3682000;0
1513;26919;62;92;37;3;34;.919;3682000;0
1513;35536;60;0;0;0;0;.00nan;0;0
1514;2016;61;0;0;0;0;.00nan;0;0
1514;7049;47;0;0;0;0;.00nan;0;0
1514;30971;61;100;29;0;29;1.000;3600000;0
1514;33654;47;78;30;2;28;.933;3550000;0
1515;1592;63;27;7;3;4;.571;354000;0
1515;8046;57;84;28;1;27;.964;3600000;0
1515;26865;57;0;0;0;0;.00nan;0;0
1515;34814;63;97;27;0;27;1.000;3237000;0
1516;6572;62;15;6;4;2;.333;427000;0
1516;20717;60;0;0;0;0;.00nan;0;0
1516;26919;62;75;31;2;29;.935;3173000;0
1516;35536;60;64;30;3;27;.900;3600000;0
1517;4338;65;79;23;1;22;.957;3600000;0
1517;4987;65;0;0;0;0;.00nan;0;0
1517;28772;53;90;39;3;36;.923;3590000;0
1517;31156;53;0;0;0;0;.00nan;0;0
1518;2163;39;0;0;0;0;.00nan;0;0
1518;5298;55;90;27;1;26;.963;3600000;0
1518;9238;39;76;38;4;34;.895;3600000;0
1518;34770;55;0;0;0;0;.00nan;0;0
1519;6081;56;92;32;1;31;.969;3600000;0
1519;23493;51;16;24;6;18;.750;3600000;0
1519;26824;56;0;0;0;0;.00nan;0;0
1519;31822;51;0;0;0;0;.00nan;0;0
1520;2796;59;0;0;0;0;.00nan;0;0
1520;3847;38;48;25;3;22;.880;3600000;0
1520;31021;38;0;0;0;0;.00nan;0;0
1520;31858;59;67;24;2;22;.917;3600000;0
1521;780;52;0;0;0;0;.00nan;0;0
1521;5137;58;41;21;5;16;.762;3578000;0
1521;14321;58;0;0;0;0;.00nan;0;0
1521;32146;52;64;34;4;30;.882;3600000;0
1522;5146;64;0;0;0;0;.00nan;0;0
1522;28845;64;81;29;1;28;.966;3600000;0
1522;34788;42;0;0;0;0;.00nan;0;0
1522;37416;42;60;22;2;20;.909;3571000;0
1523;37;46;57;28;3;25;.893;3900000;0
1523;376;45;61;34;3;31;.912;3900000;0
1523;2198;45;0;0;0;0;.00nan;0;0
1523;2553;46;0;0;0;0;.00nan;0;0
1524;3626;48;0;0;0;0;.00nan;0;0
1524;10698;4619;75;24;2;22;.917;3600000;0
1524;35210;4619;0;0;0;0;.00nan;0;0
1524;38547;48;71;39;3;36;.923;3555000;0
1525;3;50;0;0;0;0;.00nan;0;0
1525;1051;44;51;22;3;19;.864;3900000;0
1525;3281;44;0;0;0;0;.00nan;0;0
1525;5048;50;59;25;3;22;.880;3900000;0
1526;780;52;50;26;4;22;.846;3895000;0
1526;5137;58;0;0;0;0;.00nan;0;0
1526;14321;58;59;36;4;32;.889;3900000;0
1526;32146;52;0;0;0;0;.00nan;0;0
1527;2296;37;0;0;0;0;.00nan;0;0
1527;4447;54;0;0;0;0;.00nan;0;0
1527;5883;37;80;43;3;40;.930;3692000;0
1527;31643;54;65;27;2;25;.926;3692000;0
1528;1486;43;64;19;2;17;.895;3013000;0
1528;1592;63;74;36;3;33;.917;3600000;0
1528;3625;43;22;4;3;1;.250;587000;0
1528;26967;63;0;0;0;0;.00nan;0;0
1529;4338;65;0;0;0;0;.00nan;0;0
1529;4987;65;65;23;2;21;.913;3526000;0
1529;19640;41;0;0;0;0;.00nan;0;0
1529;23075;41;90;20;0;20;1.000;3600000;0
1530;2152;49;44;26;5;21;.808;3600000;0
1530;4435;49;0;0;0;0;.00nan;0;0
1530;14351;40;100;27;0;27;1.000;3600000;0
1530;26840;40;0;0;0;0;.00nan;0;0
1531;2016;61;0;0;0;0;.00nan;0;0
1531;7049;47;87;38;3;35;.921;3900000;0
1531;30971;61;55;25;3;22;.880;3900000;0
1531;33654;47;0;0;0;0;.00nan;0;0
1532;2152;49;0;0;0;0;.00nan;0;0
1532;4435;49;78;20;2;18;.900;3541000;0
1532;14351;40;78;27;1;26;.963;3600000;0
1532;26840;40;0;0;0;0;.00nan;0;0
1533;2796;59;62;24;2;22;.917;3572000;0
1533;19640;41;0;0;0;0;.00nan;0;0
1533;23075;41;82;27;1;26;.963;3600000;0
1533;31858;59;0;0;0;0;.00nan;0;0
1534;780;52;59;37;5;32;.865;3600000;0
1534;5137;58;0;0;0;0;.00nan;0;0
1534;14321;58;100;28;0;28;1.000;3600000;0
1534;32146;52;0;0;0;0;.00nan;0;0
1535;3847;38;91;31;1;30;.968;3600000;0
1535;4338;65;47;17;3;14;.824;3542000;0
1535;4987;65;0;0;0;0;.00nan;0;0
1535;31021;38;0;0;0;0;.00nan;0;0
1536;2796;59;0;0;0;0;.00nan;0;0
1536;19640;41;62;23;3;20;.870;3567000;0
1536;23075;41;0;0;0;0;.00nan;0;0
1536;31858;59;83;35;2;33;.943;3600000;0
1537;2900;36;0;0;0;0;.00nan;0;0
1537;6081;56;89;40;2;38;.950;3561000;0
1537;14874;36;100;24;0;24;1.000;3600000;0
1537;26824;56;0;0;0;0;.00nan;0;0
1538;2163;39;65;25;2;23;.920;3600000;0
1538;5298;55;97;50;3;47;.940;3600000;0
1538;9238;39;0;0;0;0;.00nan;0;0
1538;34770;55;0;0;0;0;.00nan;0;0
1539;37;46;62;26;3;23;.885;3566000;0
1539;2553;46;0;0;0;0;.00nan;0;0
1539;4447;54;0;0;0;0;.00nan;0;0
1539;31643;54;69;22;2;20;.909;3600000;0
1540;6572;62;0;0;0;0;.00nan;0;0
1540;20717;60;16;19;6;13;.684;3016000;0
1540;26919;62;48;26;4;22;.846;3600000;0
1540;35536;60;44;3;1;2;.667;584000;0
1541;5137;58;0;0;0;0;.00nan;0;0
1541;14321;58;82;32;2;30;.938;3600000;0
1541;28772;53;0;0;0;0;.00nan;0;0
1541;31156;53;30;21;5;16;.762;3600000;0
1542;780;52;0;0;0;0;.00nan;0;0
1542;3847;38;0;0;0;0;.00nan;0;0
1542;31021;38;64;41;4;37;.902;3600000;0
1542;32146;52;100;34;0;34;1.000;3600000;0
1543;2900;36;0;0;0;0;.00nan;0;0
1543;3533;57;0;0;0;0;.00nan;0;0
1543;14874;36;76;25;1;24;.960;3600000;0
1543;26865;57;87;36;2;34;.944;3557000;0
1544;1486;43;0;0;0;0;.00nan;0;0
1544;1592;63;84;30;2;28;.933;3558000;0
1544;3625;43;81;25;1;24;.960;3600000;0
1544;34814;63;0;0;0;0;.00nan;0;0
1545;6081;56;42;19;4;15;.789;3548000;0
1545;23493;51;0;0;0;0;.00nan;0;0
1545;26824;56;0;0;0;0;.00nan;0;0
1545;31822;51;61;29;3;26;.897;3600000;0
1546;37;46;0;0;0;0;.00nan;0;0
1546;2553;46;89;31;2;29;.935;3600000;0
1546;5146;64;49;35;5;30;.857;3600000;0
1546;28845;64;0;0;0;0;.00nan;0;0
1547;2163;39;100;33;0;33;1.000;3600000;0
1547;4338;65;59;29;3;26;.897;3600000;0
1547;4987;65;0;0;0;0;.00nan;0;0
1547;9238;39;0;0;0;0;.00nan;0;0
1548;4447;54;0;0;0;0;.00nan;0;0
1548;31643;54;79;28;2;26;.929;3600000;0
1548;34788;42;59;31;3;28;.903;3599000;0
1548;37416;42;0;0;0;0;.00nan;0;0
1549;6572;62;38;16;3;13;.813;3213000;0
1549;20717;60;42;28;5;23;.821;3600000;0
1549;26919;62;25;5;3;2;.400;337000;0
1549;35536;60;0;0;0;0;.00nan;0;0
1550;1051;44;80;39;3;36;.923;3900000;0
1550;2016;61;0;0;0;0;.00nan;0;0
1550;3281;44;0;0;0;0;.00nan;0;0
1550;30971;61;77;31;3;28;.903;3900000;0
1551;10698;4619;0;0;0;0;.00nan;0;0
1551;14351;40;79;49;4;45;.918;3600000;0
1551;26840;40;0;0;0;0;.00nan;0;0
1551;35210;4619;80;24;1;23;.958;3600000;0
1552;2152;49;0;0;0;0;.00nan;0;0
1552;4435;49;62;20;2;18;.900;3600000;0
1552;7049;47;0;0;0;0;.00nan;0;0
1552;33654;47;49;27;4;23;.852;3535000;0
1553;5137;58;77;27;2;25;.926;3600000;0
1553;14321;58;0;0;0;0;.00nan;0;0
1553;28772;53;85;34;3;31;.912;3574000;0
1553;31156;53;0;0;0;0;.00nan;0;0
1554;376;45;0;0;0;0;.00nan;0;0
1554;2198;45;66;27;3;24;.889;3600000;0
1554;2296;37;0;0;0;0;.00nan;0;0
1554;5883;37;74;25;2;23;.920;3600000;0
1555;1486;43;0;0;0;0;.00nan;0;0
1555;1592;63;0;0;0;0;.00nan;0;0
1555;3625;43;70;26;2;24;.923;3761000;0
1555;34814;63;74;33;3;30;.909;3761000;0
1556;3;50;0;0;0;0;.00nan;0;0
1556;3626;48;80;26;1;25;.962;3600000;0
1556;5048;50;60;20;2;18;.900;3549000;0
1556;38547;48;0;0;0;0;.00nan;0;0
1557;10698;4619;80;17;1;16;.941;3600000;0
1557;14351;40;0;0;0;0;.00nan;0;0
1557;26840;40;68;30;2;28;.933;3573000;0
1557;35210;4619;0;0;0;0;.00nan;0;0
1558;5298;55;84;35;2;33;.943;3900000;0
1558;19640;41;0;0;0;0;.00nan;0;0
1558;23075;41;82;39;2;37;.949;3900000;0
1558;34770;55;0;0;0;0;.00nan;0;0
1559;2796;59;0;0;0;0;.00nan;0;0
1559;3847;38;65;23;2;21;.913;3600000;0
1559;31021;38;0;0;0;0;.00nan;0;0
1559;31858;59;83;37;3;34;.919;3581000;0
1560;2163;39;81;27;1;26;.963;3900000;0
1560;2900;36;83;26;1;25;.962;3900000;0
1560;9238;39;0;0;0;0;.00nan;0;0
1560;14874;36;0;0;0;0;.00nan;0;0
1561;6081;56;0;0;0;0;.00nan;0;0
1561;23493;51;85;19;0;19;1.000;3600000;0
1561;26824;56;82;41;3;38;.927;3600000;0
1561;31822;51;0;0;0;0;.00nan;0;0
1562;780;52;0;0;0;0;.00nan;0;0
1562;3533;57;92;34;2;32;.941;3600000;0
1562;26865;57;0;0;0;0;.00nan;0;0
1562;32146;52;68;40;5;35;.875;3600000;0
1563;5146;64;0;0;0;0;.00nan;0;0
1563;28845;64;75;52;5;47;.904;3600000;0
1563;34788;42;0;0;0;0;.00nan;0;0
1563;37416;42;46;27;4;23;.852;3600000;0
1564;2152;49;86;35;3;32;.914;3600000;0
1564;4435;49;0;0;0;0;.00nan;0;0
1564;20717;60;61;8;0;8;1.000;789000;0
1564;35536;60;23;27;6;21;.778;2811000;0
1565;1051;44;0;0;0;0;.00nan;0;0
1565;2016;61;75;23;1;22;.957;3600000;0
1565;3281;44;58;28;3;25;.893;3568000;0
1565;30971;61;0;0;0;0;.00nan;0;0
1566;6572;62;0;0;0;0;.00nan;0;0
1566;7049;47;82;33;2;31;.939;3600000;0
1566;26919;62;96;31;1;30;.968;3600000;0
1566;33654;47;0;0;0;0;.00nan;0;0
1567;5298;55;0;0;0;0;.00nan;0;0
1567;19640;41;74;30;2;28;.933;3600000;0
1567;23075;41;0;0;0;0;.00nan;0;0
1567;34770;55;57;26;3;23;.885;3559000;0
1568;376;45;67;29;3;26;.897;3600000;0
1568;2198;45;0;0;0;0;.00nan;0;0
1568;2296;37;54;26;4;22;.846;3600000;0
1568;5883;37;0;0;0;0;.00nan;0;0
1569;37;46;0;0;0;0;.00nan;0;0
1569;2553;46;62;26;3;23;.885;3588000;0
1569;5146;64;73;21;1;20;.952;3600000;0
1569;28845;64;0;0;0;0;.00nan;0;0
1570;3;50;47;24;4;20;.833;3600000;0
1570;3626;48;0;0;0;0;.00nan;0;0
1570;5048;50;0;0;0;0;.00nan;0;0
1570;38547;48;54;41;6;35;.854;3600000;0
1571;3533;57;0;0;0;0;.00nan;0;0
1571;4338;65;69;27;2;25;.926;3600000;0
1571;4987;65;0;0;0;0;.00nan;0;0
1571;26865;57;81;54;5;49;.907;3600000;0
1572;4447;54;0;0;0;0;.00nan;0;0
1572;31643;54;69;30;3;27;.900;3900000;0
1572;34788;42;90;37;3;34;.919;3900000;0
1572;37416;42;0;0;0;0;.00nan;0;0
1573;2016;61;0;0;0;0;.00nan;0;0
1573;2152;49;0;0;0;0;.00nan;0;0
1573;4435;49;29;24;5;19;.792;3600000;0
1573;30971;61;84;33;2;31;.939;3600000;0
1574;5137;58;0;0;0;0;.00nan;0;0
1574;14321;58;52;36;5;31;.861;3574000;0
1574;28772;53;0;0;0;0;.00nan;0;0
1574;31156;53;45;23;4;19;.826;3600000;0
1575;5298;55;62;19;2;17;.895;3600000;0
1575;6081;56;41;29;5;24;.828;3600000;0
1575;26824;56;0;0;0;0;.00nan;0;0
1575;34770;55;0;0;0;0;.00nan;0;0
1576;3533;57;74;22;1;21;.955;2418000;0
1576;4338;65;52;28;4;24;.857;3600000;0
1576;4987;65;0;0;0;0;.00nan;0;0
1576;26865;57;31;17;4;13;.765;1134000;0
1577;2163;39;82;14;0;14;1.000;3600000;0
1577;2900;36;0;0;0;0;.00nan;0;0
1577;9238;39;0;0;0;0;.00nan;0;0
1577;14874;36;81;40;3;37;.925;3600000;0
1578;376;45;0;0;0;0;.00nan;0;0
1578;2198;45;71;31;3;28;.903;3583000;0
1578;23493;51;71;23;2;21;.913;3600000;0
1578;31822;51;0;0;0;0;.00nan;0;0
1579;4447;54;94;30;1;29;.967;3900000;0
1579;31643;54;0;0;0;0;.00nan;0;0
1579;34788;42;0;0;0;0;.00nan;0;0
1579;37416;42;84;30;1;29;.967;3900000;0
1580;7049;47;66;31;3;28;.903;3600000;0
1580;14351;40;0;0;0;0;.00nan;0;0
1580;26840;40;100;34;0;34;1.000;3600000;0
1580;33654;47;0;0;0;0;.00nan;0;0
1581;2016;61;91;44;3;41;.932;3600000;0
1581;2152;49;88;17;0;17;1.000;3600000;0
1581;4435;49;0;0;0;0;.00nan;0;0
1581;30971;61;0;0;0;0;.00nan;0;0
1582;3;50;50;40;6;34;.850;3600000;0
1582;5048;50;0;0;0;0;.00nan;0;0
1582;5146;64;93;33;2;31;.939;3600000;0
1582;28845;64;0;0;0;0;.00nan;0;0
1583;2796;59;0;0;0;0;.00nan;0;0
1583;2900;36;0;0;0;0;.00nan;0;0
1583;14874;36;78;34;3;31;.912;3562000;0
1583;31858;59;91;29;1;28;.966;3600000;0
1584;1486;43;86;29;1;28;.966;3600000;0
1584;3625;43;0;0;0;0;.00nan;0;0
1584;4447;54;46;22;3;19;.864;3579000;0
1584;31643;54;0;0;0;0;.00nan;0;0
1585;376;45;0;0;0;0;.00nan;0;0
1585;2198;45;83;37;3;34;.919;3600000;0
1585;23493;51;37;20;4;16;.800;3600000;0
1585;31822;51;0;0;0;0;.00nan;0;0
1586;37;46;49;24;4;20;.833;3562000;0
1586;2553;46;0;0;0;0;.00nan;0;0
1586;34788;42;0;0;0;0;.00nan;0;0
1586;37416;42;63;22;2;20;.909;3600000;0
1587;3847;38;0;0;0;0;.00nan;0;0
1587;28772;53;0;0;0;0;.00nan;0;0
1587;31021;38;78;25;2;23;.920;3900000;0
1587;31156;53;88;36;2;34;.944;3900000;0
1588;3533;57;0;0;0;0;.00nan;0;0
1588;19640;41;0;0;0;0;.00nan;0;0
1588;23075;41;97;39;2;37;.949;3900000;0
1588;26865;57;80;30;2;28;.933;3900000;0
1589;2163;39;68;16;1;15;.938;3600000;0
1589;5137;58;0;0;0;0;.00nan;0;0
1589;9238;39;0;0;0;0;.00nan;0;0
1589;14321;58;67;41;5;36;.878;3600000;0
1590;1051;44;70;21;1;20;.952;3600000;0
1590;3281;44;0;0;0;0;.00nan;0;0
1590;10698;4619;0;0;0;0;.00nan;0;0
1590;35210;4619;54;33;4;29;.879;3600000;0
1591;3626;48;84;27;2;25;.926;3600000;0
1591;7049;47;57;37;5;32;.865;3600000;0
1591;33654;47;0;0;0;0;.00nan;0;0
1591;38547;48;0;0;0;0;.00nan;0;0
1592;6572;62;47;27;4;23;.852;3600000;0
1592;14351;40;0;0;0;0;.00nan;0;0
1592;26840;40;63;21;2;19;.905;3600000;0
1592;26919;62;0;0;0;0;.00nan;0;0
1593;1592;63;40;28;5;23;.821;3600000;0
1593;5137;58;100;27;0;27;1.000;3600000;0
1593;14321;58;0;0;0;0;.00nan;0;0
1593;34814;63;0;0;0;0;.00nan;0;0
1594;2796;59;99;42;2;40;.952;3730000;0
1594;19640;41;44;16;3;13;.813;3730000;0
1594;23075;41;0;0;0;0;.00nan;0;0
1594;31858;59;0;0;0;0;.00nan;0;0
1595;780;52;0;0;0;0;.00nan;0;0
1595;3847;38;72;38;4;34;.895;3557000;0
1595;31021;38;0;0;0;0;.00nan;0;0
1595;32146;52;77;33;3;30;.909;3600000;0
1596;2163;39;0;0;0;0;.00nan;0;0
1596;2900;36;62;30;3;27;.900;3565000;0
1596;9238;39;61;24;2;22;.917;3600000;0
1596;14874;36;0;0;0;0;.00nan;0;0
1597;1486;43;0;0;0;0;.00nan;0;0
1597;3625;43;58;33;4;29;.879;3555000;0
1597;4447;54;0;0;0;0;.00nan;0;0
1597;31643;54;63;24;2;22;.917;3600000;0
1598;2296;37;72;30;2;28;.933;3574000;0
1598;6081;56;95;35;1;34;.971;3600000;0
1598;23043;37;0;0;0;0;.00nan;0;0
1598;26824;56;0;0;0;0;.00nan;0;0
1599;37;46;0;0;0;0;.00nan;0;0
1599;2553;46;65;23;2;21;.913;3600000;0
1599;34788;42;66;39;4;35;.897;3600000;0
1599;37416;42;0;0;0;0;.00nan;0;0
1600;3;50;0;0;0;0;.00nan;0;0
1600;5048;50;76;37;3;34;.919;3900000;0
1600;5146;64;66;28;3;25;.893;3900000;0
1600;28845;64;0;0;0;0;.00nan;0;0
1601;3533;57;17;27;8;19;.704;1849000;0
1601;4338;65;75;27;1;26;.963;3600000;0
1601;4987;65;0;0;0;0;.00nan;0;0
1601;26865;57;18;14;5;9;.643;1751000;0
1602;5298;55;51;8;1;7;.875;1473000;0
1602;28772;53;67;34;3;31;.912;3600000;0
1602;31156;53;0;0;0;0;.00nan;0;0
1602;34770;55;27;27;6;21;.778;2127000;0
1603;6572;62;0;0;0;0;.00nan;0;0
1603;14351;40;80;35;3;32;.914;3577000;0
1603;26840;40;0;0;0;0;.00nan;0;0
1603;26919;62;69;24;2;22;.917;3600000;0
1604;1051;44;0;0;0;0;.00nan;0;0
1604;3281;44;60;20;2;18;.900;3571000;0
1604;10698;4619;100;27;0;27;1.000;3600000;0
1604;35210;4619;0;0;0;0;.00nan;0;0
1605;2152;49;71;25;2;23;.920;3600000;0
1605;4435;49;0;0;0;0;.00nan;0;0
1605;7049;47;54;5;0;5;1.000;370000;0
1605;33654;47;57;38;6;32;.842;3230000;0
1606;2016;61;0;0;0;0;.00nan;0;0
1606;20717;60;54;27;3;24;.889;3558000;0
1606;30971;61;96;27;1;26;.963;3600000;0
1606;35536;60;0;0;0;0;.00nan;0;0
1607;780;52;0;0;0;0;.00nan;0;0
1607;19640;41;0;0;0;0;.00nan;0;0
1607;23075;41;71;34;3;31;.912;3545000;0
1607;32146;52;82;31;2;29;.935;3600000;0
1608;2796;59;0;0;0;0;.00nan;0;0
1608;4338;65;0;0;0;0;.00nan;0;0
1608;4987;65;91;14;0;14;1.000;3600000;0
1608;31858;59;86;42;3;39;.929;3600000;0
1609;2296;37;0;0;0;0;.00nan;0;0
1609;6081;56;0;0;0;0;.00nan;0;0
1609;23043;37;68;15;1;14;.933;3600000;0
1609;26824;56;46;32;5;27;.844;3600000;0
1610;3847;38;0;0;0;0;.00nan;0;0
1610;5298;55;0;0;0;0;.00nan;0;0
1610;31021;38;67;21;2;19;.905;3600000;0
1610;34770;55;63;36;4;32;.889;3570000;0
1611;1592;63;55;6;1;5;.833;1118000;0
1611;23493;51;56;30;4;26;.867;3600000;0
1611;31822;51;0;0;0;0;.00nan;0;0
1611;34814;63;32;30;6;24;.800;2482000;0
1612;3;50;73;25;1;24;.960;3600000;0
1612;5048;50;0;0;0;0;.00nan;0;0
1612;5146;64;43;17;3;14;.824;1392000;0
1612;28845;64;32;20;4;16;.800;2208000;0
1613;2016;61;56;38;5;33;.868;3600000;0
1613;20717;60;0;0;0;0;.00nan;0;0
1613;30971;61;0;0;0;0;.00nan;0;0
1613;35536;60;61;30;4;26;.867;3600000;0
1614;37;46;80;29;3;26;.897;3651000;0
1614;1486;43;59;30;4;26;.867;3651000;0
1614;2553;46;0;0;0;0;.00nan;0;0
1614;3625;43;0;0;0;0;.00nan;0;0
1615;2152;49;54;21;3;18;.857;3900000;0
1615;4435;49;0;0;0;0;.00nan;0;0
1615;7049;47;0;0;0;0;.00nan;0;0
1615;33654;47;82;38;3;35;.921;3900000;0
1616;6081;56;94;34;1;33;.971;3600000;0
1616;26824;56;0;0;0;0;.00nan;0;0
1616;28772;53;0;0;0;0;.00nan;0;0
1616;31156;53;43;31;5;26;.839;3600000;0
1617;1486;43;0;0;0;0;.00nan;0;0
1617;2900;36;0;0;0;0;.00nan;0;0
1617;3625;43;73;35;3;32;.914;3558000;0
1617;14874;36;62;19;2;17;.895;3600000;0
1618;2796;59;0;0;0;0;.00nan;0;0
1618;4338;65;0;0;0;0;.00nan;0;0
1618;4987;65;80;31;2;29;.935;3600000;0
1618;31858;59;64;26;3;23;.885;3556000;0
1619;2163;39;80;24;1;23;.958;3591000;0
1619;5298;55;0;0;0;0;.00nan;0;0
1619;9238;39;0;0;0;0;.00nan;0;0
1619;34770;55;100;29;0;29;1.000;3600000;0
1620;2296;37;60;24;3;21;.875;3600000;0
1620;23043;37;0;0;0;0;.00nan;0;0
1620;23493;51;63;24;2;22;.917;3600000;0
1620;31822;51;0;0;0;0;.00nan;0;0
1621;3;50;0;0;0;0;.00nan;0;0
1621;5048;50;37;31;6;25;.806;3517000;0
1621;34788;42;63;33;4;29;.879;3600000;0
1621;37416;42;0;0;0;0;.00nan;0;0
1622;376;45;0;0;0;0;.00nan;0;0
1622;2198;45;100;27;0;27;1.000;3600000;0
1622;5146;64;68;29;3;26;.897;3600000;0
1622;28845;64;0;0;0;0;.00nan;0;0
1623;8046;57;23;5;3;2;.400;525000;0
1623;26865;57;80;22;0;22;1.000;3024000;0
1623;28772;53;0;0;0;0;.00nan;0;0
1623;31156;53;58;20;2;18;.900;3600000;0
1624;2900;36;0;0;0;0;.00nan;0;0
1624;14874;36;77;31;2;29;.935;3900000;0
1624;19640;41;0;0;0;0;.00nan;0;0
1624;23075;41;90;34;2;32;.941;3900000;0
1625;1486;43;0;0;0;0;.00nan;0;0
1625;3625;43;77;21;1;20;.952;3600000;0
1625;5298;55;0;0;0;0;.00nan;0;0
1625;34770;55;77;46;4;42;.913;3600000;0
1626;3847;38;0;0;0;0;.00nan;0;0
1626;6081;56;54;31;4;27;.871;3600000;0
1626;26824;56;0;0;0;0;.00nan;0;0
1626;31021;38;99;19;0;19;1.000;3600000;0
1627;1592;63;69;29;2;27;.931;3600000;0
1627;5137;58;60;29;4;25;.862;3515000;0
1627;14321;58;0;0;0;0;.00nan;0;0
1627;34814;63;0;0;0;0;.00nan;0;0
1628;2163;39;60;29;3;26;.897;3600000;0
1628;9238;39;0;0;0;0;.00nan;0;0
1628;23493;51;66;40;4;36;.900;3600000;0
1628;31822;51;0;0;0;0;.00nan;0;0
1629;37;46;0;0;0;0;.00nan;0;0
1629;2296;37;57;28;4;24;.857;3600000;0
1629;2553;46;55;24;3;21;.875;3600000;0
1629;23043;37;0;0;0;0;.00nan;0;0
1630;3;50;37;27;5;22;.815;3552000;0
1630;4447;54;0;0;0;0;.00nan;0;0
1630;5048;50;0;0;0;0;.00nan;0;0
1630;31643;54;85;40;3;37;.925;3600000;0
1631;3626;48;57;35;5;30;.857;3900000;0
1631;34788;42;68;43;5;38;.884;3900000;0
1631;37416;42;0;0;0;0;.00nan;0;0
1631;38547;48;0;0;0;0;.00nan;0;0
1632;1051;44;66;34;3;31;.912;3584000;0
1632;3281;44;0;0;0;0;.00nan;0;0
1632;14351;40;70;28;2;26;.929;3600000;0
1632;26840;40;0;0;0;0;.00nan;0;0
1633;7049;47;0;0;0;0;.00nan;0;0
1633;10698;4619;80;32;2;30;.938;3900000;0
1633;33654;47;72;28;2;26;.929;3900000;0
1633;35210;4619;0;0;0;0;.00nan;0;0
1634;2152;49;78;29;2;27;.931;3600000;0
1634;4435;49;0;0;0;0;.00nan;0;0
1634;6572;62;69;34;5;29;.853;3600000;0
1634;26919;62;0;0;0;0;.00nan;0;0
1635;2016;61;50;1;0;1;1.000;321000;0
1635;20717;60;0;0;0;0;.00nan;0;0
1635;30971;61;55;47;6;41;.872;3279000;0
1635;35536;60;44;16;3;13;.813;3600000;0
1636;2900;36;100;45;4;41;.911;3900000;0
1636;14874;36;0;0;0;0;.00nan;0;0
1636;19640;41;47;25;4;21;.840;3900000;0
1636;23075;41;0;0;0;0;.00nan;0;0
1637;2796;59;0;0;0;0;.00nan;0;0
1637;4338;65;84;33;2;31;.939;3600000;0
1637;4987;65;0;0;0;0;.00nan;0;0
1637;31858;59;70;38;4;34;.895;3589000;0
1638;780;52;0;0;0;0;.00nan;0;0
1638;1592;63;0;0;0;0;.00nan;0;0
1638;32146;52;64;13;1;12;.923;3900000;0
1638;34814;63;97;39;1;38;.974;3900000;0
1639;37;46;74;37;4;33;.892;3514000;0
1639;2296;37;0;0;0;0;.00nan;0;0
1639;2553;46;0;0;0;0;.00nan;0;0
1639;5883;37;87;38;2;36;.947;3600000;0
1640;3;50;0;0;0;0;.00nan;0;0
1640;4447;54;36;28;5;23;.821;3600000;0
1640;5048;50;79;25;1;24;.960;3600000;0
1640;31643;54;0;0;0;0;.00nan;0;0
1641;3626;48;0;0;0;0;.00nan;0;0
1641;34788;42;0;0;0;0;.00nan;0;0
1641;37416;42;100;51;4;47;.922;3900000;0
1641;38547;48;52;29;4;25;.862;3900000;0
1642;1486;43;84;23;1;22;.957;3600000;0
1642;3625;43;0;0;0;0;.00nan;0;0
1642;8046;57;89;35;2;33;.943;3600000;0
1642;26865;57;0;0;0;0;.00nan;0;0
1643;3847;38;0;0;0;0;.00nan;0;0
1643;5137;58;0;0;0;0;.00nan;0;0
1643;14321;58;30;29;6;23;.793;3600000;0
1643;31021;38;42;31;5;26;.839;3600000;0
1644;376;45;0;0;0;0;.00nan;0;0
1644;2198;45;73;37;3;34;.919;3544000;0
1644;5146;64;78;27;2;25;.926;3600000;0
1644;28845;64;0;0;0;0;.00nan;0;0
1645;1051;44;0;0;0;0;.00nan;0;0
1645;3281;44;52;23;4;19;.826;3900000;0
1645;14351;40;0;0;0;0;.00nan;0;0
1645;26840;40;78;37;4;33;.892;3900000;0
1646;7049;47;66;47;4;43;.915;3600000;0
1646;10698;4619;0;0;0;0;.00nan;0;0
1646;33654;47;0;0;0;0;.00nan;0;0
1646;35210;4619;85;29;1;28;.966;3600000;0
1647;2152;49;57;30;3;27;.900;3594000;0
1647;4435;49;0;0;0;0;.00nan;0;0
1647;6572;62;0;0;0;0;.00nan;0;0
1647;26919;62;86;29;2;27;.931;3600000;0
1648;780;52;85;17;0;17;1.000;3600000;0
1648;6081;56;29;17;4;13;.765;967000;0
1648;26824;56;51;15;2;13;.867;2633000;0
1648;32146;52;0;0;0;0;.00nan;0;0
1649;1592;63;88;18;0;18;1.000;3600000;0
1649;3847;38;41;19;4;15;.789;3600000;0
1649;31021;38;0;0;0;0;.00nan;0;0
1649;34814;63;0;0;0;0;.00nan;0;0
1650;8046;57;0;0;0;0;.00nan;0;0
1650;26865;57;83;41;3;38;.927;3600000;0
1650;28772;53;0;0;0;0;.00nan;0;0
1650;31156;53;100;43;2;41;.953;3600000;0
1651;2796;59;85;28;1;27;.964;3600000;0
1651;5137;58;61;38;4;34;.895;3600000;0
1651;14321;58;0;0;0;0;.00nan;0;0
1651;31858;59;0;0;0;0;.00nan;0;0
1652;4338;65;0;0;0;0;.00nan;0;0
1652;4987;65;76;28;2;26;.929;3600000;0
1652;23493;51;48;33;5;28;.848;3600000;0
1652;31822;51;0;0;0;0;.00nan;0;0
1653;376;45;74;22;1;21;.955;3600000;0
1653;2198;45;0;0;0;0;.00nan;0;0
1653;5146;64;0;0;0;0;.00nan;0;0
1653;28845;64;94;39;2;37;.949;3565000;0
1654;2016;61;84;40;3;37;.925;3720000;0
1654;20717;60;73;36;4;32;.889;3720000;0
1654;30971;61;0;0;0;0;.00nan;0;0
1654;35536;60;0;0;0;0;.00nan;0;0
1655;2163;39;62;29;3;26;.897;3600000;0
1655;9238;39;0;0;0;0;.00nan;0;0
1655;19640;41;0;0;0;0;.00nan;0;0
1655;23075;41;37;19;4;15;.789;3573000;0
1656;3;50;37;34;6;28;.824;3600000;0
1656;4447;54;0;0;0;0;.00nan;0;0
1656;5048;50;0;0;0;0;.00nan;0;0
1656;31643;54;53;21;3;18;.857;3600000;0
1657;1051;44;80;32;3;29;.906;3600000;0
1657;3281;44;0;0;0;0;.00nan;0;0
1657;3626;48;0;0;0;0;.00nan;0;0
1657;38547;48;50;27;4;23;.852;3561000;0
1658;2163;39;0;0;0;0;.00nan;0;0
1658;9238;39;100;27;0;27;1.000;3600000;0
1658;19640;41;80;34;2;32;.941;3558000;0
1658;23075;41;0;0;0;0;.00nan;0;0
1659;1592;63;73;26;2;24;.923;3600000;0
1659;2900;36;0;0;0;0;.00nan;0;0
1659;14874;36;44;21;3;18;.857;3545000;0
1659;34814;63;0;0;0;0;.00nan;0;0
1660;6081;56;77;31;2;29;.935;3900000;0
1660;8046;57;0;0;0;0;.00nan;0;0
1660;26824;56;0;0;0;0;.00nan;0;0
1660;26865;57;89;34;2;32;.941;3900000;0
1661;1051;44;0;0;0;0;.00nan;0;0
1661;3281;44;81;27;1;26;.963;3600000;0
1661;3626;48;40;30;5;25;.833;3600000;0
1661;38547;48;0;0;0;0;.00nan;0;0
1662;7049;47;72;33;2;31;.939;3900000;0
1662;14351;40;0;0;0;0;.00nan;0;0
1662;26840;40;84;33;2;31;.939;3900000;0
1662;33654;47;0;0;0;0;.00nan;0;0
1663;2016;61;0;0;0;0;.00nan;0;0
1663;6572;62;0;0;0;0;.00nan;0;0
1663;26919;62;83;28;1;27;.964;3600000;0
1663;30971;61;66;22;2;20;.909;3562000;0
1664;10698;4619;60;22;2;20;.909;2699000;0
1664;20717;60;0;0;0;0;.00nan;0;0
1664;35210;4619;17;9;4;5;.556;889000;0
1664;35536;60;40;25;5;20;.800;3600000;0
1665;2296;37;0;0;0;0;.00nan;0;0
1665;5146;64;81;42;4;38;.905;3600000;0
1665;5883;37;100;24;0;24;1.000;3600000;0
1665;28845;64;0;0;0;0;.00nan;0;0
1666;1486;43;0;0;0;0;.00nan;0;0
1666;3625;43;100;34;0;34;1.000;3600000;0
1666;5298;55;0;0;0;0;.00nan;0;0
1666;34770;55;67;24;2;22;.917;3567000;0
1667;8046;57;67;22;2;20;.909;3900000;0
1667;26865;57;0;0;0;0;.00nan;0;0
1667;28772;53;66;26;2;24;.923;3900000;0
1667;31156;53;0;0;0;0;.00nan;0;0
1668;2900;36;0;0;0;0;.00nan;0;0
1668;6081;56;65;31;3;28;.903;3549000;0
1668;14874;36;63;23;2;21;.913;3600000;0
1668;26824;56;0;0;0;0;.00nan;0;0
1669;1486;43;0;0;0;0;.00nan;0;0
1669;3625;43;64;31;4;27;.871;3600000;0
1669;5298;55;54;34;5;29;.853;3547000;0
1669;34770;55;0;0;0;0;.00nan;0;0
1670;3847;38;0;0;0;0;.00nan;0;0
1670;23493;51;61;20;2;18;.900;3600000;0
1670;31021;38;47;37;6;31;.838;3600000;0
1670;31822;51;0;0;0;0;.00nan;0;0
1671;4338;65;100;28;0;28;1.000;3789000;0
1671;4987;65;0;0;0;0;.00nan;0;0
1671;5137;58;0;0;0;0;.00nan;0;0
1671;14321;58;83;23;1;22;.957;3789000;0
1672;4447;54;0;0;0;0;.00nan;0;0
1672;5146;64;57;13;1;12;.923;1125000;0
1672;28845;64;22;27;7;20;.741;2475000;0
1672;31643;54;50;21;3;18;.857;3600000;0
1673;376;45;0;0;0;0;.00nan;0;0
1673;2198;45;72;22;1;21;.955;3600000;0
1673;34788;42;56;27;4;23;.852;3600000;0
1673;37416;42;0;0;0;0;.00nan;0;0
1674;3;50;58;28;4;24;.857;3665000;0
1674;2296;37;0;0;0;0;.00nan;0;0
1674;5048;50;0;0;0;0;.00nan;0;0
1674;5883;37;73;34;3;31;.912;3665000;0
1675;2152;49;70;34;3;31;.912;3600000;0
1675;4435;49;0;0;0;0;.00nan;0;0
1675;20717;60;38;34;7;27;.794;3600000;0
1675;35536;60;0;0;0;0;.00nan;0;0
1676;6572;62;0;0;0;0;.00nan;0;0
1676;7049;47;0;0;0;0;.00nan;0;0
1676;26919;62;28;32;7;25;.781;3600000;0
1676;33654;47;47;26;4;22;.846;3600000;0
1677;10698;4619;0;0;0;0;.00nan;0;0
1677;14351;40;0;0;0;0;.00nan;0;0
1677;26840;40;72;33;2;31;.939;3570000;0
1677;35210;4619;88;29;1;28;.966;3600000;0
1678;780;52;55;33;4;29;.879;3600000;0
1678;19640;41;0;0;0;0;.00nan;0;0
1678;23075;41;30;21;5;16;.762;3597000;0
1678;32146;52;0;0;0;0;.00nan;0;0
1679;2796;59;0;0;0;0;.00nan;0;0
1679;4338;65;71;28;2;26;.929;3600000;0
1679;4987;65;0;0;0;0;.00nan;0;0
1679;31858;59;51;40;6;34;.850;3600000;0
1680;2900;36;60;20;2;18;.900;3900000;0
1680;14874;36;0;0;0;0;.00nan;0;0
1680;23493;51;100;44;2;42;.955;3900000;0
1680;31822;51;0;0;0;0;.00nan;0;0
1681;3847;38;67;39;5;34;.872;3600000;0
1681;6081;56;0;0;0;0;.00nan;0;0
1681;26824;56;53;44;6;38;.864;3554000;0
1681;31021;38;0;0;0;0;.00nan;0;0
1682;37;46;0;0;0;0;.00nan;0;0
1682;1592;63;62;27;3;24;.889;3600000;0
1682;2553;46;57;36;5;31;.861;3600000;0
1682;34814;63;0;0;0;0;.00nan;0;0
1683;3;50;0;0;0;0;.00nan;0;0
1683;2296;37;0;0;0;0;.00nan;0;0
1683;5048;50;76;31;2;29;.935;3595000;0
1683;5883;37;98;34;1;33;.971;3600000;0
1684;907;39;0;0;0;0;.00nan;0;0
1684;2163;39;71;36;3;33;.917;3600000;0
1684;8046;57;0;0;0;0;.00nan;0;0
1684;26865;57;86;33;2;31;.939;3600000;0
1685;5137;58;0;0;0;0;.00nan;0;0
1685;14321;58;59;17;2;15;.882;3600000;0
1685;28772;53;0;0;0;0;.00nan;0;0
1685;31156;53;52;37;5;32;.865;3600000;0
1686;4447;54;64;21;2;19;.905;3600000;0
1686;5146;64;75;40;4;36;.900;3600000;0
1686;28845;64;0;0;0;0;.00nan;0;0
1686;31643;54;0;0;0;0;.00nan;0;0
1687;376;45;59;30;4;26;.867;3563000;0
1687;2198;45;0;0;0;0;.00nan;0;0
1687;34788;42;0;0;0;0;.00nan;0;0
1687;37416;42;74;32;3;29;.906;3600000;0
1688;1051;44;0;0;0;0;.00nan;0;0
1688;2152;49;0;0;0;0;.00nan;0;0
1688;3281;44;89;35;2;33;.943;3900000;0
1688;4435;49;90;37;2;35;.946;3900000;0
1689;10698;4619;68;37;4;33;.892;3600000;0
1689;14351;40;96;36;1;35;.972;3600000;0
1689;26840;40;0;0;0;0;.00nan;0;0
1689;35210;4619;0;0;0;0;.00nan;0;0
1690;6572;62;74;27;2;25;.926;3600000;0
1690;20717;60;0;0;0;0;.00nan;0;0
1690;26919;62;0;0;0;0;.00nan;0;0
1690;35536;60;78;33;3;30;.909;3550000;0
1691;2016;61;0;0;0;0;.00nan;0;0
1691;3626;48;0;0;0;0;.00nan;0;0
1691;30971;61;71;22;2;20;.909;3600000;0
1691;38547;48;64;33;4;29;.879;3589000;0
1692;780;52;0;0;0;0;.00nan;0;0
1692;19640;41;64;19;2;17;.895;3900000;0
1692;23075;41;0;0;0;0;.00nan;0;0
1692;32146;52;90;36;2;34;.944;3900000;0
1693;5137;58;0;0;0;0;.00nan;0;0
1693;14321;58;57;30;4;26;.867;3900000;0
1693;28772;53;78;45;4;41;.911;3900000;0
1693;31156;53;0;0;0;0;.00nan;0;0
1694;37;46;77;19;1;18;.947;3600000;0
1694;1592;63;0;0;0;0;.00nan;0;0
1694;2553;46;0;0;0;0;.00nan;0;0
1694;34814;63;66;34;3;31;.912;3600000;0
1695;907;39;73;25;2;23;.920;3900000;0
1695;2163;39;0;0;0;0;.00nan;0;0
1695;4338;65;0;0;0;0;.00nan;0;0
1695;4987;65;66;27;2;25;.926;3900000;0
1696;2016;61;100;22;0;22;1.000;3600000;0
1696;3626;48;87;32;1;31;.969;3598000;0
1696;30971;61;0;0;0;0;.00nan;0;0
1696;38547;48;0;0;0;0;.00nan;0;0
1697;1592;63;100;34;1;33;.971;3600000;0
1697;2796;59;0;0;0;0;.00nan;0;0
1697;31858;59;19;26;7;19;.731;3600000;0
1697;34814;63;0;0;0;0;.00nan;0;0
1698;5298;55;76;26;1;25;.962;3600000;0
1698;6081;56;60;23;4;19;.826;3600000;0
1698;26824;56;0;0;0;0;.00nan;0;0
1698;34770;55;0;0;0;0;.00nan;0;0
1699;4447;54;0;0;0;0;.00nan;0;0
1699;31643;54;75;28;2;26;.929;3600000;0
1699;34788;42;44;30;5;25;.833;3600000;0
1699;37416;42;0;0;0;0;.00nan;0;0
1700;376;45;0;0;0;0;.00nan;0;0
1700;2198;45;82;39;3;36;.923;3598000;0
1700;2296;37;0;0;0;0;.00nan;0;0
1700;5883;37;76;22;1;21;.955;3600000;0
1701;10698;4619;68;20;1;19;.950;2388000;0
1701;20717;60;75;37;3;34;.919;3600000;0
1701;35210;4619;22;13;4;9;.692;1180000;0
1701;35536;60;0;0;0;0;.00nan;0;0
1702;376;45;100;38;2;36;.947;3900000;0
1702;2198;45;0;0;0;0;.00nan;0;0
1702;2296;37;0;0;0;0;.00nan;0;0
1702;5883;37;97;45;2;43;.956;3900000;0
1703;780;52;0;0;0;0;.00nan;0;0
1703;28772;53;64;13;1;12;.923;1111000;0
1703;31156;53;28;33;7;26;.788;2489000;0
1703;32146;52;64;24;2;22;.917;3600000;0
1704;4338;65;41;28;5;23;.821;3526000;0
1704;4987;65;0;0;0;0;.00nan;0;0
1704;8046;57;0;0;0;0;.00nan;0;0
1704;26865;57;65;32;3;29;.906;3600000;0
1705;2900;36;0;0;0;0;.00nan;0;0
1705;3847;38;0;0;0;0;.00nan;0;0
1705;14874;36;90;34;2;32;.941;3576000;0
1705;31021;38;91;29;1;28;.966;3600000;0
1706;1486;43;84;40;3;37;.925;3572000;0
1706;3625;43;26;6;3;3;.500;328000;0
1706;5146;64;68;10;0;10;1.000;1225000;0
1706;28845;64;25;24;6;18;.750;2675000;0
1707;37;46;79;23;1;22;.957;3600000;0
1707;2553;46;0;0;0;0;.00nan;0;0
1707;4447;54;84;45;3;42;.933;3534000;0
1707;31643;54;0;0;0;0;.00nan;0;0
1708;907;39;0;0;0;0;.00nan;0;0
1708;2163;39;46;25;4;21;.840;3512000;0
1708;2796;59;86;35;2;33;.943;3600000;0
1708;31858;59;0;0;0;0;.00nan;0;0
1709;10698;4619;0;0;0;0;.00nan;0;0
1709;20717;60;0;0;0;0;.00nan;0;0
1709;35210;4619;73;29;3;26;.897;3600000;0
1709;35536;60;57;33;4;29;.879;3550000;0
1710;6572;62;0;0;0;0;.00nan;0;0
1710;14351;40;63;25;2;23;.920;2741000;0
1710;26840;40;25;17;5;12;.706;859000;0
1710;26919;62;90;37;2;35;.946;3600000;0
1711;2152;49;0;0;0;0;.00nan;0;0
1711;3626;48;0;0;0;0;.00nan;0;0
1711;4435;49;60;32;4;28;.875;3900000;0
1711;38547;48;72;40;4;36;.900;3900000;0
1712;1051;44;0;0;0;0;.00nan;0;0
1712;2016;61;45;25;4;21;.840;3595000;0
1712;3281;44;68;30;3;27;.900;3600000;0
1712;30971;61;0;0;0;0;.00nan;0;0
1713;1486;43;0;0;0;0;.00nan;0;0
1713;3625;43;53;14;2;12;.857;3600000;0
1713;5146;64;58;32;5;27;.844;3600000;0
1713;28845;64;0;0;0;0;.00nan;0;0
1714;1051;44;72;29;3;26;.897;3557000;0
1714;2016;61;0;0;0;0;.00nan;0;0
1714;3281;44;0;0;0;0;.00nan;0;0
1714;30971;61;90;28;1;27;.964;3600000;0
1715;1592;63;16;21;6;15;.714;2375000;0
1715;6081;56;57;38;5;33;.868;3600000;0
1715;26824;56;0;0;0;0;.00nan;0;0
1715;34814;63;83;22;1;21;.955;1210000;0
1716;37;46;0;0;0;0;.00nan;0;0
1716;1486;43;59;23;3;20;.870;3600000;0
1716;2553;46;27;23;5;18;.783;3530000;0
1716;3625;43;0;0;0;0;.00nan;0;0
1717;3;50;0;0;0;0;.00nan;0;0
1717;5048;50;73;29;2;27;.931;3589000;0
1717;34788;42;98;41;1;40;.976;3600000;0
1717;37416;42;0;0;0;0;.00nan;0;0
1718;2796;59;0;0;0;0;.00nan;0;0
1718;4338;65;55;27;3;24;.889;3533000;0
1718;4987;65;0;0;0;0;.00nan;0;0
1718;31858;59;92;32;1;31;.969;3600000;0
1719;2163;39;0;0;0;0;.00nan;0;0
1719;5298;55;0;0;0;0;.00nan;0;0
1719;9238;39;92;29;1;28;.966;3600000;0
1719;34770;55;51;22;3;19;.864;3544000;0
1720;2152;49;0;0;0;0;.00nan;0;0
1720;4435;49;64;31;4;27;.871;3600000;0
1720;6572;62;54;9;1;8;.889;1819000;0
1720;26919;62;17;22;6;16;.727;1781000;0
1721;7049;47;0;0;0;0;.00nan;0;0
1721;20717;60;87;28;2;26;.929;3600000;0
1721;33654;47;66;25;3;22;.880;3551000;0
1721;35536;60;0;0;0;0;.00nan;0;0
1722;780;52;0;0;0;0;.00nan;0;0
1722;5137;58;0;0;0;0;.00nan;0;0
1722;14321;58;62;32;4;28;.875;3607000;0
1722;32146;52;76;46;5;41;.891;3607000;0
1723;1592;63;0;0;0;0;.00nan;0;0
1723;3847;38;0;0;0;0;.00nan;0;0
1723;31021;38;72;40;3;37;.925;3900000;0
1723;34814;63;71;36;3;33;.917;3900000;0
1724;2900;36;0;0;0;0;.00nan;0;0
1724;6081;56;64;29;3;26;.897;3533000;0
1724;14874;36;91;24;1;23;.958;3600000;0
1724;26824;56;0;0;0;0;.00nan;0;0
1725;5137;58;20;25;6;19;.760;3600000;0
1725;5298;55;0;0;0;0;.00nan;0;0
1725;14321;58;0;0;0;0;.00nan;0;0
1725;34770;55;55;19;3;16;.842;3600000;0
1726;780;52;45;41;7;34;.829;3600000;0
1726;28772;53;66;31;3;28;.903;3600000;0
1726;31156;53;0;0;0;0;.00nan;0;0
1726;32146;52;0;0;0;0;.00nan;0;0
1727;2796;59;0;0;0;0;.00nan;0;0
1727;4338;65;68;32;3;29;.906;3719000;0
1727;4987;65;0;0;0;0;.00nan;0;0
1727;31858;59;78;30;2;28;.933;3719000;0
1728;3;50;87;52;4;48;.923;3561000;0
1728;5048;50;0;0;0;0;.00nan;0;0
1728;10698;4619;0;0;0;0;.00nan;0;0
1728;35210;4619;71;28;2;26;.929;3600000;0
1729;1486;43;0;0;0;0;.00nan;0;0
1729;3625;43;97;22;0;22;1.000;3600000;0
1729;8046;57;0;0;0;0;.00nan;0;0
1729;26865;57;52;35;5;30;.857;3600000;0
1730;2163;39;78;27;2;25;.926;3600000;0
1730;3847;38;0;0;0;0;.00nan;0;0
1730;9238;39;0;0;0;0;.00nan;0;0
1730;31021;38;75;45;4;41;.911;3600000;0
1731;2900;36;65;26;2;24;.923;3600000;0
1731;14874;36;0;0;0;0;.00nan;0;0
1731;23493;51;0;0;0;0;.00nan;0;0
1731;31822;51;43;28;5;23;.821;3600000;0
1732;2152;49;68;18;1;17;.944;3600000;0
1732;4435;49;0;0;0;0;.00nan;0;0
1732;7049;47;0;0;0;0;.00nan;0;0
1732;33654;47;87;38;2;36;.947;3552000;0
1733;3626;48;0;0;0;0;.00nan;0;0
1733;6572;62;0;0;0;0;.00nan;0;0
1733;26919;62;89;17;0;17;1.000;3600000;0
1733;38547;48;75;43;3;40;.930;3600000;0
1734;14351;40;60;37;4;33;.892;3531000;0
1734;20717;60;0;0;0;0;.00nan;0;0
1734;26840;40;0;0;0;0;.00nan;0;0
1734;35536;60;67;24;2;22;.917;3600000;0
1735;1592;63;86;38;2;36;.947;3900000;0
1735;6081;56;71;33;2;31;.939;3900000;0
1735;26824;56;0;0;0;0;.00nan;0;0
1735;34814;63;0;0;0;0;.00nan;0;0
1736;4447;54;0;0;0;0;.00nan;0;0
1736;31643;54;73;37;3;34;.919;3600000;0
1736;34788;42;61;22;2;20;.909;3600000;0
1736;37416;42;0;0;0;0;.00nan;0;0
1737;2016;61;0;0;0;0;.00nan;0;0
1737;2296;37;0;0;0;0;.00nan;0;0
1737;5883;37;84;30;2;28;.933;3600000;0
1737;30971;61;58;29;4;25;.862;3552000;0
1738;3847;38;0;0;0;0;.00nan;0;0
1738;28772;53;0;0;0;0;.00nan;0;0
1738;31021;38;55;31;4;27;.871;3600000;0
1738;31156;53;88;33;2;31;.939;3600000;0
1739;3;50;71;45;6;39;.867;3600000;0
1739;5048;50;0;0;0;0;.00nan;0;0
1739;10698;4619;0;0;0;0;.00nan;0;0
1739;35210;4619;50;15;2;13;.867;3600000;0
1740;14351;40;75;34;3;31;.912;3567000;0
1740;20717;60;88;31;1;30;.968;3600000;0
1740;26840;40;0;0;0;0;.00nan;0;0
1740;35536;60;0;0;0;0;.00nan;0;0
1741;5298;55;0;0;0;0;.00nan;0;0
1741;8046;57;0;0;0;0;.00nan;0;0
1741;26865;57;50;32;4;28;.875;3559000;0
1741;34770;55;63;27;3;24;.889;3600000;0
1742;2016;61;44;22;4;18;.818;3517000;0
1742;2296;37;65;23;2;21;.913;3600000;0
1742;5883;37;0;0;0;0;.00nan;0;0
1742;30971;61;0;0;0;0;.00nan;0;0
1743;1486;43;0;0;0;0;.00nan;0;0
1743;2796;59;0;0;0;0;.00nan;0;0
1743;3625;43;100;41;1;40;.976;3600000;0
1743;31858;59;67;27;3;24;.889;3515000;0
1744;37;46;56;32;4;28;.875;3578000;0
1744;2553;46;0;0;0;0;.00nan;0;0
1744;4447;54;64;25;3;22;.880;3600000;0
1744;31643;54;0;0;0;0;.00nan;0;0
1745;5146;64;54;29;4;25;.862;3542000;0
1745;28845;64;0;0;0;0;.00nan;0;0
1745;34788;42;0;0;0;0;.00nan;0;0
1745;37416;42;82;39;3;36;.923;3600000;0
1746;376;45;0;0;0;0;.00nan;0;0
1746;2198;45;62;28;3;25;.893;3600000;0
1746;19640;41;0;0;0;0;.00nan;0;0
1746;23075;41;42;23;4;19;.826;3600000;0
1747;1051;44;90;42;3;39;.929;3600000;0
1747;3281;44;0;0;0;0;.00nan;0;0
1747;6572;62;43;19;4;15;.789;2401000;0
1747;26919;62;32;15;4;11;.733;1199000;0
1748;2152;49;0;0;0;0;.00nan;0;0
1748;3626;48;0;0;0;0;.00nan;0;0
1748;4435;49;68;22;1;21;.955;3600000;0
1748;38547;48;50;39;5;34;.872;3600000;0
1749;2163;39;0;0;0;0;.00nan;0;0
1749;5137;58;0;0;0;0;.00nan;0;0
1749;9238;39;57;24;3;21;.875;3600000;0
1749;14321;58;64;44;6;38;.864;3600000;0
1750;1592;63;97;39;2;37;.949;3900000;0
1750;6081;56;93;27;2;25;.926;3900000;0
1750;26824;56;0;0;0;0;.00nan;0;0
1750;34814;63;0;0;0;0;.00nan;0;0
1751;1486;43;55;17;2;15;.882;3600000;0
1751;2796;59;74;39;4;35;.897;3562000;0
1751;3625;43;0;0;0;0;.00nan;0;0
1751;31858;59;0;0;0;0;.00nan;0;0
1752;37;46;0;0;0;0;.00nan;0;0
1752;2553;46;82;31;2;29;.935;3600000;0
1752;4447;54;98;31;0;31;1.000;3228000;0
1752;31643;54;26;8;3;5;.625;357000;0
1753;5146;64;0;0;0;0;.00nan;0;0
1753;28845;64;55;18;2;16;.889;3900000;0
1753;34788;42;98;45;2;43;.956;3900000;0
1753;37416;42;0;0;0;0;.00nan;0;0
1754;376;45;58;27;3;24;.889;3600000;0
1754;2198;45;0;0;0;0;.00nan;0;0
1754;19640;41;67;36;4;32;.889;3558000;0
1754;23075;41;0;0;0;0;.00nan;0;0
1755;3626;48;76;32;2;30;.938;3600000;0
1755;7049;47;0;0;0;0;.00nan;0;0
1755;33654;47;57;26;4;22;.846;3535000;0
1755;38547;48;0;0;0;0;.00nan;0;0
1756;2163;39;55;25;4;21;.840;3600000;0
1756;9238;39;0;0;0;0;.00nan;0;0
1756;28772;53;100;30;0;30;1.000;3600000;0
1756;31156;53;0;0;0;0;.00nan;0;0
1757;780;52;71;22;1;21;.955;3600000;0
1757;4338;65;86;36;3;33;.917;3600000;0
1757;4987;65;0;0;0;0;.00nan;0;0
1757;32146;52;0;0;0;0;.00nan;0;0
1758;3;50;0;0;0;0;.00nan;0;0
1758;2296;37;0;0;0;0;.00nan;0;0
1758;5048;50;91;35;3;32;.914;3600000;0
1758;5883;37;86;33;2;31;.939;3600000;0
1759;3847;38;75;25;2;23;.920;3570000;0
1759;5137;58;0;0;0;0;.00nan;0;0
1759;14321;58;99;28;1;27;.964;3600000;0
1759;31021;38;0;0;0;0;.00nan;0;0
1760;37;46;93;31;1;30;.968;3600000;0
1760;2553;46;0;0;0;0;.00nan;0;0
1760;5146;64;74;31;2;29;.935;3564000;0
1760;28845;64;0;0;0;0;.00nan;0;0
1761;14351;40;60;30;3;27;.900;3600000;0
1761;20717;60;0;0;0;0;.00nan;0;0
1761;26840;40;0;0;0;0;.00nan;0;0
1761;35536;60;57;23;2;21;.913;3600000;0
1762;1051;44;0;0;0;0;.00nan;0;0
1762;3281;44;50;36;6;30;.833;3600000;0
1762;6572;62;0;0;0;0;.00nan;0;0
1762;26919;62;78;35;3;32;.914;3600000;0
1763;2152;49;55;25;3;22;.880;3542000;0
1763;4435;49;0;0;0;0;.00nan;0;0
1763;7049;47;71;25;2;23;.920;3600000;0
1763;33654;47;0;0;0;0;.00nan;0;0
1764;3;50;79;35;2;33;.943;3600000;0
1764;2296;37;0;0;0;0;.00nan;0;0
1764;5048;50;0;0;0;0;.00nan;0;0
1764;5883;37;79;26;1;25;.962;3600000;0
1765;1051;44;100;27;0;27;1.000;3600000;0
1765;3281;44;0;0;0;0;.00nan;0;0
1765;14351;40;32;23;5;18;.783;3600000;0
1765;26840;40;0;0;0;0;.00nan;0;0
1766;780;52;0;0;0;0;.00nan;0;0
1766;3847;38;0;0;0;0;.00nan;0;0
1766;31021;38;86;42;4;38;.905;3900000;0
1766;32146;52;66;29;4;25;.862;3900000;0
1767;1592;63;74;31;3;28;.903;3590000;0
1767;5298;55;65;16;1;15;.938;3600000;0
1767;34770;55;0;0;0;0;.00nan;0;0
1767;34814;63;0;0;0;0;.00nan;0;0
1768;37;46;56;35;5;30;.857;3600000;0
1768;2553;46;0;0;0;0;.00nan;0;0
1768;4447;54;0;0;0;0;.00nan;0;0
1768;31643;54;95;23;0;23;1.000;3600000;0
1769;2163;39;0;0;0;0;.00nan;0;0
1769;6081;56;0;0;0;0;.00nan;0;0
1769;9238;39;63;22;2;20;.909;3600000;0
1769;26824;56;51;39;5;34;.872;3600000;0
1770;5137;58;0;0;0;0;.00nan;0;0
1770;14321;58;79;27;2;25;.926;3600000;0
1770;23493;51;77;33;3;30;.909;3600000;0
1770;31822;51;0;0;0;0;.00nan;0;0
1771;1051;44;0;0;0;0;.00nan;0;0
1771;3281;44;92;22;0;22;1.000;3600000;0
1771;14351;40;0;0;0;0;.00nan;0;0
1771;26840;40;48;25;4;21;.840;3600000;0
1772;3626;48;0;0;0;0;.00nan;0;0
1772;6572;62;0;0;0;0;.00nan;0;0
1772;26919;62;58;19;2;17;.895;3600000;0
1772;38547;48;64;39;4;35;.897;3563000;0
1773;2900;36;0;0;0;0;.00nan;0;0
1773;4338;65;0;0;0;0;.00nan;0;0
1773;4987;65;90;34;2;32;.941;3565000;0
1773;14874;36;74;20;1;19;.950;3600000;0
1774;2796;59;0;0;0;0;.00nan;0;0
1774;5298;55;50;23;3;20;.870;3600000;0
1774;31858;59;64;38;5;33;.868;3548000;0
1774;34770;55;0;0;0;0;.00nan;0;0
1775;5137;58;0;0;0;0;.00nan;0;0
1775;6081;56;38;31;6;25;.806;3560000;0
1775;14321;58;71;37;5;32;.865;3600000;0
1775;26824;56;0;0;0;0;.00nan;0;0
1776;1592;63;0;0;0;0;.00nan;0;0
1776;23493;51;81;27;1;26;.963;3600000;0
1776;31822;51;0;0;0;0;.00nan;0;0
1776;34814;63;76;32;3;29;.906;3523000;0
1777;3;50;0;0;0;0;.00nan;0;0
1777;37;46;92;24;1;23;.958;3600000;0
1777;2553;46;0;0;0;0;.00nan;0;0
1777;5048;50;81;32;2;30;.938;3600000;0
1778;3847;38;0;0;0;0;.00nan;0;0
1778;8046;57;0;0;0;0;.00nan;0;0
1778;26865;57;92;36;2;34;.944;3600000;0
1778;31021;38;58;24;3;21;.875;3544000;0
1779;2163;39;0;0;0;0;.00nan;0;0
1779;9238;39;71;35;4;31;.886;3900000;0
1779;28772;53;68;29;4;25;.862;3900000;0
1779;31156;53;0;0;0;0;.00nan;0;0
1780;1486;43;91;23;0;23;1.000;3600000;0
1780;3625;43;0;0;0;0;.00nan;0;0
1780;4447;54;0;0;0;0;.00nan;0;0
1780;31643;54;65;30;3;27;.900;3600000;0
1781;751;64;81;26;1;25;.962;3600000;0
1781;5146;64;0;0;0;0;.00nan;0;0
1781;34788;42;39;34;6;28;.824;3600000;0
1781;37416;42;0;0;0;0;.00nan;0;0
1782;376;45;75;36;3;33;.917;3600000;0
1782;2198;45;0;0;0;0;.00nan;0;0
1782;2296;37;0;0;0;0;.00nan;0;0
1782;5883;37;74;19;1;18;.947;3600000;0
1783;6572;62;0;0;0;0;.00nan;0;0
1783;14351;40;99;21;0;21;1.000;3600000;0
1783;26840;40;0;0;0;0;.00nan;0;0
1783;26919;62;68;28;2;26;.929;3586000;0
1784;3626;48;64;43;5;38;.884;3600000;0
1784;20717;60;82;14;0;14;1.000;3600000;0
1784;35536;60;0;0;0;0;.00nan;0;0
1784;38547;48;0;0;0;0;.00nan;0;0
1785;2016;61;52;21;3;18;.857;3894000;0
1785;7049;47;0;0;0;0;.00nan;0;0
1785;30971;61;0;0;0;0;.00nan;0;0
1785;33654;47;69;24;2;22;.917;3894000;0
1786;1592;63;42;34;5;29;.853;3600000;0
1786;23493;51;0;0;0;0;.00nan;0;0
1786;31822;51;59;20;2;18;.900;3600000;0
1786;34814;63;0;0;0;0;.00nan;0;0
1787;780;52;0;0;0;0;.00nan;0;0
1787;19640;41;0;0;0;0;.00nan;0;0
1787;23075;41;35;24;5;19;.792;3600000;0
1787;32146;52;79;47;4;43;.915;3600000;0
1788;2796;59;36;26;5;21;.808;3519000;0
1788;4338;65;86;41;3;38;.927;3600000;0
1788;4987;65;0;0;0;0;.00nan;0;0
1788;31858;59;0;0;0;0;.00nan;0;0
1789;2163;39;65;27;3;24;.889;3600000;0
1789;2900;36;93;39;2;37;.949;3600000;0
1789;9238;39;0;0;0;0;.00nan;0;0
1789;14874;36;0;0;0;0;.00nan;0;0
1790;5298;55;0;0;0;0;.00nan;0;0
1790;28772;53;0;0;0;0;.00nan;0;0
1790;31156;53;69;31;3;28;.903;3900000;0
1790;34770;55;68;27;3;24;.889;3900000;0
1791;5137;58;0;0;0;0;.00nan;0;0
1791;6081;56;0;0;0;0;.00nan;0;0
1791;14321;58;57;34;4;30;.882;3572000;0
1791;26824;56;63;21;2;19;.905;3600000;0
1792;4447;54;41;37;6;31;.838;3600000;0
1792;31643;54;0;0;0;0;.00nan;0;0
1792;34788;42;0;0;0;0;.00nan;0;0
1792;37416;42;50;25;3;22;.880;3600000;0
1793;37;46;0;0;0;0;.00nan;0;0
1793;1486;43;93;28;1;27;.964;3600000;0
1793;2553;46;78;33;2;31;.939;3600000;0
1793;3625;43;0;0;0;0;.00nan;0;0
1794;3;50;67;30;3;27;.900;3600000;0
1794;751;64;0;0;0;0;.00nan;0;0
1794;5048;50;0;0;0;0;.00nan;0;0
1794;5146;64;55;36;5;31;.861;3581000;0
1795;376;45;0;0;0;0;.00nan;0;0
1795;2198;45;33;17;4;13;.765;3581000;0
1795;2296;37;61;30;3;27;.900;3600000;0
1795;5883;37;0;0;0;0;.00nan;0;0
1796;2152;49;93;40;3;37;.925;3635000;0
1796;4435;49;0;0;0;0;.00nan;0;0
1796;6572;62;86;36;2;34;.944;3635000;0
1796;26919;62;0;0;0;0;.00nan;0;0
1797;1051;44;0;0;0;0;.00nan;0;0
1797;3281;44;55;22;3;19;.864;3600000;0
1797;10698;4619;0;0;0;0;.00nan;0;0
1797;35210;4619;57;30;4;26;.867;3600000;0
1798;3626;48;0;0;0;0;.00nan;0;0
1798;20717;60;82;32;2;30;.938;3600000;0
1798;35536;60;0;0;0;0;.00nan;0;0
1798;38547;48;28;24;5;19;.792;3600000;0
1799;780;52;63;28;3;25;.893;3600000;0
1799;19640;41;68;33;4;29;.879;3600000;0
1799;23075;41;0;0;0;0;.00nan;0;0
1799;32146;52;0;0;0;0;.00nan;0;0
1800;3847;38;0;0;0;0;.00nan;0;0
1800;8046;57;0;0;0;0;.00nan;0;0
1800;26865;57;72;28;2;26;.929;3583000;0
1800;31021;38;95;25;1;24;.960;3600000;0
1801;751;64;75;33;2;31;.939;3723000;0
1801;1486;43;0;0;0;0;.00nan;0;0
1801;3625;43;81;41;3;38;.927;3723000;0
1801;5146;64;0;0;0;0;.00nan;0;0
1802;2796;59;0;0;0;0;.00nan;0;0
1802;4338;65;0;0;0;0;.00nan;0;0
1802;4987;65;85;40;3;37;.925;3855000;0
1802;31858;59;54;16;2;14;.875;3855000;0
1803;2152;49;0;0;0;0;.00nan;0;0
1803;4435;49;72;21;1;20;.952;3600000;0
1803;14351;40;57;49;6;43;.878;2992000;0
1803;26840;40;54;4;0;4;1.000;608000;0
1804;1051;44;15;24;6;18;.750;3030000;0
1804;3281;44;55;5;0;5;1.000;570000;0
1804;10698;4619;85;29;1;28;.966;3600000;0
1804;35210;4619;0;0;0;0;.00nan;0;0
1805;2016;61;0;0;0;0;.00nan;0;0
1805;7049;47;0;0;0;0;.00nan;0;0
1805;30971;61;87;33;2;31;.939;3600000;0
1805;33654;47;58;24;4;20;.833;3544000;0
1806;3;50;54;28;4;24;.857;3600000;0
1806;5048;50;0;0;0;0;.00nan;0;0
1806;34788;42;100;28;0;28;1.000;3600000;0
1806;37416;42;0;0;0;0;.00nan;0;0
1807;19640;41;0;0;0;0;.00nan;0;0
1807;23075;41;47;15;2;13;.867;3548000;0
1807;28772;53;99;37;1;36;.973;3600000;0
1807;31156;53;0;0;0;0;.00nan;0;0
1808;780;52;0;0;0;0;.00nan;0;0
1808;4338;65;29;28;6;22;.786;3583000;0
1808;4987;65;0;0;0;0;.00nan;0;0
1808;32146;52;68;44;5;39;.886;3600000;0
1809;6081;56;0;0;0;0;.00nan;0;0
1809;26824;56;83;41;3;38;.927;3900000;0
1809;31994;63;0;0;0;0;.00nan;0;0
1809;34814;63;76;29;3;26;.897;3900000;0
1810;2163;39;0;0;0;0;.00nan;0;0
1810;5298;55;80;31;2;29;.935;3600000;0
1810;9238;39;69;22;1;21;.955;3600000;0
1810;34770;55;0;0;0;0;.00nan;0;0
1811;2900;36;0;0;0;0;.00nan;0;0
1811;14874;36;60;20;2;18;.900;3600000;0
1811;23493;51;45;21;4;17;.810;3537000;0
1811;31822;51;0;0;0;0;.00nan;0;0
1812;2296;37;0;0;0;0;.00nan;0;0
1812;4447;54;71;26;2;24;.923;3900000;0
1812;5883;37;97;40;2;38;.950;3900000;0
1812;31643;54;0;0;0;0;.00nan;0;0
1813;37;46;0;0;0;0;.00nan;0;0
1813;751;64;0;0;0;0;.00nan;0;0
1813;2553;46;82;33;2;31;.939;3600000;0
1813;5146;64;58;24;3;21;.875;3544000;0
1814;1051;44;0;0;0;0;.00nan;0;0
1814;3281;44;69;48;5;43;.896;3600000;0
1814;20717;60;0;0;0;0;.00nan;0;0
1814;35536;60;72;28;2;26;.929;3600000;0
1815;3626;48;0;0;0;0;.00nan;0;0
1815;14351;40;65;23;2;21;.913;3900000;0
1815;26840;40;0;0;0;0;.00nan;0;0
1815;38547;48;76;31;2;29;.935;3900000;0
1816;2900;36;0;0;0;0;.00nan;0;0
1816;5298;55;0;0;0;0;.00nan;0;0
1816;14874;36;100;35;0;35;1.000;3600000;0
1816;34770;55;63;40;4;36;.900;3600000;0
1817;37;46;94;40;1;39;.975;3723000;0
1817;2296;37;0;0;0;0;.00nan;0;0
1817;2553;46;0;0;0;0;.00nan;0;0
1817;5883;37;89;31;2;29;.935;3723000;0
1818;3;50;0;0;0;0;.00nan;0;0
1818;751;64;0;0;0;0;.00nan;0;0
1818;5048;50;74;29;2;27;.931;3900000;0
1818;5146;64;70;24;2;22;.917;3900000;0
1819;3847;38;0;0;0;0;.00nan;0;0
1819;28772;53;62;39;5;34;.872;3582000;0
1819;31021;38;74;28;3;25;.893;3600000;0
1819;31156;53;0;0;0;0;.00nan;0;0
1820;2796;59;0;0;0;0;.00nan;0;0
1820;8046;57;0;0;0;0;.00nan;0;0
1820;26865;57;86;37;2;35;.946;3584000;0
1820;31858;59;87;29;1;28;.966;3600000;0
1821;5137;58;0;0;0;0;.00nan;0;0
1821;14321;58;47;21;3;18;.857;3853000;0
1821;23493;51;79;31;2;29;.935;3853000;0
1821;31822;51;0;0;0;0;.00nan;0;0
1822;2163;39;0;0;0;0;.00nan;0;0
1822;6081;56;0;0;0;0;.00nan;0;0
1822;9238;39;81;25;1;24;.960;3600000;0
1822;26824;56;62;41;5;36;.878;3600000;0
1823;1486;43;72;26;2;24;.923;3600000;0
1823;3625;43;0;0;0;0;.00nan;0;0
1823;34788;42;53;29;4;25;.862;3600000;0
1823;37416;42;0;0;0;0;.00nan;0;0
1824;4447;54;0;0;0;0;.00nan;0;0
1824;10698;4619;0;0;0;0;.00nan;0;0
1824;31643;54;79;35;3;32;.914;3575000;0
1824;35210;4619;80;31;1;30;.968;3600000;0
1825;7049;47;0;0;0;0;.00nan;0;0
1825;14351;40;86;38;3;35;.921;3558000;0
1825;26840;40;0;0;0;0;.00nan;0;0
1825;33654;47;66;25;2;23;.920;3600000;0
1826;2152;49;76;33;3;30;.909;3900000;0
1826;3626;48;83;31;3;28;.903;3900000;0
1826;4435;49;0;0;0;0;.00nan;0;0
1826;38547;48;0;0;0;0;.00nan;0;0
1827;2016;61;0;0;0;0;.00nan;0;0
1827;6572;62;0;0;0;0;.00nan;0;0
1827;26919;62;92;27;1;26;.963;3600000;0
1827;30971;61;81;46;4;42;.913;3600000;0
1828;1051;44;0;0;0;0;.00nan;0;0
1828;3281;44;47;26;4;22;.846;3600000;0
1828;20717;60;69;20;1;19;.950;3600000;0
1828;35536;60;0;0;0;0;.00nan;0;0
1829;3;50;86;16;0;16;1.000;3600000;0
1829;751;64;56;34;4;30;.882;3600000;0
1829;5048;50;0;0;0;0;.00nan;0;0
1829;5146;64;0;0;0;0;.00nan;0;0
1830;376;45;0;0;0;0;.00nan;0;0
1830;2198;45;74;33;3;30;.909;3585000;0
1830;19640;41;67;17;1;16;.941;3600000;0
1830;23075;41;0;0;0;0;.00nan;0;0
1831;2163;39;69;21;2;19;.905;3600000;0
1831;6081;56;50;38;5;33;.868;3600000;0
1831;9238;39;0;0;0;0;.00nan;0;0
1831;26824;56;0;0;0;0;.00nan;0;0
1832;23493;51;0;0;0;0;.00nan;0;0
1832;28772;53;0;0;0;0;.00nan;0;0
1832;31156;53;100;42;0;42;1.000;3600000;0
1832;31822;51;80;30;2;28;.933;3555000;0
1833;4338;65;0;0;0;0;.00nan;0;0
1833;4987;65;66;25;2;23;.920;3600000;0
1833;31994;63;55;24;3;21;.875;3557000;0
1833;34814;63;0;0;0;0;.00nan;0;0
1834;2900;36;0;0;0;0;.00nan;0;0
1834;5298;55;60;22;2;20;.909;3600000;0
1834;14874;36;60;28;3;25;.893;3552000;0
1834;34770;55;0;0;0;0;.00nan;0;0
1835;37;46;0;0;0;0;.00nan;0;0
1835;2296;37;69;27;3;24;.889;3900000;0
1835;2553;46;97;45;3;42;.933;3900000;0
1835;5883;37;0;0;0;0;.00nan;0;0
1836;1486;43;0;0;0;0;.00nan;0;0
1836;3625;43;96;33;1;32;.970;3600000;0
1836;34788;42;0;0;0;0;.00nan;0;0
1836;37416;42;63;22;2;20;.909;3581000;0
1837;2796;59;35;21;5;16;.762;3600000;0
1837;8046;57;80;26;1;25;.962;3600000;0
1837;26865;57;0;0;0;0;.00nan;0;0
1837;31858;59;0;0;0;0;.00nan;0;0
1838;3847;38;78;42;4;38;.905;3600000;0
1838;5137;58;30;32;6;26;.813;3522000;0
1838;14321;58;0;0;0;0;.00nan;0;0
1838;31021;38;0;0;0;0;.00nan;0;0
1839;4447;54;19;17;5;12;.706;2012000;0
1839;10698;4619;65;31;4;27;.871;3600000;0
1839;31643;54;53;21;3;18;.857;1588000;0
1839;35210;4619;0;0;0;0;.00nan;0;0
1840;7049;47;69;33;3;30;.909;3900000;0
1840;20717;60;0;0;0;0;.00nan;0;0
1840;33654;47;0;0;0;0;.00nan;0;0
1840;35536;60;51;21;3;18;.857;3900000;0
1841;2016;61;53;24;3;21;.875;3900000;0
1841;6572;62;56;27;3;24;.889;3900000;0
1841;26919;62;0;0;0;0;.00nan;0;0
1841;30971;61;0;0;0;0;.00nan;0;0
1842;1051;44;0;0;0;0;.00nan;0;0
1842;3281;44;38;28;5;23;.821;3600000;0
1842;14351;40;0;0;0;0;.00nan;0;0
1842;26840;40;72;31;2;29;.935;3600000;0
1843;2152;49;0;0;0;0;.00nan;0;0
1843;3626;48;0;0;0;0;.00nan;0;0
1843;4435;49;87;24;1;23;.958;3600000;0
1843;38547;48;96;44;2;42;.955;3569000;0
1844;376;45;22;11;4;7;.636;1170000;0
1844;2198;45;64;28;3;25;.893;2430000;0
1844;19640;41;0;0;0;0;.00nan;0;0
1844;23075;41;66;28;2;26;.929;3600000;0
1845;780;52;0;0;0;0;.00nan;0;0
1845;3847;38;52;3;0;3;1.000;867000;0
1845;31021;38;27;29;6;23;.793;2733000;0
1845;32146;52;58;19;2;17;.895;3600000;0
1846;8046;57;0;0;0;0;.00nan;0;0
1846;26865;57;95;38;2;36;.947;3600000;0
1846;31994;63;0;0;0;0;.00nan;0;0
1846;34814;63;65;39;4;35;.897;3566000;0
1847;2796;59;0;0;0;0;.00nan;0;0
1847;4338;65;33;29;6;23;.793;3600000;0
1847;4987;65;0;0;0;0;.00nan;0;0
1847;31858;59;100;41;1;40;.976;3600000;0
1848;2900;36;68;31;3;28;.903;3600000;0
1848;6081;56;0;0;0;0;.00nan;0;0
1848;14874;36;0;0;0;0;.00nan;0;0
1848;26824;56;64;34;4;30;.882;3573000;0
1849;751;64;97;50;1;49;.980;3582000;0
1849;5146;64;0;0;0;0;.00nan;0;0
1849;34788;42;72;9;0;9;1.000;3600000;0
1849;37416;42;0;0;0;0;.00nan;0;0
1850;3;50;77;28;2;26;.929;3600000;0
1850;4447;54;0;0;0;0;.00nan;0;0
1850;5048;50;0;0;0;0;.00nan;0;0
1850;31643;54;51;32;5;27;.844;3600000;0
1851;2016;61;0;0;0;0;.00nan;0;0
1851;2152;49;78;21;1;20;.952;3600000;0
1851;4435;49;0;0;0;0;.00nan;0;0
1851;30971;61;92;37;2;35;.946;3595000;0
1852;5137;58;0;0;0;0;.00nan;0;0
1852;14321;58;69;29;2;27;.931;3558000;0
1852;19640;41;80;21;1;20;.952;3600000;0
1852;23075;41;0;0;0;0;.00nan;0;0
1853;37;46;67;41;5;36;.878;3880000;0
1853;1486;43;0;0;0;0;.00nan;0;0
1853;2553;46;0;0;0;0;.00nan;0;0
1853;3625;43;52;27;4;23;.852;3880000;0
1854;6572;62;0;0;0;0;.00nan;0;0
1854;20717;60;72;19;1;18;.947;3600000;0
1854;26919;62;92;43;2;41;.953;3576000;0
1854;35536;60;0;0;0;0;.00nan;0;0
1855;1592;63;28;14;4;10;.714;758000;0
1855;28772;53;0;0;0;0;.00nan;0;0
1855;31156;53;100;33;0;33;1.000;3600000;0
1855;34814;63;45;28;4;24;.857;2842000;0
1856;2796;59;0;0;0;0;.00nan;0;0
1856;8046;57;0;0;0;0;.00nan;0;0
1856;26865;57;55;24;3;21;.875;3600000;0
1856;31858;59;82;29;2;27;.931;3600000;0
1857;2163;39;0;0;0;0;.00nan;0;0
1857;2900;36;0;0;0;0;.00nan;0;0
1857;9238;39;68;23;2;21;.913;3600000;0
1857;14874;36;65;37;5;32;.865;3600000;0
1858;5298;55;77;37;2;35;.946;3600000;0
1858;23493;51;33;24;5;19;.792;2150000;0
1858;31822;51;57;9;0;9;1.000;1450000;0
1858;34770;55;0;0;0;0;.00nan;0;0
1859;376;45;0;0;0;0;.00nan;0;0
1859;2198;45;81;30;2;28;.933;3600000;0
1859;4447;54;41;32;6;26;.813;3214000;0
1859;31643;54;52;2;0;2;1.000;386000;0
1860;1051;44;0;0;0;0;.00nan;0;0
1860;3281;44;100;26;0;26;1.000;3600000;0
1860;7049;47;0;0;0;0;.00nan;0;0
1860;33654;47;48;30;5;25;.833;3600000;0
1861;6572;62;44;35;5;30;.857;3600000;0
1861;14351;40;41;31;6;25;.806;3600000;0
1861;26840;40;0;0;0;0;.00nan;0;0
1861;26919;62;0;0;0;0;.00nan;0;0
1862;5137;58;0;0;0;0;.00nan;0;0
1862;14321;58;73;30;2;28;.933;3581000;0
1862;19640;41;0;0;0;0;.00nan;0;0
1862;23075;41;92;28;1;27;.964;3600000;0
1863;2900;36;0;0;0;0;.00nan;0;0
1863;5298;55;80;22;2;20;.909;3600000;0
1863;14874;36;41;29;5;24;.828;3600000;0
1863;34770;55;0;0;0;0;.00nan;0;0
1864;1486;43;0;0;0;0;.00nan;0;0
1864;2163;39;0;0;0;0;.00nan;0;0
1864;3625;43;62;23;2;21;.913;3576000;0
1864;9238;39;76;25;1;24;.960;3600000;0
1865;6081;56;0;0;0;0;.00nan;0;0
1865;23493;51;74;35;3;32;.914;3600000;0
1865;26824;56;53;30;5;25;.833;3589000;0
1865;31822;51;0;0;0;0;.00nan;0;0
1866;780;52;0;0;0;0;.00nan;0;0
1866;3847;38;0;0;0;0;.00nan;0;0
1866;31021;38;72;24;2;22;.917;3546000;0
1866;32146;52;90;28;1;27;.964;3600000;0
1867;1592;63;0;0;0;0;.00nan;0;0
1867;2796;59;0;0;0;0;.00nan;0;0
1867;31858;59;86;15;0;15;1.000;3600000;0
1867;34814;63;83;35;3;32;.914;3600000;0
1868;376;45;0;0;0;0;.00nan;0;0
1868;2198;45;29;26;5;21;.808;3551000;0
1868;34788;42;63;32;4;28;.875;3600000;0
1868;37416;42;0;0;0;0;.00nan;0;0
1869;3;50;76;25;1;24;.960;3600000;0
1869;5048;50;0;0;0;0;.00nan;0;0
1869;10698;4619;0;0;0;0;.00nan;0;0
1869;35210;4619;60;28;3;25;.893;3544000;0
1870;3626;48;24;5;3;2;.400;527000;0
1870;14351;40;84;29;2;27;.931;3600000;0
1870;26840;40;0;0;0;0;.00nan;0;0
1870;38547;48;45;18;3;15;.833;3073000;0
1871;1486;43;57;24;3;21;.875;3546000;0
1871;2163;39;74;30;2;28;.933;3600000;0
1871;3625;43;0;0;0;0;.00nan;0;0
1871;9238;39;0;0;0;0;.00nan;0;0
1872;751;64;56;4;0;4;1.000;511000;0
1872;2296;37;0;0;0;0;.00nan;0;0
1872;5146;64;43;36;6;30;.833;3089000;0
1872;5883;37;79;28;2;26;.929;3600000;0
1873;8046;57;0;0;0;0;.00nan;0;0
1873;19640;41;0;0;0;0;.00nan;0;0
1873;23075;41;62;30;4;26;.867;3900000;0
1873;26865;57;76;34;4;30;.882;3900000;0
1874;1592;63;85;29;1;28;.966;3600000;0
1874;2796;59;0;0;0;0;.00nan;0;0
1874;31858;59;46;29;5;24;.828;3600000;0
1874;34814;63;0;0;0;0;.00nan;0;0
1875;780;52;0;0;0;0;.00nan;0;0
1875;3847;38;53;35;5;30;.857;3867000;0
1875;31021;38;0;0;0;0;.00nan;0;0
1875;32146;52;50;30;5;25;.833;3900000;0
1876;4338;65;77;31;2;29;.935;3600000;0
1876;4987;65;0;0;0;0;.00nan;0;0
1876;28772;53;0;0;0;0;.00nan;0;0
1876;31156;53;81;36;3;33;.917;3548000;0
1877;2900;36;52;21;2;19;.905;3900000;0
1877;5298;55;0;0;0;0;.00nan;0;0
1877;14874;36;0;0;0;0;.00nan;0;0
1877;34770;55;82;33;2;31;.939;3900000;0
1878;6081;56;46;17;3;14;.824;3532000;0
1878;23493;51;0;0;0;0;.00nan;0;0
1878;26824;56;0;0;0;0;.00nan;0;0
1878;31822;51;81;27;1;26;.963;3600000;0
1879;37;46;71;30;2;28;.933;3600000;0
1879;2553;46;0;0;0;0;.00nan;0;0
1879;4447;54;0;0;0;0;.00nan;0;0
1879;31643;54;57;29;3;26;.897;3600000;0
1880;376;45;62;28;3;25;.893;3600000;0
1880;2198;45;0;0;0;0;.00nan;0;0
1880;34788;42;0;0;0;0;.00nan;0;0
1880;37416;42;54;33;4;29;.879;3557000;0
1881;1051;44;0;0;0;0;.00nan;0;0
1881;2152;49;61;35;4;31;.886;3900000;0
1881;3281;44;78;47;4;43;.915;3900000;0
1881;4435;49;0;0;0;0;.00nan;0;0
1882;3626;48;69;39;4;35;.897;3900000;0
1882;14351;40;0;0;0;0;.00nan;0;0
1882;26840;40;61;27;4;23;.852;3900000;0
1882;38547;48;0;0;0;0;.00nan;0;0
1883;3;50;0;0;0;0;.00nan;0;0
1883;5048;50;70;28;2;26;.929;3600000;0
1883;10698;4619;97;23;0;23;1.000;3600000;0
1883;35210;4619;0;0;0;0;.00nan;0;0
1884;7049;47;81;28;1;27;.964;3600000;0
1884;20717;60;46;20;3;17;.850;3579000;0
1884;33654;47;0;0;0;0;.00nan;0;0
1884;35536;60;0;0;0;0;.00nan;0;0
1885;2016;61;0;0;0;0;.00nan;0;0
1885;6572;62;0;0;0;0;.00nan;0;0
1885;26919;62;83;38;3;35;.921;3516000;0
1885;30971;61;70;21;1;20;.952;3600000;0
1886;8046;57;90;39;1;38;.974;3900000;0
1886;19640;41;65;13;1;12;.923;3900000;0
1886;23075;41;0;0;0;0;.00nan;0;0
1886;26865;57;0;0;0;0;.00nan;0;0
1887;780;52;0;0;0;0;.00nan;0;0
1887;5137;58;0;0;0;0;.00nan;0;0
1887;14321;58;63;25;3;22;.880;3529000;0
1887;32146;52;86;29;1;28;.966;3600000;0
1888;4338;65;0;0;0;0;.00nan;0;0
1888;4987;65;92;18;0;18;1.000;3600000;0
1888;28772;53;76;39;3;36;.923;3600000;0
1888;31156;53;0;0;0;0;.00nan;0;0
1889;751;64;82;45;4;41;.911;3514000;0
1889;2296;37;70;28;2;26;.929;3600000;0
1889;5146;64;0;0;0;0;.00nan;0;0
1889;5883;37;0;0;0;0;.00nan;0;0
1890;1051;44;0;0;0;0;.00nan;0;0
1890;2152;49;0;0;0;0;.00nan;0;0
1890;3281;44;62;36;5;31;.861;3900000;0
1890;4435;49;37;28;5;23;.821;3900000;0
1891;2016;61;58;27;3;24;.889;3565000;0
1891;6572;62;77;29;2;27;.931;3600000;0
1891;26919;62;0;0;0;0;.00nan;0;0
1891;30971;61;0;0;0;0;.00nan;0;0
1892;7049;47;0;0;0;0;.00nan;0;0
1892;20717;60;0;0;0;0;.00nan;0;0
1892;33654;47;78;27;1;26;.963;3600000;0
1892;35536;60;58;29;3;26;.897;3562000;0
1893;2796;59;0;0;0;0;.00nan;0;0
1893;4338;65;0;0;0;0;.00nan;0;0
1893;4987;65;49;19;3;16;.842;3600000;0
1893;31858;59;44;29;5;24;.828;3600000;0
1894;2152;49;26;30;6;24;.800;3563000;0
1894;4435;49;0;0;0;0;.00nan;0;0
1894;20717;60;58;31;4;27;.871;3600000;0
1894;35536;60;0;0;0;0;.00nan;0;0
1895;1486;43;0;0;0;0;.00nan;0;0
1895;2900;36;0;0;0;0;.00nan;0;0
1895;3625;43;73;36;3;33;.917;3579000;0
1895;14874;36;77;18;1;17;.944;3600000;0
1896;3847;38;0;0;0;0;.00nan;0;0
1896;5298;55;73;27;3;24;.889;3900000;0
1896;31021;38;67;31;3;28;.903;3900000;0
1896;34770;55;0;0;0;0;.00nan;0;0
1897;37;46;91;35;2;33;.943;3900000;0
1897;2553;46;0;0;0;0;.00nan;0;0
1897;4447;54;0;0;0;0;.00nan;0;0
1897;31643;54;70;17;2;15;.882;3900000;0
1898;376;45;71;37;3;34;.919;3900000;0
1898;751;64;0;0;0;0;.00nan;0;0
1898;2198;45;0;0;0;0;.00nan;0;0
1898;5146;64;66;31;3;28;.903;3900000;0
1899;3;50;88;37;3;34;.919;3600000;0
1899;5048;50;0;0;0;0;.00nan;0;0
1899;34788;42;62;34;4;30;.882;3562000;0
1899;37416;42;0;0;0;0;.00nan;0;0
1900;1051;44;0;0;0;0;.00nan;0;0
1900;3281;44;63;21;3;18;.857;3600000;0
1900;7049;47;0;0;0;0;.00nan;0;0
1900;33654;47;48;36;5;31;.861;3523000;0
1901;6572;62;0;0;0;0;.00nan;0;0
1901;10698;4619;46;22;3;19;.864;3573000;0
1901;26919;62;96;45;1;44;.978;3600000;0
1901;35210;4619;0;0;0;0;.00nan;0;0
1902;3847;38;20;17;5;12;.706;1925000;0
1902;28772;53;58;31;4;27;.871;3600000;0
1902;31021;38;17;19;6;13;.684;1675000;0
1902;31156;53;0;0;0;0;.00nan;0;0
1903;1486;43;0;0;0;0;.00nan;0;0
1903;2796;59;0;0;0;0;.00nan;0;0
1903;3625;43;64;28;3;25;.893;3534000;0
1903;31858;59;74;20;1;19;.950;3600000;0
1904;5298;55;92;46;3;43;.935;3728000;0
1904;19640;41;0;0;0;0;.00nan;0;0
1904;23075;41;60;21;2;19;.905;3728000;0
1904;34770;55;0;0;0;0;.00nan;0;0
1905;1592;63;62;33;4;29;.879;3552000;0
1905;6081;56;0;0;0;0;.00nan;0;0
1905;26824;56;89;36;2;34;.944;3600000;0
1905;34814;63;0;0;0;0;.00nan;0;0
1906;5137;58;0;0;0;0;.00nan;0;0
1906;8046;57;0;0;0;0;.00nan;0;0
1906;14321;58;92;17;0;17;1.000;3600000;0
1906;26865;57;98;44;2;42;.955;3527000;0
1907;2163;39;0;0;0;0;.00nan;0;0
1907;2900;36;0;0;0;0;.00nan;0;0
1907;9238;39;69;24;2;22;.917;3600000;0
1907;14874;36;50;38;5;33;.868;3600000;0
1908;4447;54;0;0;0;0;.00nan;0;0
1908;31643;54;81;27;1;26;.963;3600000;0
1908;34788;42;41;28;5;23;.821;3600000;0
1908;37416;42;0;0;0;0;.00nan;0;0
1909;37;46;0;0;0;0;.00nan;0;0
1909;751;64;0;0;0;0;.00nan;0;0
1909;2553;46;61;34;4;30;.882;3600000;0
1909;5146;64;81;31;1;30;.968;3600000;0
1910;376;45;0;0;0;0;.00nan;0;0
1910;2198;45;70;32;3;29;.906;3546000;0
1910;23493;51;75;30;2;28;.933;3600000;0
1910;31822;51;0;0;0;0;.00nan;0;0
1911;3;50;43;34;6;28;.824;3570000;0
1911;5048;50;0;0;0;0;.00nan;0;0
1911;6572;62;0;0;0;0;.00nan;0;0
1911;26919;62;57;27;4;23;.852;3600000;0
1912;1051;44;0;0;0;0;.00nan;0;0
1912;3281;44;49;21;4;17;.810;3600000;0
1912;7049;47;0;0;0;0;.00nan;0;0
1912;33654;47;100;31;0;31;1.000;3600000;0
1913;2152;49;71;28;3;25;.893;3600000;0
1913;4435;49;0;0;0;0;.00nan;0;0
1913;20717;60;0;0;0;0;.00nan;0;0
1913;35536;60;61;41;5;36;.878;3548000;0
1914;3626;48;0;0;0;0;.00nan;0;0
1914;10698;4619;56;24;3;21;.875;3542000;0
1914;35210;4619;0;0;0;0;.00nan;0;0
1914;38547;48;90;46;2;44;.957;3600000;0
1915;2016;61;0;0;0;0;.00nan;0;0
1915;2296;37;0;0;0;0;.00nan;0;0
1915;5883;37;89;36;3;33;.917;3572000;0
1915;30971;61;53;17;2;15;.882;3600000;0
1916;2163;39;74;24;2;22;.917;3900000;0
1916;5298;55;0;0;0;0;.00nan;0;0
1916;9238;39;0;0;0;0;.00nan;0;0
1916;34770;55;97;36;2;34;.944;3900000;0
1917;8046;57;100;42;0;42;1.000;3600000;0
1917;26865;57;0;0;0;0;.00nan;0;0
1917;28772;53;0;0;0;0;.00nan;0;0
1917;31156;53;65;23;2;21;.913;3582000;0
1918;780;52;0;0;0;0;.00nan;0;0
1918;4338;65;0;0;0;0;.00nan;0;0
1918;4987;65;71;25;2;23;.920;3551000;0
1918;32146;52;78;25;1;24;.960;3600000;0
1919;2900;36;84;35;2;33;.943;3900000;0
1919;14874;36;0;0;0;0;.00nan;0;0
1919;19640;41;90;35;2;33;.943;3900000;0
1919;23075;41;0;0;0;0;.00nan;0;0
1920;1486;43;35;31;6;25;.806;3600000;0
1920;2796;59;0;0;0;0;.00nan;0;0
1920;3625;43;0;0;0;0;.00nan;0;0
1920;31858;59;90;37;1;36;.973;3600000;0
1921;1592;63;0;0;0;0;.00nan;0;0
1921;6081;56;61;27;3;24;.889;3600000;0
1921;26824;56;0;0;0;0;.00nan;0;0
1921;34814;63;60;35;4;31;.886;3600000;0
1922;37;46;58;41;5;36;.878;3590000;0
1922;2553;46;0;0;0;0;.00nan;0;0
1922;4447;54;44;25;4;21;.840;3600000;0
1922;31643;54;0;0;0;0;.00nan;0;0
1923;3;50;64;34;3;31;.912;2976000;0
1923;5048;50;22;5;3;2;.400;574000;0
1923;6572;62;54;26;4;22;.846;3600000;0
1923;26919;62;0;0;0;0;.00nan;0;0
1924;3847;38;43;41;6;35;.854;3600000;0
1924;5137;58;0;0;0;0;.00nan;0;0
1924;14321;58;97;38;2;36;.947;3600000;0
1924;31021;38;0;0;0;0;.00nan;0;0
1925;751;64;100;25;0;25;1.000;3600000;0
1925;5146;64;0;0;0;0;.00nan;0;0
1925;34788;42;42;34;5;29;.853;3600000;0
1925;37416;42;0;0;0;0;.00nan;0;0
1926;376;45;100;33;0;33;1.000;3600000;0
1926;2198;45;0;0;0;0;.00nan;0;0
1926;23493;51;0;0;0;0;.00nan;0;0
1926;31822;51;60;24;4;20;.833;3600000;0
1927;2152;49;0;0;0;0;.00nan;0;0
1927;4435;49;83;23;1;22;.957;3600000;0
1927;14351;40;57;22;3;19;.864;3519000;0
1927;26840;40;0;0;0;0;.00nan;0;0
1928;1051;44;53;26;3;23;.885;3555000;0
1928;3281;44;0;0;0;0;.00nan;0;0
1928;7049;47;0;0;0;0;.00nan;0;0
1928;33654;47;77;30;2;28;.933;3600000;0
1929;3626;48;60;32;4;28;.875;3600000;0
1929;10698;4619;55;4;0;4;1.000;638000;0
1929;35210;4619;26;35;7;28;.800;2962000;0
1929;38547;48;0;0;0;0;.00nan;0;0
1930;2016;61;0;0;0;0;.00nan;0;0
1930;2296;37;55;32;4;28;.875;3568000;0
1930;5883;37;0;0;0;0;.00nan;0;0
1930;30971;61;64;20;2;18;.900;3600000;0
1931;4338;65;58;25;3;22;.880;3600000;0
1931;4987;65;0;0;0;0;.00nan;0;0
1931;8046;57;61;56;7;49;.875;3600000;0
1931;26865;57;0;0;0;0;.00nan;0;0
1932;780;52;0;0;0;0;.00nan;0;0
1932;8046;57;72;28;2;26;.929;3832000;0
1932;26865;57;0;0;0;0;.00nan;0;0
1932;32146;52;76;23;1;22;.957;3832000;0
1933;4338;65;0;0;0;0;.00nan;0;0
1933;4987;65;59;32;4;28;.875;3900000;0
1933;28772;53;81;41;4;37;.902;3900000;0
1933;31156;53;0;0;0;0;.00nan;0;0
1934;5298;55;70;30;3;27;.900;3600000;0
1934;23493;51;78;49;4;45;.918;3562000;0
1934;31822;51;0;0;0;0;.00nan;0;0
1934;34770;55;0;0;0;0;.00nan;0;0
1935;2900;36;87;33;2;31;.939;3676000;0
1935;6081;56;0;0;0;0;.00nan;0;0
1935;14874;36;0;0;0;0;.00nan;0;0
1935;26824;56;96;32;1;31;.969;3676000;0
1936;2796;59;0;0;0;0;.00nan;0;0
1936;5137;58;0;0;0;0;.00nan;0;0
1936;14321;58;58;30;4;26;.867;3600000;0
1936;31858;59;86;28;1;27;.964;3600000;0
1937;2163;39;0;0;0;0;.00nan;0;0
1937;9238;39;91;33;1;32;.970;3600000;0
1937;19640;41;32;9;3;6;.667;1569000;0
1937;23075;41;28;26;6;20;.769;2031000;0
1938;4447;54;0;0;0;0;.00nan;0;0
1938;31643;54;61;25;3;22;.880;3876000;0
1938;34788;42;81;35;3;32;.914;3900000;0
1938;37416;42;0;0;0;0;.00nan;0;0
1939;6572;62;0;0;0;0;.00nan;0;0
1939;10698;4619;0;0;0;0;.00nan;0;0
1939;26919;62;62;30;4;26;.867;3574000;0
1939;35210;4619;77;30;3;27;.900;3600000;0
1940;3626;48;96;32;1;31;.969;3600000;0
1940;20717;60;0;0;0;0;.00nan;0;0
1940;35536;60;52;26;4;22;.846;3600000;0
1940;38547;48;0;0;0;0;.00nan;0;0
1941;1486;43;0;0;0;0;.00nan;0;0
1941;1592;63;0;0;0;0;.00nan;0;0
1941;3625;43;100;25;0;25;1.000;3600000;0
1941;34814;63;83;33;2;31;.939;3545000;0
1942;3626;48;0;0;0;0;.00nan;0;0
1942;20717;60;75;25;1;24;.960;3600000;0
1942;35536;60;0;0;0;0;.00nan;0;0
1942;38547;48;79;42;3;39;.929;3600000;0
1943;2016;61;0;0;0;0;.00nan;0;0
1943;14351;40;59;28;3;25;.893;3600000;0
1943;26840;40;0;0;0;0;.00nan;0;0
1943;30971;61;70;24;2;22;.917;3600000;0
1944;1486;43;0;0;0;0;.00nan;0;0
1944;3625;43;81;44;4;40;.909;3600000;0
1944;4338;65;0;0;0;0;.00nan;0;0
1944;4987;65;70;24;2;22;.917;3600000;0
1945;5298;55;81;30;2;28;.933;3611000;0
1945;23493;51;99;37;1;36;.973;3611000;0
1945;31822;51;0;0;0;0;.00nan;0;0
1945;34770;55;0;0;0;0;.00nan;0;0
1946;2900;36;62;14;1;13;.929;3600000;0
1946;6081;56;0;0;0;0;.00nan;0;0
1946;14874;36;0;0;0;0;.00nan;0;0
1946;26824;56;72;36;4;32;.889;3600000;0
1947;37;46;97;31;1;30;.968;3600000;0
1947;2152;49;0;0;0;0;.00nan;0;0
1947;2553;46;0;0;0;0;.00nan;0;0
1947;4435;49;46;25;4;21;.840;3600000;0
1948;3847;38;0;0;0;0;.00nan;0;0
1948;8046;57;74;40;3;37;.925;3586000;0
1948;26865;57;0;0;0;0;.00nan;0;0
1948;31021;38;73;29;2;27;.931;3600000;0
1949;780;52;0;0;0;0;.00nan;0;0
1949;2796;59;0;0;0;0;.00nan;0;0
1949;31858;59;58;19;2;17;.895;3600000;0
1949;32146;52;59;36;5;31;.861;3600000;0
1950;5137;58;0;0;0;0;.00nan;0;0
1950;14321;58;100;48;2;46;.958;3600000;0
1950;28772;53;80;32;3;29;.906;3600000;0
1950;31156;53;0;0;0;0;.00nan;0;0
1951;2163;39;0;0;0;0;.00nan;0;0
1951;9238;39;74;35;4;31;.886;3573000;0
1951;19640;41;72;32;2;30;.938;3600000;0
1951;23075;41;0;0;0;0;.00nan;0;0
1952;376;45;72;40;4;36;.900;3600000;0
1952;2198;45;0;0;0;0;.00nan;0;0
1952;2296;37;0;0;0;0;.00nan;0;0
1952;5883;37;21;23;6;17;.739;3600000;0
1953;751;64;86;38;3;35;.921;3600000;0
1953;4447;54;0;0;0;0;.00nan;0;0
1953;5146;64;0;0;0;0;.00nan;0;0
1953;31643;54;44;21;4;17;.810;3600000;0
1954;3;50;0;0;0;0;.00nan;0;0
1954;5048;50;77;31;2;29;.935;3546000;0
1954;34788;42;99;36;1;35;.972;3600000;0
1954;37416;42;0;0;0;0;.00nan;0;0
1955;7049;47;0;0;0;0;.00nan;0;0
1955;10698;4619;0;0;0;0;.00nan;0;0
1955;33654;47;67;33;4;29;.879;3900000;0
1955;35210;4619;47;26;4;22;.846;3898000;0
1956;1051;44;0;0;0;0;.00nan;0;0
1956;3281;44;58;37;5;32;.865;3600000;0
1956;6572;62;0;0;0;0;.00nan;0;0
1956;26919;62;57;33;4;29;.879;3600000;0
1957;2016;61;72;30;2;28;.933;3539000;0
1957;14351;40;0;0;0;0;.00nan;0;0
1957;26840;40;100;28;0;28;1.000;3600000;0
1957;30971;61;0;0;0;0;.00nan;0;0
1958;1486;43;94;36;1;35;.972;3600000;0
1958;3625;43;0;0;0;0;.00nan;0;0
1958;4338;65;76;35;3;32;.914;3548000;0
1958;4987;65;0;0;0;0;.00nan;0;0
1959;1592;63;0;0;0;0;.00nan;0;0
1959;2267;39;37;11;3;8;.727;1275000;0
1959;9238;39;16;21;6;15;.714;2325000;0
1959;34814;63;89;38;3;35;.921;3600000;0
1960;2796;59;87;30;1;29;.967;3600000;0
1960;3847;38;80;35;2;33;.943;3580000;0
1960;31021;38;0;0;0;0;.00nan;0;0
1960;31858;59;0;0;0;0;.00nan;0;0
1961;2900;36;0;0;0;0;.00nan;0;0
1961;14874;36;76;33;2;31;.939;3705000;0
1961;19640;41;0;0;0;0;.00nan;0;0
1961;23075;41;49;19;3;16;.842;3705000;0
1962;5137;58;46;5;1;4;.800;717000;0
1962;5298;55;0;0;0;0;.00nan;0;0
1962;14321;58;19;27;7;20;.741;2883000;0
1962;34770;55;79;26;1;25;.962;3600000;0
1963;6081;56;60;27;3;24;.889;3600000;0
1963;23493;51;0;0;0;0;.00nan;0;0
1963;26824;56;0;0;0;0;.00nan;0;0
1963;31822;51;35;17;4;13;.765;3568000;0
1964;376;45;0;0;0;0;.00nan;0;0
1964;2198;45;44;32;5;27;.844;3600000;0
1964;2296;37;95;39;2;37;.949;3600000;0
1964;5883;37;0;0;0;0;.00nan;0;0
1965;751;64;0;0;0;0;.00nan;0;0
1965;4447;54;81;39;3;36;.923;3900000;0
1965;5146;64;90;41;3;38;.927;3900000;0
1965;31643;54;0;0;0;0;.00nan;0;0
1966;37;46;0;0;0;0;.00nan;0;0
1966;2152;49;84;33;2;31;.939;3600000;0
1966;2553;46;39;32;6;26;.813;3600000;0
1966;4435;49;0;0;0;0;.00nan;0;0
1967;3;50;74;30;3;27;.900;3838000;0
1967;5048;50;0;0;0;0;.00nan;0;0
1967;34788;42;0;0;0;0;.00nan;0;0
1967;37416;42;70;23;2;21;.913;3838000;0
1968;780;52;0;0;0;0;.00nan;0;0
1968;8046;57;0;0;0;0;.00nan;0;0
1968;26865;57;100;46;1;45;.978;3600000;0
1968;32146;52;50;23;3;20;.870;3559000;0
1969;7049;47;67;21;2;19;.905;3527000;0
1969;10698;4619;88;15;0;15;1.000;3600000;0
1969;33654;47;0;0;0;0;.00nan;0;0
1969;35210;4619;0;0;0;0;.00nan;0;0
1970;1051;44;45;32;4;28;.875;3600000;0
1970;3281;44;0;0;0;0;.00nan;0;0
1970;6572;62;70;39;3;36;.923;3600000;0
1970;26919;62;0;0;0;0;.00nan;0;0
1971;3;50;0;0;0;0;.00nan;0;0
1971;37;46;68;35;4;31;.886;3600000;0
1971;2553;46;0;0;0;0;.00nan;0;0
1971;5048;50;82;36;3;33;.917;3600000;0
1972;5137;58;0;0;0;0;.00nan;0;0
1972;14321;58;29;23;5;18;.783;3600000;0
1972;28772;53;99;39;2;37;.949;3600000;0
1972;38651;53;0;0;0;0;.00nan;0;0
1973;780;52;0;0;0;0;.00nan;0;0
1973;19640;41;99;23;0;23;1.000;3600000;0
1973;23075;41;0;0;0;0;.00nan;0;0
1973;32146;52;56;40;6;34;.850;3600000;0
1974;1486;43;0;0;0;0;.00nan;0;0
1974;3625;43;83;29;2;27;.931;3600000;0
1974;5298;55;72;37;3;34;.919;3600000;0
1974;34770;55;0;0;0;0;.00nan;0;0
1975;2900;36;77;17;1;16;.941;3600000;0
1975;14874;36;0;0;0;0;.00nan;0;0
1975;23493;51;76;26;2;24;.923;3546000;0
1975;31822;51;0;0;0;0;.00nan;0;0
1976;2267;39;0;0;0;0;.00nan;0;0
1976;3847;38;0;0;0;0;.00nan;0;0
1976;9238;39;96;35;2;33;.943;3535000;0
1976;31021;38;100;34;0;34;1.000;3600000;0
1977;4338;65;0;0;0;0;.00nan;0;0
1977;4987;65;49;17;3;14;.824;3900000;0
1977;8046;57;0;0;0;0;.00nan;0;0
1977;26865;57;85;38;3;35;.921;3900000;0
1978;2796;59;0;0;0;0;.00nan;0;0
1978;6081;56;56;11;1;10;.909;635000;0
1978;26824;56;37;34;6;28;.824;2965000;0
1978;31858;59;69;23;2;21;.913;3600000;0
1979;751;64;71;32;3;29;.906;3600000;0
1979;5146;64;0;0;0;0;.00nan;0;0
1979;34788;42;46;22;4;18;.818;3557000;0
1979;37416;42;0;0;0;0;.00nan;0;0
1980;376;45;0;0;0;0;.00nan;0;0
1980;2198;45;72;26;2;24;.923;3600000;0
1980;4447;54;0;0;0;0;.00nan;0;0
1980;31643;54;72;23;1;22;.957;3600000;0
1981;3;50;74;36;3;33;.917;3600000;0
1981;37;46;0;0;0;0;.00nan;0;0
1981;2553;46;57;30;4;26;.867;3580000;0
1981;5048;50;0;0;0;0;.00nan;0;0
1982;1051;44;0;0;0;0;.00nan;0;0
1982;3281;44;87;31;1;30;.968;3600000;0
1982;10698;4619;71;30;2;28;.933;3600000;0
1982;35210;4619;0;0;0;0;.00nan;0;0
1983;3626;48;34;38;7;31;.816;3600000;0
1983;7049;47;0;0;0;0;.00nan;0;0
1983;33654;47;83;27;2;25;.926;3600000;0
1983;38547;48;0;0;0;0;.00nan;0;0
1984;6572;62;0;0;0;0;.00nan;0;0
1984;20717;60;64;34;4;30;.882;3600000;0
1984;26919;62;82;28;1;27;.964;3600000;0
1984;35536;60;0;0;0;0;.00nan;0;0
1985;2152;49;41;14;3;11;.786;3600000;0
1985;14351;40;0;0;0;0;.00nan;0;0
1985;26840;40;39;22;4;18;.818;3600000;0
1985;38817;49;0;0;0;0;.00nan;0;0
1986;2016;61;0;0;0;0;.00nan;0;0
1986;2296;37;0;0;0;0;.00nan;0;0
1986;5883;37;50;20;3;17;.850;3557000;0
1986;30971;61;100;42;1;41;.976;3600000;0
1987;2900;36;0;0;0;0;.00nan;0;0
1987;14874;36;69;21;1;20;.952;3600000;0
1987;23493;51;0;0;0;0;.00nan;0;0
1987;31822;51;91;42;2;40;.952;3565000;0
1988;780;52;0;0;0;0;.00nan;0;0
1988;19640;41;0;0;0;0;.00nan;0;0
1988;23075;41;62;20;2;18;.900;3600000;0
1988;32146;52;99;36;1;35;.972;3600000;0
1989;2267;39;92;22;0;22;1.000;3600000;0
1989;9238;39;0;0;0;0;.00nan;0;0
1989;28772;53;0;0;0;0;.00nan;0;0
1989;38651;53;97;45;1;44;.978;3553000;0
1990;4338;65;65;17;1;16;.941;3600000;0
1990;4987;65;0;0;0;0;.00nan;0;0
1990;6081;56;81;37;3;34;.919;3066000;0
1990;26824;56;32;7;3;4;.571;534000;0
1991;1486;43;49;23;4;19;.826;3900000;0
1991;3625;43;0;0;0;0;.00nan;0;0
1991;5298;55;0;0;0;0;.00nan;0;0
1991;34770;55;94;47;4;43;.915;3900000;0
1992;2796;59;77;20;1;19;.950;3600000;0
1992;8046;57;58;38;5;33;.868;3600000;0
1992;26865;57;0;0;0;0;.00nan;0;0
1992;31858;59;0;0;0;0;.00nan;0;0
1993;3847;38;0;0;0;0;.00nan;0;0
1993;5137;58;0;0;0;0;.00nan;0;0
1993;14321;58;53;22;3;19;.864;3552000;0
1993;31021;38;81;33;2;31;.939;3600000;0
1994;751;64;0;0;0;0;.00nan;0;0
1994;5146;64;48;32;6;26;.813;3600000;0
1994;34788;42;49;30;5;25;.833;3600000;0
1994;37416;42;0;0;0;0;.00nan;0;0
1995;376;45;53;35;5;30;.857;3600000;0
1995;2198;45;0;0;0;0;.00nan;0;0
1995;4447;54;79;22;1;21;.955;3600000;0
1995;31643;54;0;0;0;0;.00nan;0;0
1996;2152;49;0;0;0;0;.00nan;0;0
1996;14351;40;56;33;4;29;.879;3600000;0
1996;26840;40;0;0;0;0;.00nan;0;0
1996;38817;49;62;16;1;15;.938;3600000;0
1997;1051;44;100;29;0;29;1.000;3600000;0
1997;3281;44;0;0;0;0;.00nan;0;0
1997;10698;4619;0;0;0;0;.00nan;0;0
1997;35210;4619;91;28;1;27;.964;3554000;0
1998;3626;48;67;38;4;34;.895;3600000;0
1998;7049;47;90;20;0;20;1.000;3600000;0
1998;33654;47;0;0;0;0;.00nan;0;0
1998;38547;48;0;0;0;0;.00nan;0;0
1999;2016;61;81;33;2;31;.939;3600000;0
1999;2296;37;80;40;3;37;.925;3560000;0
1999;5883;37;0;0;0;0;.00nan;0;0
1999;30971;61;0;0;0;0;.00nan;0;0
2000;751;64;77;43;5;38;.884;3600000;0
2000;4447;54;0;0;0;0;.00nan;0;0
2000;5146;64;0;0;0;0;.00nan;0;0
2000;31643;54;73;25;1;24;.960;3600000;0
2001;780;52;0;0;0;0;.00nan;0;0
2001;2267;39;86;28;2;26;.929;3900000;0
2001;9238;39;0;0;0;0;.00nan;0;0
2001;32146;52;88;34;2;32;.941;3900000;0
2002;2796;59;0;0;0;0;.00nan;0;0
2002;2841;41;0;0;0;0;.00nan;0;0
2002;19640;41;71;22;2;20;.909;3600000;0
2002;31858;59;75;39;3;36;.923;3550000;0
2003;37;46;55;25;3;22;.880;3600000;0
2003;376;45;0;0;0;0;.00nan;0;0
2003;2198;45;97;22;0;22;1.000;3600000;0
2003;2553;46;0;0;0;0;.00nan;0;0
2004;10698;4619;25;18;5;13;.722;3546000;0
2004;25153;48;0;0;0;0;.00nan;0;0
2004;35210;4619;0;0;0;0;.00nan;0;0
2004;38547;48;86;49;4;45;.918;3600000;0
2005;1592;63;65;32;3;29;.906;3600000;0
2005;5298;55;46;27;4;23;.852;2351000;0
2005;31994;63;0;0;0;0;.00nan;0;0
2005;34770;55;46;12;2;10;.833;1249000;0
2006;2796;59;0;0;0;0;.00nan;0;0
2006;2841;41;93;30;1;29;.967;3600000;0
2006;19640;41;0;0;0;0;.00nan;0;0
2006;31858;59;59;20;2;18;.900;3550000;0
2007;6081;56;0;0;0;0;.00nan;0;0
2007;23493;51;99;25;0;25;1.000;3600000;0
2007;26824;56;91;30;2;28;.933;3600000;0
2007;31822;51;0;0;0;0;.00nan;0;0
2008;5137;58;13;5;4;1;.200;1043000;0
2008;8046;57;0;0;0;0;.00nan;0;0
2008;14321;58;35;32;6;26;.813;2557000;0
2008;26865;57;50;32;5;27;.844;3600000;0
2009;4447;54;100;30;0;30;1.000;3600000;0
2009;31643;54;0;0;0;0;.00nan;0;0
2009;34788;42;80;36;3;33;.917;3600000;0
2009;37416;42;0;0;0;0;.00nan;0;0
2010;37;46;0;0;0;0;.00nan;0;0
2010;376;45;0;0;0;0;.00nan;0;0
2010;2198;45;74;30;3;27;.900;3600000;0
2010;2553;46;59;30;4;26;.867;3544000;0
2011;10698;4619;0;0;0;0;.00nan;0;0
2011;25153;48;97;40;0;40;1.000;3383000;0
2011;35210;4619;60;18;2;16;.889;3600000;0
2011;38547;48;27;7;3;4;.571;217000;0
2012;2016;61;0;0;0;0;.00nan;0;0
2012;7049;47;69;34;3;31;.912;3600000;0
2012;30971;61;61;32;4;28;.875;3600000;0
2012;33654;47;0;0;0;0;.00nan;0;0
2013;6572;62;0;0;0;0;.00nan;0;0
2013;20717;60;0;0;0;0;.00nan;0;0
2013;26919;62;87;29;2;27;.931;3900000;0
2013;35536;60;86;35;2;33;.943;3900000;0
2014;2900;36;0;0;0;0;.00nan;0;0
2014;14874;36;79;29;2;27;.931;3900000;0
2014;23493;51;74;31;2;29;.935;3900000;0
2014;31822;51;0;0;0;0;.00nan;0;0
2015;2267;39;48;22;3;19;.864;3819000;0
2015;5298;55;83;39;4;35;.897;3819000;0
2015;9238;39;0;0;0;0;.00nan;0;0
2015;34770;55;0;0;0;0;.00nan;0;0
2016;1592;63;72;18;1;17;.944;3600000;0
2016;6081;56;77;39;3;36;.923;3550000;0
2016;26824;56;0;0;0;0;.00nan;0;0
2016;31994;63;0;0;0;0;.00nan;0;0
2017;3847;38;0;0;0;0;.00nan;0;0
2017;4338;65;0;0;0;0;.00nan;0;0
2017;4987;65;67;27;2;25;.926;3599000;0
2017;31021;38;100;34;0;34;1.000;3600000;0
2018;1592;63;0;0;0;0;.00nan;0;0
2018;6081;56;0;0;0;0;.00nan;0;0
2018;26824;56;60;35;4;31;.886;3600000;0
2018;34814;63;81;25;1;24;.960;3600000;0
2019;1486;43;0;0;0;0;.00nan;0;0
2019;3625;43;81;36;3;33;.917;3600000;0
2019;19640;41;36;20;4;16;.800;3543000;0
2019;23075;41;0;0;0;0;.00nan;0;0
2020;2796;59;0;0;0;0;.00nan;0;0
2020;5137;58;0;0;0;0;.00nan;0;0
2020;14321;58;80;42;4;38;.905;3564000;0
2020;31858;59;58;24;3;21;.875;3600000;0
2021;3847;38;0;0;0;0;.00nan;0;0
2021;28772;53;52;35;5;30;.857;3600000;0
2021;31021;38;93;29;1;28;.966;3600000;0
2021;38651;53;0;0;0;0;.00nan;0;0
2022;780;52;0;0;0;0;.00nan;0;0
2022;4338;65;54;28;4;24;.857;3660000;0
2022;4987;65;0;0;0;0;.00nan;0;0
2022;32146;52;62;31;3;28;.903;3660000;0
2023;2267;39;0;0;0;0;.00nan;0;0
2023;2900;36;86;40;3;37;.925;3600000;0
2023;9238;39;43;28;4;24;.857;3559000;0
2023;14874;36;0;0;0;0;.00nan;0;0
2024;37;46;56;30;4;26;.867;3600000;0
2024;33661;46;0;0;0;0;.00nan;0;0
2024;34788;42;55;39;6;33;.846;3600000;0
2024;37416;42;0;0;0;0;.00nan;0;0
2025;5298;55;0;0;0;0;.00nan;0;0
2025;8046;57;0;0;0;0;.00nan;0;0
2025;26865;57;78;21;1;20;.952;3600000;0
2025;34770;55;94;51;3;48;.941;3588000;0
2026;3;50;100;22;0;22;1.000;3600000;0
2026;751;64;74;34;2;32;.941;3566000;0
2026;904;64;0;0;0;0;.00nan;0;0
2026;5571;50;0;0;0;0;.00nan;0;0
2027;2198;45;66;21;2;19;.905;3600000;0
2027;21324;60;0;0;0;0;.00nan;0;0
2027;31044;45;0;0;0;0;.00nan;0;0
2027;35536;60;62;28;3;25;.893;3600000;0
2028;1051;44;42;31;6;25;.806;3600000;0
2028;3281;44;0;0;0;0;.00nan;0;0
2028;25153;48;0;0;0;0;.00nan;0;0
2028;38547;48;78;29;2;27;.931;3600000;0
2029;2016;61;0;0;0;0;.00nan;0;0
2029;10698;4619;0;0;0;0;.00nan;0;0
2029;30971;61;72;17;1;16;.941;3600000;0
2029;35210;4619;70;38;4;34;.895;3600000;0
2030;7049;47;83;26;1;25;.962;3600000;0
2030;28712;40;0;0;0;0;.00nan;0;0
2030;33654;47;0;0;0;0;.00nan;0;0
2030;35508;40;47;14;2;12;.857;3563000;0
2031;2152;49;85;37;3;34;.919;3900000;0
2031;6572;62;0;0;0;0;.00nan;0;0
2031;26919;62;72;40;3;37;.925;3900000;0
2031;38817;49;0;0;0;0;.00nan;0;0
2032;1486;43;80;30;2;28;.933;3900000;0
2032;3625;43;0;0;0;0;.00nan;0;0
2032;19640;41;0;0;0;0;.00nan;0;0
2032;23075;41;75;36;2;34;.944;3900000;0
2033;780;52;81;29;2;27;.931;3588000;0
2033;28772;53;0;0;0;0;.00nan;0;0
2033;32146;52;0;0;0;0;.00nan;0;0
2033;38651;53;77;21;1;20;.952;3600000;0
2034;2296;37;51;33;4;29;.879;3584000;0
2034;4447;54;40;14;3;11;.786;3600000;0
2034;19448;37;0;0;0;0;.00nan;0;0
2034;31643;54;0;0;0;0;.00nan;0;0
2035;3847;38;80;28;3;25;.893;3900000;0
2035;4338;65;0;0;0;0;.00nan;0;0
2035;4987;65;86;37;3;34;.919;3900000;0
2035;31021;38;0;0;0;0;.00nan;0;0
2036;5137;58;0;0;0;0;.00nan;0;0
2036;8046;57;40;35;6;29;.829;2938000;0
2036;14321;58;87;16;0;16;1.000;3600000;0
2036;26865;57;52;7;1;6;.857;662000;0
2037;2267;39;72;26;2;24;.923;3600000;0
2037;9238;39;0;0;0;0;.00nan;0;0
2037;23493;51;45;36;5;31;.861;3600000;0
2037;31822;51;0;0;0;0;.00nan;0;0
2038;3;50;52;40;6;34;.850;3600000;0
2038;751;64;100;29;1;28;.966;3600000;0
2038;5146;64;0;0;0;0;.00nan;0;0
2038;5571;50;0;0;0;0;.00nan;0;0
2039;37;46;0;0;0;0;.00nan;0;0
2039;2553;46;100;25;0;25;1.000;3600000;0
2039;34788;42;0;0;0;0;.00nan;0;0
2039;37416;42;81;33;2;31;.939;3576000;0
2040;2016;61;75;27;2;25;.926;3600000;0
2040;10698;4619;59;24;3;21;.875;3584000;0
2040;30971;61;0;0;0;0;.00nan;0;0
2040;35210;4619;0;0;0;0;.00nan;0;0
2041;2198;45;0;0;0;0;.00nan;0;0
2041;21324;60;84;39;2;37;.949;3559000;0
2041;31044;45;100;42;1;41;.976;3600000;0
2041;35536;60;0;0;0;0;.00nan;0;0
2042;2152;49;0;0;0;0;.00nan;0;0
2042;6572;62;81;33;3;30;.909;3600000;0
2042;26919;62;0;0;0;0;.00nan;0;0
2042;38817;49;49;32;5;27;.844;3573000;0
2043;7049;47;0;0;0;0;.00nan;0;0
2043;26840;40;0;0;0;0;.00nan;0;0
2043;28712;40;76;37;3;34;.919;3600000;0
2043;33654;47;71;27;2;25;.926;3600000;0
2044;1592;63;0;0;0;0;.00nan;0;0
2044;23493;51;0;0;0;0;.00nan;0;0
2044;31822;51;81;29;2;27;.931;3600000;0
2044;34814;63;46;25;4;21;.840;3573000;0
2045;2900;36;22;11;4;7;.636;1182000;0
2045;6081;56;0;0;0;0;.00nan;0;0
2045;14874;36;36;10;3;7;.700;2418000;0
2045;26824;56;81;33;3;30;.909;3600000;0
2046;2296;37;0;0;0;0;.00nan;0;0
2046;4447;54;0;0;0;0;.00nan;0;0
2046;19448;37;68;31;2;29;.935;3579000;0
2046;31643;54;87;29;1;28;.966;3600000;0
2047;1051;44;0;0;0;0;.00nan;0;0
2047;3281;44;62;19;2;17;.895;3600000;0
2047;25153;48;0;0;0;0;.00nan;0;0
2047;38547;48;44;23;4;19;.826;3588000;0
2048;3;50;92;43;3;40;.930;3600000;0
2048;2198;45;80;31;2;29;.935;3600000;0
2048;5571;50;0;0;0;0;.00nan;0;0
2048;31044;45;0;0;0;0;.00nan;0;0
2049;23493;51;0;0;0;0;.00nan;0;0
2049;26967;63;100;32;0;32;1.000;3600000;0
2049;31822;51;64;23;2;21;.913;3550000;0
2049;34814;63;0;0;0;0;.00nan;0;0
2050;37;46;0;0;0;0;.00nan;0;0
2050;1486;43;100;24;0;24;1.000;3600000;0
2050;2553;46;74;33;2;31;.939;3540000;0
2050;3625;43;0;0;0;0;.00nan;0;0
2051;2796;59;0;0;0;0;.00nan;0;0
2051;8046;57;0;0;0;0;.00nan;0;0
2051;26865;57;66;32;3;29;.906;3600000;0
2051;31858;59;64;23;2;21;.913;3600000;0
2052;780;52;0;0;0;0;.00nan;0;0
2052;5137;58;0;0;0;0;.00nan;0;0
2052;14321;58;68;35;4;31;.886;3600000;0
2052;32146;52;94;29;1;28;.966;3600000;0
2053;2296;37;0;0;0;0;.00nan;0;0
2053;4447;54;81;27;1;26;.963;3558000;0
2053;5883;37;100;32;0;32;1.000;3600000;0
2053;31643;54;0;0;0;0;.00nan;0;0
2054;7049;47;66;33;3;30;.909;3554000;0
2054;20717;60;0;0;0;0;.00nan;0;0
2054;35536;60;78;25;2;23;.920;3600000;0
2054;42603;47;0;0;0;0;.00nan;0;0
2055;2152;49;0;0;0;0;.00nan;0;0
2055;3626;48;0;0;0;0;.00nan;0;0
2055;4435;49;68;24;2;22;.917;3600000;0
2055;38547;48;87;36;3;33;.917;3554000;0
2056;3;50;87;40;3;37;.925;3565000;0
2056;376;45;0;0;0;0;.00nan;0;0
2056;2198;45;73;19;1;18;.947;3600000;0
2056;5048;50;0;0;0;0;.00nan;0;0
2057;2267;39;0;0;0;0;.00nan;0;0
2057;9238;39;87;27;1;26;.963;3600000;0
2057;14874;36;53;37;5;32;.865;3600000;0
2057;42825;36;0;0;0;0;.00nan;0;0
2058;1486;43;77;26;2;24;.923;3900000;0
2058;3625;43;0;0;0;0;.00nan;0;0
2058;8046;57;0;0;0;0;.00nan;0;0
2058;26865;57;98;34;2;32;.941;3900000;0
2059;4338;65;0;0;0;0;.00nan;0;0
2059;4987;65;81;29;1;28;.966;3600000;0
2059;5298;55;13;25;7;18;.720;3600000;0
2059;34770;55;0;0;0;0;.00nan;0;0
2060;6081;56;0;0;0;0;.00nan;0;0
2060;23493;51;81;26;1;25;.962;3600000;0
2060;26824;56;62;38;4;34;.895;3600000;0
2060;31822;51;0;0;0;0;.00nan;0;0
2061;37;46;87;32;2;30;.938;3600000;0
2061;2553;46;0;0;0;0;.00nan;0;0
2061;7049;47;60;22;3;19;.864;3555000;0
2061;42603;47;0;0;0;0;.00nan;0;0
2062;7523;38;0;0;0;0;.00nan;0;0
2062;19640;41;48;22;4;18;.818;3555000;0
2062;23075;41;0;0;0;0;.00nan;0;0
2062;31021;38;81;33;2;31;.939;3600000;0
2063;5137;58;0;0;0;0;.00nan;0;0
2063;14321;58;67;25;2;23;.920;3900000;0
2063;28772;53;92;37;2;35;.946;3900000;0
2063;31156;53;0;0;0;0;.00nan;0;0
2064;3;50;45;5;1;4;.800;338000;0
2064;5048;50;38;33;6;27;.818;3226000;0
2064;34788;42;43;31;6;25;.806;3600000;0
2064;37416;42;0;0;0;0;.00nan;0;0
2065;3626;48;0;0;0;0;.00nan;0;0
2065;6572;62;0;0;0;0;.00nan;0;0
2065;26919;62;66;36;4;32;.889;3600000;0
2065;38547;48;79;49;5;44;.898;3600000;0
2066;2016;61;0;0;0;0;.00nan;0;0
2066;14351;40;35;23;5;18;.783;3841000;0
2066;26840;40;0;0;0;0;.00nan;0;0
2066;30971;61;47;38;6;32;.842;3790000;0
2067;1486;43;0;0;0;0;.00nan;0;0
2067;3625;43;47;37;6;31;.838;3900000;0
2067;8046;57;34;32;6;26;.813;3900000;0
2067;26865;57;0;0;0;0;.00nan;0;0
2068;6081;56;96;43;2;41;.953;3900000;0
2068;23493;51;0;0;0;0;.00nan;0;0
2068;26824;56;0;0;0;0;.00nan;0;0
2068;31822;51;62;21;2;19;.905;3900000;0
2069;751;64;44;32;6;26;.813;3600000;0
2069;2296;37;0;0;0;0;.00nan;0;0
2069;5146;64;0;0;0;0;.00nan;0;0
2069;5883;37;100;24;0;24;1.000;3600000;0
2070;2267;39;30;25;6;19;.760;3600000;0
2070;9238;39;0;0;0;0;.00nan;0;0
2070;26967;63;94;32;1;31;.969;3600000;0
2070;34814;63;0;0;0;0;.00nan;0;0
2071;7523;38;28;24;6;18;.750;2126000;0
2071;31021;38;76;15;0;15;1.000;1474000;0
2071;31156;53;90;38;2;36;.947;3600000;0
2071;38651;53;0;0;0;0;.00nan;0;0
2072;780;52;0;0;0;0;.00nan;0;0
2072;2796;59;0;0;0;0;.00nan;0;0
2072;31858;59;100;21;0;21;1.000;3600000;0
2072;32146;52;69;29;2;27;.931;3532000;0
2073;5298;55;0;0;0;0;.00nan;0;0
2073;14874;36;65;33;3;30;.909;3900000;0
2073;34770;55;100;42;3;39;.929;3900000;0
2073;42825;36;0;0;0;0;.00nan;0;0
2074;4447;54;0;0;0;0;.00nan;0;0
2074;4716;4619;93;40;2;38;.950;3600000;0
2074;10698;4619;0;0;0;0;.00nan;0;0
2074;31643;54;58;27;3;24;.889;3600000;0
2075;37;46;0;0;0;0;.00nan;0;0
2075;2553;46;70;36;3;33;.917;3900000;0
2075;7049;47;0;0;0;0;.00nan;0;0
2075;42603;47;61;27;3;24;.889;3900000;0
2076;376;45;0;0;0;0;.00nan;0;0
2076;2198;45;65;28;3;25;.893;3600000;0
2076;34788;42;0;0;0;0;.00nan;0;0
2076;37416;42;48;29;4;25;.862;3595000;0
2077;5137;58;61;29;4;25;.862;3900000;0
2077;14321;58;0;0;0;0;.00nan;0;0
2077;19640;41;0;0;0;0;.00nan;0;0
2077;23075;41;63;33;4;29;.879;3900000;0
2078;1051;44;0;0;0;0;.00nan;0;0
2078;2152;49;49;9;1;8;.889;1146000;0
2078;3281;44;74;31;3;28;.903;3600000;0
2078;4435;49;42;20;4;16;.800;2387000;0
2079;3626;48;80;44;4;40;.909;3600000;0
2079;6572;62;89;32;1;31;.969;3600000;0
2079;26919;62;0;0;0;0;.00nan;0;0
2079;38547;48;0;0;0;0;.00nan;0;0
2080;780;52;46;19;4;15;.789;3600000;0
2080;19640;41;95;21;0;21;1.000;3600000;0
2080;23075;41;0;0;0;0;.00nan;0;0
2080;32146;52;0;0;0;0;.00nan;0;0
2081;751;64;0;0;0;0;.00nan;0;0
2081;2296;37;0;0;0;0;.00nan;0;0
2081;5146;64;56;24;3;21;.875;3570000;0
2081;5883;37;93;38;2;36;.947;3600000;0
2082;7523;38;0;0;0;0;.00nan;0;0
2082;31021;38;68;28;3;25;.893;3555000;0
2082;31156;53;0;0;0;0;.00nan;0;0
2082;38651;53;100;40;1;39;.975;3600000;0
2083;2796;59;0;0;0;0;.00nan;0;0
2083;14874;36;69;34;3;31;.912;3578000;0
2083;31858;59;85;27;1;26;.963;3600000;0
2083;42825;36;0;0;0;0;.00nan;0;0
2084;2267;39;0;0;0;0;.00nan;0;0
2084;9238;39;40;15;3;12;.800;3562000;0
2084;26967;63;0;0;0;0;.00nan;0;0
2084;34814;63;91;36;2;34;.944;3600000;0
2085;4447;54;82;31;1;30;.968;3600000;0
2085;4716;4619;0;0;0;0;.00nan;0;0
2085;10698;4619;75;28;2;26;.929;3551000;0
2085;31643;54;0;0;0;0;.00nan;0;0
2086;4338;65;43;26;5;21;.808;3900000;0
2086;4987;65;0;0;0;0;.00nan;0;0
2086;5298;55;62;43;5;38;.884;3884000;0
2086;34770;55;0;0;0;0;.00nan;0;0
2087;376;45;66;35;3;32;.914;3891000;0
2087;2198;45;0;0;0;0;.00nan;0;0
2087;34788;42;84;35;2;33;.943;3891000;0
2087;37416;42;0;0;0;0;.00nan;0;0
2088;1051;44;62;29;4;25;.862;3548000;0
2088;2152;49;0;0;0;0;.00nan;0;0
2088;3281;44;0;0;0;0;.00nan;0;0
2088;4435;49;79;28;2;26;.929;3600000;0
2089;2016;61;0;0;0;0;.00nan;0;0
2089;14351;40;0;0;0;0;.00nan;0;0
2089;26840;40;64;19;1;18;.947;3600000;0
2089;30971;61;59;30;4;26;.867;3600000;0
2090;1486;43;74;33;3;30;.909;3773000;0
2090;3625;43;0;0;0;0;.00nan;0;0
2090;23493;51;68;25;2;23;.920;3773000;0
2090;31822;51;0;0;0;0;.00nan;0;0
2091;4338;65;0;0;0;0;.00nan;0;0
2091;4987;65;100;48;2;46;.958;3900000;0
2091;19640;41;72;31;2;29;.935;3900000;0
2091;23075;41;0;0;0;0;.00nan;0;0
2092;2016;61;0;0;0;0;.00nan;0;0
2092;26967;63;64;34;4;30;.882;3600000;0
2092;30971;61;100;23;0;23;1.000;3600000;0
2092;34814;63;0;0;0;0;.00nan;0;0
2093;7523;38;0;0;0;0;.00nan;0;0
2093;8046;57;0;0;0;0;.00nan;0;0
2093;26865;57;73;34;4;30;.882;3600000;0
2093;31021;38;68;27;2;25;.926;3600000;0
2094;2267;39;0;0;0;0;.00nan;0;0
2094;9238;39;84;26;1;25;.962;3600000;0
2094;14874;36;86;39;2;37;.949;3553000;0
2094;42825;36;0;0;0;0;.00nan;0;0
2095;1486;43;0;0;0;0;.00nan;0;0
2095;3625;43;53;25;3;22;.880;3600000;0
2095;23493;51;65;26;2;24;.923;3600000;0
2095;31822;51;0;0;0;0;.00nan;0;0
2096;376;45;0;0;0;0;.00nan;0;0
2096;751;64;76;32;3;29;.906;3900000;0
2096;2198;45;100;35;3;32;.914;3900000;0
2096;5146;64;0;0;0;0;.00nan;0;0
2097;4716;4619;68;26;3;23;.885;3600000;0
2097;6572;62;75;37;4;33;.892;3600000;0
2097;10698;4619;0;0;0;0;.00nan;0;0
2097;26919;62;0;0;0;0;.00nan;0;0
2098;1051;44;0;0;0;0;.00nan;0;0
2098;2152;49;74;20;1;19;.950;3600000;0
2098;3281;44;95;45;2;43;.956;3600000;0
2098;4435;49;0;0;0;0;.00nan;0;0
2099;2296;37;0;0;0;0;.00nan;0;0
2099;5883;37;65;43;5;38;.884;3600000;0
2099;34788;42;85;28;1;27;.964;3600000;0
2099;37416;42;0;0;0;0;.00nan;0;0
2100;780;52;0;0;0;0;.00nan;0;0
2100;2796;59;0;0;0;0;.00nan;0;0
2100;31858;59;55;19;3;16;.842;3600000;0
2100;32146;52;46;33;5;28;.848;3591000;0
2101;2900;36;0;0;0;0;.00nan;0;0
2101;5298;55;0;0;0;0;.00nan;0;0
2101;14874;36;60;31;4;27;.871;3547000;0
2101;34770;55;54;24;3;21;.875;3600000;0
2102;2267;39;50;19;3;16;.842;3600000;0
2102;6081;56;75;36;4;32;.889;3558000;0
2102;9238;39;0;0;0;0;.00nan;0;0
2102;26628;56;0;0;0;0;.00nan;0;0
2103;2016;61;0;0;0;0;.00nan;0;0
2103;23493;51;98;31;1;30;.968;3900000;0
2103;30971;61;100;40;1;39;.975;3900000;0
2103;31822;51;0;0;0;0;.00nan;0;0
2104;3;50;91;31;1;30;.968;3600000;0
2104;37;46;45;23;4;19;.826;3600000;0
2104;2553;46;0;0;0;0;.00nan;0;0
2104;5048;50;0;0;0;0;.00nan;0;0
2105;8046;57;0;0;0;0;.00nan;0;0
2105;19640;41;55;16;2;14;.875;3600000;0
2105;23075;41;0;0;0;0;.00nan;0;0
2105;26865;57;52;34;5;29;.853;3600000;0
2106;4338;65;29;32;6;26;.813;3600000;0
2106;4987;65;0;0;0;0;.00nan;0;0
2106;5137;58;0;0;0;0;.00nan;0;0
2106;14321;58;76;36;3;33;.917;3600000;0
2107;376;45;0;0;0;0;.00nan;0;0
2107;2198;45;77;29;1;28;.966;3600000;0
2107;4447;54;0;0;0;0;.00nan;0;0
2107;31643;54;71;23;2;21;.913;3600000;0
2108;4716;4619;80;23;1;22;.957;3600000;0
2108;6572;62;0;0;0;0;.00nan;0;0
2108;10698;4619;0;0;0;0;.00nan;0;0
2108;26919;62;62;43;5;38;.884;3600000;0
2109;2152;49;0;0;0;0;.00nan;0;0
2109;3626;48;0;0;0;0;.00nan;0;0
2109;4435;49;44;30;5;25;.833;3600000;0
2109;38547;48;64;26;2;24;.923;3600000;0
2110;7049;47;74;24;1;23;.958;3640000;0
2110;14351;40;0;0;0;0;.00nan;0;0
2110;26840;40;89;33;2;31;.939;3640000;0
2110;42603;47;0;0;0;0;.00nan;0;0
2111;2016;61;0;0;0;0;.00nan;0;0
2111;23493;51;0;0;0;0;.00nan;0;0
2111;30971;61;73;42;4;38;.905;3518000;0
2111;31822;51;49;21;3;18;.857;3600000;0
2112;2296;37;0;0;0;0;.00nan;0;0
2112;5883;37;100;28;0;28;1.000;3600000;0
2112;34788;42;71;29;2;27;.931;3560000;0
2112;37416;42;0;0;0;0;.00nan;0;0
2113;780;52;0;0;0;0;.00nan;0;0
2113;2796;59;46;10;2;8;.800;1667000;0
2113;31858;59;41;21;4;17;.810;1933000;0
2113;32146;52;93;36;2;34;.944;3600000;0
2114;2900;36;95;40;2;38;.950;3900000;0
2114;5298;55;81;26;2;24;.923;3900000;0
2114;14874;36;0;0;0;0;.00nan;0;0
2114;34770;55;0;0;0;0;.00nan;0;0
2115;1486;43;53;21;3;18;.857;3582000;0
2115;3625;43;0;0;0;0;.00nan;0;0
2115;26967;63;75;32;2;30;.938;3600000;0
2115;34814;63;0;0;0;0;.00nan;0;0
2116;2267;39;0;0;0;0;.00nan;0;0
2116;6081;56;82;31;2;29;.935;3600000;0
2116;9238;39;53;28;4;24;.857;3560000;0
2116;14061;56;0;0;0;0;.00nan;0;0
2117;3;50;0;0;0;0;.00nan;0;0
2117;37;46;0;0;0;0;.00nan;0;0
2117;2553;46;68;21;2;19;.905;3600000;0
2117;5048;50;71;26;3;23;.885;3543000;0
2118;8046;57;0;0;0;0;.00nan;0;0
2118;19640;41;76;33;3;30;.909;3600000;0
2118;23075;41;0;0;0;0;.00nan;0;0
2118;26865;57;16;22;6;16;.727;3600000;0
2119;5137;58;100;25;0;25;1.000;3600000;0
2119;7523;38;70;39;5;34;.872;3600000;0
2119;14321;58;0;0;0;0;.00nan;0;0
2119;31021;38;0;0;0;0;.00nan;0;0
2120;4338;65;0;0;0;0;.00nan;0;0
2120;4987;65;76;34;2;32;.941;3564000;0
2120;28772;53;0;0;0;0;.00nan;0;0
2120;31156;53;73;21;1;20;.952;3600000;0
2121;376;45;87;37;2;35;.946;3600000;0
2121;751;64;83;22;1;21;.955;3600000;0
2121;2198;45;0;0;0;0;.00nan;0;0
2121;5146;64;0;0;0;0;.00nan;0;0
2122;2152;49;64;25;2;23;.920;3571000;0
2122;3626;48;100;36;1;35;.972;3600000;0
2122;4435;49;0;0;0;0;.00nan;0;0
2122;38547;48;0;0;0;0;.00nan;0;0
2123;14351;40;21;10;4;6;.600;879000;0
2123;20717;60;0;0;0;0;.00nan;0;0
2123;26840;40;73;29;3;26;.897;2721000;0
2123;35536;60;68;20;1;19;.950;3600000;0
2124;4716;4619;0;0;0;0;.00nan;0;0
2124;6572;62;77;41;4;37;.902;3683000;0
2124;10698;4619;88;36;3;33;.917;3683000;0
2124;26919;62;0;0;0;0;.00nan;0;0
2125;1051;44;0;0;0;0;.00nan;0;0
2125;3281;44;79;37;3;34;.919;3626000;0
2125;7049;47;0;0;0;0;.00nan;0;0
2125;42603;47;91;34;2;32;.941;3626000;0
2126;780;52;0;0;0;0;.00nan;0;0
2126;28772;53;69;35;4;31;.886;3600000;0
2126;31156;53;0;0;0;0;.00nan;0;0
2126;32146;52;59;42;5;37;.881;3545000;0
2127;2796;59;0;0;0;0;.00nan;0;0
2127;7523;38;0;0;0;0;.00nan;0;0
2127;31021;38;53;15;2;13;.867;3525000;0
2127;31858;59;100;27;0;27;1.000;3600000;0
2128;3;50;77;22;1;21;.955;3600000;0
2128;751;64;0;0;0;0;.00nan;0;0
2128;5048;50;0;0;0;0;.00nan;0;0
2128;5146;64;68;34;3;31;.912;3555000;0
2129;37;46;44;34;5;29;.853;3600000;0
2129;2553;46;0;0;0;0;.00nan;0;0
2129;4447;54;69;30;2;28;.933;3600000;0
2129;31643;54;0;0;0;0;.00nan;0;0
2130;1051;44;0;0;0;0;.00nan;0;0
2130;3281;44;68;28;3;25;.893;3600000;0
2130;20717;60;51;25;4;21;.840;3578000;0
2130;35536;60;0;0;0;0;.00nan;0;0
2131;2016;61;0;0;0;0;.00nan;0;0
2131;26967;63;0;0;0;0;.00nan;0;0
2131;30971;61;86;33;3;30;.909;3600000;0
2131;34814;63;73;42;4;38;.905;3584000;0
2132;3;50;74;23;3;20;.870;3863000;0
2132;4447;54;69;27;3;24;.889;3900000;0
2132;5048;50;0;0;0;0;.00nan;0;0
2132;31643;54;0;0;0;0;.00nan;0;0
2133;2900;36;77;26;3;23;.885;3900000;0
2133;5298;55;0;0;0;0;.00nan;0;0
2133;14874;36;0;0;0;0;.00nan;0;0
2133;34770;55;55;28;3;25;.893;3900000;0
2134;37;46;70;27;2;25;.926;3600000;0
2134;751;64;0;0;0;0;.00nan;0;0
2134;2553;46;0;0;0;0;.00nan;0;0
2134;5146;64;73;50;5;45;.900;3600000;0
2135;5137;58;86;36;2;34;.944;3634000;0
2135;7523;38;99;40;1;39;.975;3634000;0
2135;14321;58;0;0;0;0;.00nan;0;0
2135;31021;38;0;0;0;0;.00nan;0;0
2136;2796;59;0;0;0;0;.00nan;0;0
2136;4338;65;0;0;0;0;.00nan;0;0
2136;4987;65;55;44;6;38;.864;3600000;0
2136;31858;59;77;30;2;28;.933;3600000;0
2137;2267;39;71;25;2;23;.920;3306000;0
2137;9238;39;22;5;3;2;.400;294000;0
2137;23493;51;52;16;2;14;.875;3600000;0
2137;31822;51;0;0;0;0;.00nan;0;0
2138;6572;62;0;0;0;0;.00nan;0;0
2138;14351;40;0;0;0;0;.00nan;0;0
2138;26840;40;66;33;3;30;.909;3600000;0
2138;26919;62;77;25;1;24;.960;3600000;0
2139;2152;49;0;0;0;0;.00nan;0;0
2139;4435;49;54;34;5;29;.853;3600000;0
2139;20717;60;95;39;2;37;.949;3600000;0
2139;35536;60;0;0;0;0;.00nan;0;0
2140;780;52;0;0;0;0;.00nan;0;0
2140;4338;65;70;30;2;28;.933;3532000;0
2140;4987;65;0;0;0;0;.00nan;0;0
2140;32146;52;96;21;0;21;1.000;3600000;0
2141;5137;58;0;0;0;0;.00nan;0;0
2141;14321;58;64;26;3;23;.885;3600000;0
2141;19640;41;69;27;2;25;.926;3600000;0
2141;23075;41;0;0;0;0;.00nan;0;0
2142;5298;55;0;0;0;0;.00nan;0;0
2142;26967;63;87;33;2;31;.939;3550000;0
2142;34770;55;73;23;1;22;.957;3600000;0
2142;34814;63;0;0;0;0;.00nan;0;0
2143;37;46;45;26;4;22;.846;3564000;0
2143;1486;43;0;0;0;0;.00nan;0;0
2143;2553;46;0;0;0;0;.00nan;0;0
2143;3625;43;73;30;3;27;.900;3600000;0
2144;8046;57;0;0;0;0;.00nan;0;0
2144;23493;51;74;25;1;24;.960;3600000;0
2144;26865;57;81;37;3;34;.919;3600000;0
2144;31822;51;0;0;0;0;.00nan;0;0
2145;2267;39;72;24;2;22;.917;3600000;0
2145;2900;36;0;0;0;0;.00nan;0;0
2145;9238;39;0;0;0;0;.00nan;0;0
2145;14874;36;76;38;3;35;.921;3525000;0
2146;2296;37;0;0;0;0;.00nan;0;0
2146;5883;37;54;24;3;21;.875;3771000;0
2146;6081;56;92;40;2;38;.950;3771000;0
2146;14061;56;0;0;0;0;.00nan;0;0
2147;4447;54;0;0;0;0;.00nan;0;0
2147;31643;54;57;34;4;30;.882;3600000;0
2147;34788;42;100;30;0;30;1.000;3600000;0
2147;37416;42;0;0;0;0;.00nan;0;0
2148;376;45;0;0;0;0;.00nan;0;0
2148;1051;44;0;0;0;0;.00nan;0;0
2148;2198;45;65;28;3;25;.893;3600000;0
2148;3281;44;40;25;5;20;.800;3562000;0
2149;6572;62;57;12;1;11;.917;1225000;0
2149;7049;47;64;30;3;27;.900;3600000;0
2149;26919;62;44;23;5;18;.783;2375000;0
2149;33654;47;0;0;0;0;.00nan;0;0
2150;14351;40;0;0;0;0;.00nan;0;0
2150;20717;60;73;29;3;26;.897;3900000;0
2150;26840;40;60;32;3;29;.906;3900000;0
2150;35536;60;0;0;0;0;.00nan;0;0
2151;2016;61;0;0;0;0;.00nan;0;0
2151;4716;4619;0;0;0;0;.00nan;0;0
2151;10698;4619;52;24;3;21;.875;3900000;0
2151;30971;61;67;32;3;29;.906;3900000;0
2152;5137;58;23;27;6;21;.778;2886000;0
2152;14321;58;49;9;1;8;.889;714000;0
2152;19640;41;91;16;0;16;1.000;3600000;0
2152;23075;41;0;0;0;0;.00nan;0;0
2153;2796;59;0;0;0;0;.00nan;0;0
2153;23493;51;81;34;2;32;.941;3900000;0
2153;31822;51;0;0;0;0;.00nan;0;0
2153;31858;59;72;28;2;26;.929;3900000;0
2154;2900;36;90;33;3;30;.909;3664000;0
2154;14874;36;0;0;0;0;.00nan;0;0
2154;26967;63;0;0;0;0;.00nan;0;0
2154;34814;63;60;18;2;16;.889;3664000;0
2155;2267;39;0;0;0;0;.00nan;0;0
2155;5298;55;100;24;0;24;1.000;3600000;0
2155;9238;39;53;33;5;28;.848;3600000;0
2155;34770;55;0;0;0;0;.00nan;0;0
2156;2296;37;84;20;1;19;.950;3900000;0
2156;5883;37;0;0;0;0;.00nan;0;0
2156;6081;56;93;30;1;29;.967;3900000;0
2156;14061;56;0;0;0;0;.00nan;0;0
2157;751;64;0;0;0;0;.00nan;0;0
2157;4447;54;67;24;2;22;.917;3565000;0
2157;5146;64;99;38;1;37;.974;3600000;0
2157;31643;54;0;0;0;0;.00nan;0;0
2158;3;50;0;0;0;0;.00nan;0;0
2158;3626;48;0;0;0;0;.00nan;0;0
2158;5048;50;79;25;2;23;.920;3600000;0
2158;38547;48;73;49;5;44;.898;3600000;0
2159;780;52;0;0;0;0;.00nan;0;0
2159;7523;38;63;26;3;23;.885;3900000;0
2159;31021;38;0;0;0;0;.00nan;0;0
2159;32146;52;100;60;3;57;.950;3881000;0
2160;8046;57;64;21;2;19;.905;3900000;0
2160;26865;57;0;0;0;0;.00nan;0;0
2160;28772;53;0;0;0;0;.00nan;0;0
2160;31156;53;73;26;2;24;.923;3900000;0
2161;376;45;99;30;1;29;.967;3600000;0
2161;1051;44;43;4;1;3;.750;450000;0
2161;2198;45;0;0;0;0;.00nan;0;0
2161;3281;44;39;29;6;23;.793;3150000;0
2162;14351;40;86;18;0;18;1.000;3600000;0
2162;20717;60;0;0;0;0;.00nan;0;0
2162;26840;40;0;0;0;0;.00nan;0;0
2162;35536;60;61;31;4;27;.871;3600000;0
2163;2152;49;57;22;3;19;.864;3600000;0
2163;4435;49;0;0;0;0;.00nan;0;0
2163;6572;62;49;37;5;32;.865;3551000;0
2163;26919;62;0;0;0;0;.00nan;0;0
2164;1486;43;71;28;2;26;.929;3572000;0
2164;3625;43;0;0;0;0;.00nan;0;0
2164;34788;42;96;30;1;29;.967;3600000;0
2164;37416;42;0;0;0;0;.00nan;0;0
2165;780;52;0;0;0;0;.00nan;0;0
2165;7523;38;0;0;0;0;.00nan;0;0
2165;31021;38;100;36;0;36;1.000;3600000;0
2165;32146;52;60;40;4;36;.900;3600000;0
2166;2796;59;0;0;0;0;.00nan;0;0
2166;28772;53;38;26;5;21;.808;3600000;0
2166;31156;53;0;0;0;0;.00nan;0;0
2166;31858;59;96;24;0;24;1.000;3600000;0
2167;37;46;42;24;4;20;.833;3573000;0
2167;751;64;88;50;3;47;.940;3600000;0
2167;2553;46;0;0;0;0;.00nan;0;0
2167;5146;64;0;0;0;0;.00nan;0;0
2168;3;50;53;20;3;17;.850;3600000;0
2168;3626;48;86;32;2;30;.938;3600000;0
2168;5048;50;0;0;0;0;.00nan;0;0
2168;38547;48;0;0;0;0;.00nan;0;0
2169;4338;65;84;29;1;28;.966;3600000;0
2169;4987;65;0;0;0;0;.00nan;0;0
2169;8046;57;0;0;0;0;.00nan;0;0
2169;26865;57;60;29;3;26;.897;3544000;0
2170;2016;61;0;0;0;0;.00nan;0;0
2170;4716;4619;80;34;2;32;.941;3900000;0
2170;10698;4619;0;0;0;0;.00nan;0;0
2170;30971;61;78;28;2;26;.929;3900000;0
2171;1486;43;76;32;2;30;.938;3600000;0
2171;3625;43;0;0;0;0;.00nan;0;0
2171;34788;42;78;33;3;30;.909;3600000;0
2171;37416;42;0;0;0;0;.00nan;0;0
2172;2016;61;60;30;3;27;.900;3559000;0
2172;2296;37;0;0;0;0;.00nan;0;0
2172;5883;37;87;31;2;29;.935;3600000;0
2172;30971;61;0;0;0;0;.00nan;0;0
2173;780;52;0;0;0;0;.00nan;0;0
2173;5137;58;0;0;0;0;.00nan;0;0
2173;14321;58;64;23;2;21;.913;3600000;0
2173;32146;52;68;31;3;28;.903;3542000;0
2174;2900;36;0;0;0;0;.00nan;0;0
2174;14874;36;49;31;5;26;.839;3600000;0
2174;28772;53;0;0;0;0;.00nan;0;0
2174;31156;53;82;31;2;29;.935;3600000;0
2175;37;46;0;0;0;0;.00nan;0;0
2175;376;45;0;0;0;0;.00nan;0;0
2175;2198;45;83;37;3;34;.919;3600000;0
2175;2553;46;58;31;4;27;.871;3565000;0
2176;751;64;0;0;0;0;.00nan;0;0
2176;4447;54;80;23;1;22;.957;3600000;0
2176;5146;64;57;36;5;31;.861;3600000;0
2176;31643;54;0;0;0;0;.00nan;0;0
2177;7049;47;0;0;0;0;.00nan;0;0
2177;14351;40;97;41;2;39;.951;3547000;0
2177;26840;40;0;0;0;0;.00nan;0;0
2177;33654;47;84;23;1;22;.957;3600000;0
2178;1051;44;0;0;0;0;.00nan;0;0
2178;3281;44;74;22;2;20;.909;3600000;0
2178;20717;60;58;32;4;28;.875;3584000;0
2178;35536;60;0;0;0;0;.00nan;0;0
2179;3626;48;0;0;0;0;.00nan;0;0
2179;6572;62;0;0;0;0;.00nan;0;0
2179;26919;62;44;21;4;17;.810;3900000;0
2179;38547;48;70;43;4;39;.907;3900000;0
2180;2016;61;0;0;0;0;.00nan;0;0
2180;2296;37;90;37;2;35;.946;3600000;0
2180;5883;37;0;0;0;0;.00nan;0;0
2180;30971;61;54;28;3;25;.893;3594000;0
2181;4338;65;76;43;4;39;.907;3600000;0
2181;4987;65;0;0;0;0;.00nan;0;0
2181;26967;63;82;26;1;25;.962;3600000;0
2181;34814;63;0;0;0;0;.00nan;0;0
2182;7523;38;0;0;0;0;.00nan;0;0
2182;19640;41;94;33;1;32;.970;3600000;0
2182;23075;41;0;0;0;0;.00nan;0;0
2182;31021;38;87;32;2;30;.938;3561000;0
2183;780;52;0;0;0;0;.00nan;0;0
2183;2900;36;0;0;0;0;.00nan;0;0
2183;14874;36;74;35;3;32;.914;3600000;0
2183;32146;52;59;37;5;32;.865;3525000;0
2184;4338;65;0;0;0;0;.00nan;0;0
2184;4987;65;69;33;4;29;.879;3600000;0
2184;6081;56;81;31;2;29;.935;3600000;0
2184;14061;56;0;0;0;0;.00nan;0;0
2185;23493;51;49;34;5;29;.853;3532000;0
2185;28772;53;0;0;0;0;.00nan;0;0
2185;31156;53;77;38;3;35;.921;3600000;0
2185;31822;51;0;0;0;0;.00nan;0;0
2186;37;46;0;0;0;0;.00nan;0;0
2186;376;45;0;0;0;0;.00nan;0;0
2186;2198;45;52;24;3;21;.875;3516000;0
2186;2553;46;79;25;1;24;.960;3600000;0
2187;2796;59;0;0;0;0;.00nan;0;0
2187;5298;55;57;38;6;32;.842;3600000;0
2187;31858;59;64;27;3;24;.889;3600000;0
2187;34770;55;0;0;0;0;.00nan;0;0
2188;5137;58;0;0;0;0;.00nan;0;0
2188;8046;57;0;0;0;0;.00nan;0;0
2188;14321;58;71;29;3;26;.897;3674000;0
2188;26865;57;94;38;2;36;.947;3674000;0
2189;1486;43;66;43;4;39;.907;3600000;0
2189;2267;39;0;0;0;0;.00nan;0;0
2189;3625;43;0;0;0;0;.00nan;0;0
2189;9238;39;93;21;0;21;1.000;3600000;0
2190;4716;4619;0;0;0;0;.00nan;0;0
2190;10698;4619;70;34;3;31;.912;3600000;0
2190;14351;40;40;20;4;16;.800;3588000;0
2190;26840;40;0;0;0;0;.00nan;0;0
2191;2152;49;0;0;0;0;.00nan;0;0
2191;4435;49;83;21;1;20;.952;3600000;0
2191;7049;47;61;28;3;25;.893;3548000;0
2191;33654;47;0;0;0;0;.00nan;0;0
2192;3626;48;69;42;5;37;.881;3600000;0
2192;6572;62;0;0;0;0;.00nan;0;0
2192;26919;62;62;21;2;19;.905;3600000;0
2192;38547;48;0;0;0;0;.00nan;0;0
2193;1051;44;61;10;1;9;.900;1242000;0
2193;3281;44;36;19;4;15;.789;2323000;0
2193;20717;60;60;23;3;20;.870;3600000;0
2193;35536;60;0;0;0;0;.00nan;0;0
2194;4338;65;93;18;0;18;1.000;3600000;0
2194;4987;65;0;0;0;0;.00nan;0;0
2194;23493;51;0;0;0;0;.00nan;0;0
2194;31822;51;78;39;3;36;.923;3600000;0
2195;751;64;97;38;1;37;.974;3600000;0
2195;5146;64;0;0;0;0;.00nan;0;0
2195;26967;63;0;0;0;0;.00nan;0;0
2195;34814;63;44;39;6;33;.846;3600000;0
2196;7523;38;65;23;2;21;.913;3600000;0
2196;19640;41;73;29;3;26;.897;3554000;0
2196;23075;41;0;0;0;0;.00nan;0;0
2196;31021;38;0;0;0;0;.00nan;0;0
2197;2796;59;0;0;0;0;.00nan;0;0
2197;2900;36;63;40;5;35;.875;3600000;0
2197;14874;36;0;0;0;0;.00nan;0;0
2197;31858;59;100;26;0;26;1.000;3600000;0
2198;1486;43;0;0;0;0;.00nan;0;0
2198;2267;39;0;0;0;0;.00nan;0;0
2198;3625;43;81;35;3;32;.914;3900000;0
2198;9238;39;56;26;3;23;.885;3900000;0
2199;780;52;80;28;2;26;.929;3600000;0
2199;5298;55;0;0;0;0;.00nan;0;0
2199;32146;52;0;0;0;0;.00nan;0;0
2199;34770;55;54;31;5;26;.839;3600000;0
2200;6081;56;91;39;2;37;.949;3600000;0
2200;14061;56;0;0;0;0;.00nan;0;0
2200;28772;53;52;35;5;30;.857;3600000;0
2200;31156;53;0;0;0;0;.00nan;0;0
2201;376;45;53;16;2;14;.875;3543000;0
2201;2198;45;0;0;0;0;.00nan;0;0
2201;4447;54;73;24;1;23;.958;3600000;0
2201;31643;54;0;0;0;0;.00nan;0;0
2202;37;46;96;23;0;23;1.000;3600000;0
2202;2553;46;0;0;0;0;.00nan;0;0
2202;34788;42;70;28;2;26;.929;3536000;0
2202;37416;42;0;0;0;0;.00nan;0;0
2203;3;50;58;35;4;31;.886;3561000;0
2203;2296;37;0;0;0;0;.00nan;0;0
2203;5048;50;0;0;0;0;.00nan;0;0
2203;5883;37;73;30;3;27;.900;3600000;0
2204;5137;58;60;25;3;22;.880;3544000;0
2204;8046;57;84;32;1;31;.969;3600000;0
2204;14321;58;0;0;0;0;.00nan;0;0
2204;26865;57;0;0;0;0;.00nan;0;0
2205;4716;4619;13;19;6;13;.684;1934000;0
2205;10698;4619;60;11;1;10;.909;1666000;0
2205;14351;40;0;0;0;0;.00nan;0;0
2205;26840;40;54;25;3;22;.880;3600000;0
2206;2016;61;0;0;0;0;.00nan;0;0
2206;7049;47;0;0;0;0;.00nan;0;0
2206;30971;61;92;30;1;29;.967;3760000;0
2206;33654;47;100;31;0;31;1.000;3760000;0
2207;1051;44;74;27;2;25;.926;3900000;0
2207;3281;44;0;0;0;0;.00nan;0;0
2207;20717;60;0;0;0;0;.00nan;0;0
2207;35536;60;79;35;2;33;.943;3900000;0
2208;3626;48;0;0;0;0;.00nan;0;0
2208;6572;62;78;27;1;26;.963;3600000;0
2208;26919;62;0;0;0;0;.00nan;0;0
2208;38547;48;88;37;2;35;.946;3548000;0
2209;7523;38;0;0;0;0;.00nan;0;0
2209;19640;41;81;24;1;23;.958;3600000;0
2209;23075;41;0;0;0;0;.00nan;0;0
2209;31021;38;98;41;2;39;.951;3579000;0
2210;751;64;0;0;0;0;.00nan;0;0
2210;5146;64;80;40;3;37;.925;3900000;0
2210;26967;63;66;36;3;33;.917;3900000;0
2210;34814;63;0;0;0;0;.00nan;0;0
2211;4447;54;0;0;0;0;.00nan;0;0
2211;31643;54;84;32;2;30;.938;3600000;0
2211;34788;42;0;0;0;0;.00nan;0;0
2211;37416;42;32;32;6;26;.813;3600000;0
2212;2796;59;0;0;0;0;.00nan;0;0
2212;8046;57;0;0;0;0;.00nan;0;0
2212;26865;57;54;34;5;29;.853;3600000;0
2212;31858;59;54;33;4;29;.879;3600000;0
2213;2016;61;0;0;0;0;.00nan;0;0
2213;2152;49;84;22;1;21;.955;3900000;0
2213;4435;49;0;0;0;0;.00nan;0;0
2213;30971;61;86;33;1;32;.970;3900000;0
2214;1486;43;0;0;0;0;.00nan;0;0
2214;3625;43;88;31;2;29;.935;3600000;0
2214;5298;55;0;0;0;0;.00nan;0;0
2214;34770;55;82;32;3;29;.906;3600000;0
2215;3;50;0;0;0;0;.00nan;0;0
2215;2296;37;0;0;0;0;.00nan;0;0
2215;5048;50;91;42;2;40;.952;3600000;0
2215;5883;37;54;22;3;19;.864;3566000;0
2216;376;45;0;0;0;0;.00nan;0;0
2216;751;64;0;0;0;0;.00nan;0;0
2216;2198;45;65;31;3;28;.903;3600000;0
2216;5146;64;66;39;5;34;.872;3600000;0
2217;37;46;71;30;3;27;.900;3600000;0
2217;2152;49;0;0;0;0;.00nan;0;0
2217;2553;46;0;0;0;0;.00nan;0;0
2217;4435;49;76;41;4;37;.902;3586000;0
2218;5137;58;0;0;0;0;.00nan;0;0
2218;14321;58;54;21;3;18;.857;3570000;0
2218;28772;53;0;0;0;0;.00nan;0;0
2218;31156;53;100;42;1;41;.976;3600000;0
2219;4338;65;64;34;4;30;.882;3600000;0
2219;4987;65;0;0;0;0;.00nan;0;0
2219;8046;57;26;39;8;31;.795;3600000;0
2219;26865;57;0;0;0;0;.00nan;0;0
2220;1486;43;0;0;0;0;.00nan;0;0
2220;2900;36;0;0;0;0;.00nan;0;0
2220;3625;43;74;19;1;18;.947;3600000;0
2220;14874;36;51;18;2;16;.889;3550000;0
2221;2796;59;0;0;0;0;.00nan;0;0
2221;26967;63;0;0;0;0;.00nan;0;0
2221;31858;59;58;20;2;18;.900;3600000;0
2221;34814;63;69;33;3;30;.909;3600000;0
2222;780;52;0;0;0;0;.00nan;0;0
2222;5298;55;0;0;0;0;.00nan;0;0
2222;32146;52;56;22;2;20;.909;3546000;0
2222;34770;55;79;26;1;25;.962;3600000;0
2223;2296;37;0;0;0;0;.00nan;0;0
2223;5883;37;71;16;1;15;.938;3600000;0
2223;34788;42;21;9;4;5;.556;1084000;0
2223;37416;42;67;32;3;29;.906;2516000;0
2224;4716;4619;0;0;0;0;.00nan;0;0
2224;7049;47;0;0;0;0;.00nan;0;0
2224;10698;4619;74;28;2;26;.929;3900000;0
2224;33654;47;100;42;2;40;.952;3900000;0
2225;1051;44;0;0;0;0;.00nan;0;0
2225;3281;44;64;29;3;26;.897;3600000;0
2225;6572;62;82;27;1;26;.963;3600000;0
2225;26919;62;0;0;0;0;.00nan;0;0
2226;2016;61;0;0;0;0;.00nan;0;0
2226;20717;60;61;33;4;29;.879;3900000;0
2226;30971;61;59;35;4;31;.886;3900000;0
2226;35536;60;0;0;0;0;.00nan;0;0
2227;5137;58;0;0;0;0;.00nan;0;0
2227;14321;58;66;26;3;23;.885;3600000;0
2227;28772;53;0;0;0;0;.00nan;0;0
2227;31156;53;100;25;0;25;1.000;3600000;0
2228;1486;43;65;27;3;24;.889;3600000;0
2228;3625;43;0;0;0;0;.00nan;0;0
2228;19640;41;73;48;4;44;.917;3585000;0
2228;23075;41;0;0;0;0;.00nan;0;0
2229;2900;36;96;35;2;33;.943;3600000;0
2229;5298;55;0;0;0;0;.00nan;0;0
2229;14874;36;0;0;0;0;.00nan;0;0
2229;34770;55;50;36;5;31;.861;3600000;0
2230;2796;59;0;0;0;0;.00nan;0;0
2230;6081;56;75;48;4;44;.917;3900000;0
2230;14061;56;0;0;0;0;.00nan;0;0
2230;31858;59;72;35;4;31;.886;3900000;0
2231;8046;57;60;30;4;26;.867;3600000;0
2231;23493;51;0;0;0;0;.00nan;0;0
2231;26865;57;0;0;0;0;.00nan;0;0
2231;31035;51;100;43;0;43;1.000;3600000;0
2232;4338;65;67;35;4;31;.886;3600000;0
2232;4987;65;0;0;0;0;.00nan;0;0
2232;7523;38;0;0;0;0;.00nan;0;0
2232;31021;38;93;29;1;28;.966;3600000;0
2233;2267;39;0;0;0;0;.00nan;0;0
2233;9238;39;72;26;2;24;.923;3600000;0
2233;26967;63;41;35;6;29;.829;3600000;0
2233;34814;63;0;0;0;0;.00nan;0;0
2234;751;64;0;0;0;0;.00nan;0;0
2234;2296;37;0;0;0;0;.00nan;0;0
2234;5146;64;52;23;3;20;.870;3600000;0
2234;5883;37;51;31;4;27;.871;3597000;0
2235;376;45;0;0;0;0;.00nan;0;0
2235;2198;45;71;38;4;34;.895;3900000;0
2235;4447;54;0;0;0;0;.00nan;0;0
2235;31643;54;53;27;4;23;.852;3880000;0
2236;3;50;74;44;4;40;.909;3900000;0
2236;5048;50;0;0;0;0;.00nan;0;0
2236;34788;42;55;29;4;25;.862;3900000;0
2236;37416;42;0;0;0;0;.00nan;0;0
2237;37;46;66;23;2;21;.913;3900000;0
2237;2553;46;0;0;0;0;.00nan;0;0
2237;7049;47;0;0;0;0;.00nan;0;0
2237;33654;47;100;43;2;41;.953;3900000;0
2238;2016;61;0;0;0;0;.00nan;0;0
2238;14351;40;0;0;0;0;.00nan;0;0
2238;26840;40;90;43;3;40;.930;3837000;0
2238;30971;61;83;33;2;31;.939;3837000;0
2239;1051;44;0;0;0;0;.00nan;0;0
2239;3281;44;61;25;3;22;.880;3600000;0
2239;3626;48;38;6;2;4;.667;1087000;0
2239;38547;48;9;19;6;13;.684;2513000;0
2240;2796;59;0;0;0;0;.00nan;0;0
2240;23493;51;0;0;0;0;.00nan;0;0
2240;31035;51;52;17;2;15;.882;3597000;0
2240;31858;59;83;28;1;27;.964;3600000;0
2241;780;52;0;0;0;0;.00nan;0;0
2241;26967;63;0;0;0;0;.00nan;0;0
2241;32146;52;42;34;6;28;.824;3600000;0
2241;34814;63;91;31;1;30;.968;3600000;0
2242;4716;4619;86;32;2;30;.938;3900000;0
2242;10698;4619;0;0;0;0;.00nan;0;0
2242;20717;60;73;25;2;23;.920;3900000;0
2242;35536;60;0;0;0;0;.00nan;0;0
2243;1051;44;0;0;0;0;.00nan;0;0
2243;3281;44;61;34;4;30;.882;3600000;0
2243;3626;48;71;32;3;29;.906;3600000;0
2243;38547;48;0;0;0;0;.00nan;0;0
2244;4338;65;0;0;0;0;.00nan;0;0
2244;4987;65;59;43;7;36;.837;3600000;0
2244;28772;53;0;0;0;0;.00nan;0;0
2244;31156;53;74;22;2;20;.909;3600000;0
2245;2267;39;68;23;2;21;.913;3573000;0
2245;2900;36;0;0;0;0;.00nan;0;0
2245;9238;39;0;0;0;0;.00nan;0;0
2245;14874;36;99;38;1;37;.974;3600000;0
2246;6081;56;100;34;0;34;1.000;3600000;0
2246;8046;57;0;0;0;0;.00nan;0;0
2246;14061;56;0;0;0;0;.00nan;0;0
2246;26865;57;60;30;3;27;.900;3600000;0
2247;2296;37;0;0;0;0;.00nan;0;0
2247;5883;37;80;42;3;39;.929;3600000;0
2247;34788;42;0;0;0;0;.00nan;0;0
2247;37416;42;33;27;5;22;.815;3542000;0
2248;5137;58;80;28;3;25;.893;3589000;0
2248;7523;38;76;27;2;25;.926;3600000;0
2248;14321;58;0;0;0;0;.00nan;0;0
2248;31021;38;0;0;0;0;.00nan;0;0
2249;376;45;25;27;6;21;.778;3600000;0
2249;2198;45;0;0;0;0;.00nan;0;0
2249;4447;54;89;42;2;40;.952;3600000;0
2249;31643;54;0;0;0;0;.00nan;0;0
2250;37;46;0;0;0;0;.00nan;0;0
2250;2553;46;85;25;1;24;.960;3600000;0
2250;7049;47;84;33;2;31;.939;3554000;0
2250;33654;47;0;0;0;0;.00nan;0;0
2251;2152;49;0;0;0;0;.00nan;0;0
2251;4435;49;98;41;2;39;.951;3578000;0
2251;6572;62;0;0;0;0;.00nan;0;0
2251;26919;62;100;34;0;34;1.000;3600000;0
2252;1486;43;60;32;4;28;.875;3600000;0
2252;3625;43;0;0;0;0;.00nan;0;0
2252;19640;41;31;26;6;20;.769;2168000;0
2252;23075;41;64;12;0;12;1.000;1379000;0
2253;5298;55;0;0;0;0;.00nan;0;0
2253;7523;38;0;0;0;0;.00nan;0;0
2253;31021;38;47;25;4;21;.840;3546000;0
2253;34770;55;71;26;2;24;.923;3600000;0
2254;780;52;0;0;0;0;.00nan;0;0
2254;2267;39;0;0;0;0;.00nan;0;0
2254;9238;39;92;22;0;22;1.000;3600000;0
2254;32146;52;96;45;2;43;.956;3520000;0
2255;3;50;56;25;4;21;.840;3573000;0
2255;751;64;0;0;0;0;.00nan;0;0
2255;5048;50;0;0;0;0;.00nan;0;0
2255;5146;64;77;32;3;29;.906;3600000;0
2256;37;46;73;28;3;25;.893;3900000;0
2256;2152;49;87;38;3;35;.921;3900000;0
2256;2553;46;0;0;0;0;.00nan;0;0
2256;4435;49;0;0;0;0;.00nan;0;0
2257;4716;4619;0;0;0;0;.00nan;0;0
2257;10698;4619;58;30;4;26;.867;3600000;0
2257;20717;60;0;0;0;0;.00nan;0;0
2257;35536;60;69;38;4;34;.895;3574000;0
2258;6572;62;0;0;0;0;.00nan;0;0
2258;14351;40;83;39;2;37;.949;3600000;0
2258;26840;40;0;0;0;0;.00nan;0;0
2258;26919;62;69;37;4;33;.892;3580000;0
2259;2296;37;0;0;0;0;.00nan;0;0
2259;5883;37;77;20;1;19;.950;3600000;0
2259;23493;51;0;0;0;0;.00nan;0;0
2259;31035;51;97;44;2;42;.955;3551000;0
2260;4447;54;0;0;0;0;.00nan;0;0
2260;31643;54;84;34;1;33;.971;3600000;0
2260;34788;42;45;26;5;21;.808;3600000;0
2260;37416;42;0;0;0;0;.00nan;0;0
2261;2016;61;0;0;0;0;.00nan;0;0
2261;26967;63;51;19;3;16;.842;2215000;0
2261;30971;61;100;30;0;30;1.000;3600000;0
2261;34814;63;38;7;2;5;.714;1385000;0
2262;2152;49;0;0;0;0;.00nan;0;0
2262;4435;49;76;33;3;30;.909;3600000;0
2262;20717;60;0;0;0;0;.00nan;0;0
2262;35536;60;69;39;5;34;.872;3524000;0
2263;2796;59;0;0;0;0;.00nan;0;0
2263;28772;53;0;0;0;0;.00nan;0;0
2263;31156;53;25;26;6;20;.769;3600000;0
2263;31858;59;78;33;3;30;.909;3600000;0
2264;2267;39;0;0;0;0;.00nan;0;0
2264;5298;55;0;0;0;0;.00nan;0;0
2264;9238;39;63;34;5;29;.853;3900000;0
2264;34770;55;73;41;5;36;.878;3900000;0
2265;2296;37;87;36;2;34;.944;3600000;0
2265;5883;37;0;0;0;0;.00nan;0;0
2265;23493;51;0;0;0;0;.00nan;0;0
2265;31035;51;67;31;3;28;.903;3573000;0
2266;4716;4619;63;45;5;40;.889;3600000;0
2266;10698;4619;0;0;0;0;.00nan;0;0
2266;14351;40;97;33;1;32;.970;3600000;0
2266;26840;40;0;0;0;0;.00nan;0;0
2267;1592;63;0;0;0;0;.00nan;0;0
2267;2016;61;0;0;0;0;.00nan;0;0
2267;30971;61;55;34;5;29;.853;3900000;0
2267;34814;63;43;35;5;30;.857;3900000;0
2268;6081;56;89;18;0;18;1.000;3600000;0
2268;14061;56;0;0;0;0;.00nan;0;0
2268;28772;53;66;34;4;30;.882;3600000;0
2268;31156;53;0;0;0;0;.00nan;0;0
2269;4338;65;56;28;3;25;.893;3587000;0
2269;4987;65;0;0;0;0;.00nan;0;0
2269;19640;41;85;28;2;26;.929;3600000;0
2269;23075;41;0;0;0;0;.00nan;0;0
2270;1486;43;62;32;3;29;.906;3600000;0
2270;2267;39;0;0;0;0;.00nan;0;0
2270;3625;43;0;0;0;0;.00nan;0;0
2270;9238;39;82;34;2;32;.941;3600000;0
2271;2900;36;36;25;5;20;.800;3548000;0
2271;5298;55;0;0;0;0;.00nan;0;0
2271;14874;36;0;0;0;0;.00nan;0;0
2271;34770;55;79;35;3;32;.914;3600000;0
2272;37;46;0;0;0;0;.00nan;0;0
2272;376;45;0;0;0;0;.00nan;0;0
2272;2198;45;98;46;3;43;.935;3543000;0
2272;2553;46;71;22;2;20;.909;3600000;0
2273;5137;58;0;0;0;0;.00nan;0;0
2273;7523;38;65;22;2;20;.909;3600000;0
2273;14321;58;45;23;4;19;.826;3555000;0
2273;31021;38;0;0;0;0;.00nan;0;0
2274;2796;59;0;0;0;0;.00nan;0;0
2274;8046;57;72;29;3;26;.897;3520000;0
2274;26865;57;0;0;0;0;.00nan;0;0
2274;31858;59;80;27;1;26;.963;3600000;0
2275;1592;63;0;0;0;0;.00nan;0;0
2275;2296;37;0;0;0;0;.00nan;0;0
2275;5883;37;56;17;2;15;.882;3581000;0
2275;34814;63;100;28;0;28;1.000;3600000;0
2276;751;64;0;0;0;0;.00nan;0;0
2276;4447;54;79;32;2;30;.938;3662000;0
2276;5146;64;59;25;3;22;.880;3662000;0
2276;31643;54;0;0;0;0;.00nan;0;0
2277;3626;48;0;0;0;0;.00nan;0;0
2277;7049;47;0;0;0;0;.00nan;0;0
2277;33654;47;89;26;1;25;.962;3900000;0
2277;38547;48;81;33;1;32;.970;3900000;0
2278;2152;49;87;18;0;18;1.000;3600000;0
2278;4435;49;0;0;0;0;.00nan;0;0
2278;4716;4619;87;34;2;32;.941;3600000;0
2278;10698;4619;0;0;0;0;.00nan;0;0
2279;3;50;87;33;2;31;.939;3900000;0
2279;5048;50;0;0;0;0;.00nan;0;0
2279;6572;62;93;38;2;36;.947;3900000;0
2279;26919;62;0;0;0;0;.00nan;0;0
2280;1051;44;0;0;0;0;.00nan;0;0
2280;3281;44;36;25;5;20;.800;3581000;0
2280;34788;42;90;46;4;42;.913;3600000;0
2280;37416;42;0;0;0;0;.00nan;0;0
2281;4338;65;0;0;0;0;.00nan;0;0
2281;4987;65;90;39;2;37;.949;3900000;0
2281;19640;41;0;0;0;0;.00nan;0;0
2281;23075;41;57;20;2;18;.900;3900000;0
2282;780;52;0;0;0;0;.00nan;0;0
2282;2796;59;49;25;4;21;.840;3568000;0
2282;31858;59;0;0;0;0;.00nan;0;0
2282;32146;52;76;37;3;34;.919;3600000;0
2283;5137;58;0;0;0;0;.00nan;0;0
2283;6081;56;91;39;2;37;.949;3588000;0
2283;14061;56;0;0;0;0;.00nan;0;0
2283;14321;58;78;26;1;25;.962;3600000;0
2284;2900;36;59;30;3;27;.900;3071000;0
2284;14874;36;32;13;3;10;.769;529000;0
2284;28772;53;0;0;0;0;.00nan;0;0
2284;31156;53;79;31;3;28;.903;3600000;0
2285;1486;43;0;0;0;0;.00nan;0;0
2285;2267;39;71;33;4;29;.879;3900000;0
2285;3625;43;58;38;4;34;.895;3900000;0
2285;9238;39;0;0;0;0;.00nan;0;0
2286;37;46;66;26;2;24;.923;3600000;0
2286;376;45;57;36;5;31;.861;3600000;0
2286;2198;45;0;0;0;0;.00nan;0;0
2286;2553;46;0;0;0;0;.00nan;0;0
2287;5298;55;52;17;2;15;.882;3600000;0
2287;8046;57;0;0;0;0;.00nan;0;0
2287;26865;57;59;27;3;24;.889;3550000;0
2287;34770;55;0;0;0;0;.00nan;0;0
2288;751;64;88;42;3;39;.929;3682000;0
2288;4447;54;0;0;0;0;.00nan;0;0
2288;5146;64;0;0;0;0;.00nan;0;0
2288;31643;54;58;31;4;27;.871;3735000;0
2289;2152;49;58;30;3;27;.900;3600000;0
2289;4435;49;0;0;0;0;.00nan;0;0
2289;4716;4619;89;20;0;20;1.000;3600000;0
2289;10698;4619;0;0;0;0;.00nan;0;0
2290;14351;40;93;44;2;42;.955;3584000;0
2290;20717;60;0;0;0;0;.00nan;0;0
2290;26840;40;0;0;0;0;.00nan;0;0
2290;35536;60;100;33;1;32;.970;3600000;0
2291;3;50;0;0;0;0;.00nan;0;0
2291;5048;50;58;42;6;36;.857;3600000;0
2291;6572;62;0;0;0;0;.00nan;0;0
2291;26919;62;74;30;3;27;.900;3600000;0
2292;1051;44;47;29;4;25;.862;3538000;0
2292;3281;44;0;0;0;0;.00nan;0;0
2292;34788;42;78;25;2;23;.920;3600000;0
2292;37416;42;0;0;0;0;.00nan;0;0
2293;3626;48;37;21;5;16;.762;2399000;0
2293;7049;47;71;32;3;29;.906;3600000;0
2293;33654;47;0;0;0;0;.00nan;0;0
2293;38547;48;29;14;4;10;.714;1201000;0
2294;2016;61;0;0;0;0;.00nan;0;0
2294;23493;51;0;0;0;0;.00nan;0;0
2294;30971;61;100;22;0;22;1.000;3600000;0
2294;31035;51;49;35;5;30;.857;3600000;0
2295;5137;58;0;0;0;0;.00nan;0;0
2295;6081;56;0;0;0;0;.00nan;0;0
2295;14061;56;70;26;2;24;.923;3743000;0
2295;14321;58;82;36;3;33;.917;3743000;0
2296;780;52;0;0;0;0;.00nan;0;0
2296;8046;57;66;18;1;17;.944;3600000;0
2296;26865;57;0;0;0;0;.00nan;0;0
2296;32146;52;90;35;2;33;.943;3571000;0
2297;1592;63;0;0;0;0;.00nan;0;0
2297;2296;37;0;0;0;0;.00nan;0;0
2297;5883;37;59;20;2;18;.900;3540000;0
2297;34814;63;100;33;0;33;1.000;3600000;0
2298;376;45;0;0;0;0;.00nan;0;0
2298;751;64;0;0;0;0;.00nan;0;0
2298;2198;45;92;35;2;33;.943;3600000;0
2298;5146;64;55;31;4;27;.871;3540000;0
2299;2900;36;0;0;0;0;.00nan;0;0
2299;7523;38;0;0;0;0;.00nan;0;0
2299;14874;36;68;30;3;27;.900;3900000;0
2299;31021;38;53;23;3;20;.870;3900000;0
2300;37;46;0;0;0;0;.00nan;0;0
2300;2553;46;100;30;0;30;1.000;3600000;0
2300;4447;54;70;32;3;29;.906;3600000;0
2300;31643;54;0;0;0;0;.00nan;0;0
2301;14351;40;0;0;0;0;.00nan;0;0
2301;20717;60;61;43;6;37;.860;3600000;0
2301;26840;40;59;26;3;23;.885;3600000;0
2301;35536;60;0;0;0;0;.00nan;0;0
2302;2016;61;0;0;0;0;.00nan;0;0
2302;23493;51;0;0;0;0;.00nan;0;0
2302;30971;61;66;33;4;29;.879;3600000;0
2302;31035;51;100;36;1;35;.972;3600000;0
2303;3626;48;0;0;0;0;.00nan;0;0
2303;34788;42;70;40;4;36;.900;3600000;0
2303;37416;42;0;0;0;0;.00nan;0;0
2303;38547;48;100;27;0;27;1.000;3600000;0
2304;780;52;0;0;0;0;.00nan;0;0
2304;4338;65;0;0;0;0;.00nan;0;0
2304;4987;65;50;30;5;25;.833;3900000;0
2304;32146;52;60;44;5;39;.886;3900000;0
2305;3;50;98;28;0;28;1.000;3600000;0
2305;1051;44;0;0;0;0;.00nan;0;0
2305;3281;44;80;30;1;29;.967;3600000;0
2305;5048;50;0;0;0;0;.00nan;0;0
2306;3626;48;65;30;3;27;.900;3600000;0
2306;34788;42;43;25;4;21;.840;3594000;0
2306;37416;42;0;0;0;0;.00nan;0;0
2306;38547;48;0;0;0;0;.00nan;0;0
2307;1592;63;0;0;0;0;.00nan;0;0
2307;2900;36;26;20;5;15;.750;3542000;0
2307;14874;36;0;0;0;0;.00nan;0;0
2307;34814;63;74;32;3;29;.906;3600000;0
2308;2296;37;0;0;0;0;.00nan;0;0
2308;4447;54;0;0;0;0;.00nan;0;0
2308;5883;37;80;48;5;43;.896;3600000;0
2308;31643;54;81;22;1;21;.955;3600000;0
2309;376;45;0;0;0;0;.00nan;0;0
2309;751;64;100;35;0;35;1.000;3600000;0
2309;2198;45;48;18;3;15;.833;3600000;0
2309;5146;64;0;0;0;0;.00nan;0;0
2310;5298;55;0;0;0;0;.00nan;0;0
2310;6081;56;0;0;0;0;.00nan;0;0
2310;14061;56;50;32;5;27;.844;3515000;0
2310;34770;55;62;30;3;27;.900;3600000;0
2311;37;46;0;0;0;0;.00nan;0;0
2311;1486;43;0;0;0;0;.00nan;0;0
2311;2553;46;73;26;2;24;.923;3600000;0
2311;3625;43;68;34;4;30;.882;3572000;0
2312;2796;59;0;0;0;0;.00nan;0;0
2312;8046;57;0;0;0;0;.00nan;0;0
2312;26865;57;99;44;2;42;.955;3600000;0
2312;31858;59;52;22;3;19;.864;3573000;0
2313;2267;39;0;0;0;0;.00nan;0;0
2313;9238;39;57;25;3;22;.880;3570000;0
2313;23493;51;0;0;0;0;.00nan;0;0
2313;31035;51;79;29;2;27;.931;3600000;0
2314;7049;47;0;0;0;0;.00nan;0;0
2314;20717;60;0;0;0;0;.00nan;0;0
2314;33654;47;74;32;2;30;.938;3900000;0
2314;35536;60;74;19;2;17;.895;3900000;0
2315;3;50;64;23;3;20;.870;3900000;0
2315;1051;44;57;23;3;20;.870;3900000;0
2315;3281;44;0;0;0;0;.00nan;0;0
2315;5048;50;0;0;0;0;.00nan;0;0
2316;19640;41;77;25;2;23;.920;3600000;0
2316;23075;41;0;0;0;0;.00nan;0;0
2316;28772;53;0;0;0;0;.00nan;0;0
2316;31156;53;65;33;3;30;.909;3550000;0
2317;780;52;0;0;0;0;.00nan;0;0
2317;7523;38;86;18;0;18;1.000;3600000;0
2317;31021;38;0;0;0;0;.00nan;0;0
2317;32146;52;98;43;1;42;.977;3600000;0
2318;19640;41;0;0;0;0;.00nan;0;0
2318;23075;41;53;34;5;29;.853;3808000;0
2318;28772;53;29;6;3;3;.500;600000;0
2318;31156;53;74;20;1;19;.950;3208000;0
2319;2900;36;0;0;0;0;.00nan;0;0
2319;5137;58;0;0;0;0;.00nan;0;0
2319;14321;58;98;35;2;33;.943;3900000;0
2319;14874;36;83;32;2;30;.938;3900000;0
2320;5298;55;0;0;0;0;.00nan;0;0
2320;6081;56;100;33;1;32;.970;3600000;0
2320;14061;56;0;0;0;0;.00nan;0;0
2320;34770;55;59;28;3;25;.893;3518000;0
2321;2267;39;0;0;0;0;.00nan;0;0
2321;9238;39;52;29;4;25;.862;3600000;0
2321;23493;51;0;0;0;0;.00nan;0;0
2321;31035;51;64;36;3;33;.917;3600000;0
2322;4338;65;65;28;3;25;.893;3600000;0
2322;4987;65;0;0;0;0;.00nan;0;0
2322;8046;57;88;43;4;39;.907;3600000;0
2322;26865;57;0;0;0;0;.00nan;0;0
2323;2296;37;0;0;0;0;.00nan;0;0
2323;4447;54;71;21;1;20;.952;3600000;0
2323;5883;37;97;41;2;39;.951;3580000;0
2323;31643;54;0;0;0;0;.00nan;0;0
2324;4716;4619;100;39;0;39;1.000;3600000;0
2324;7049;47;0;0;0;0;.00nan;0;0
2324;10698;4619;0;0;0;0;.00nan;0;0
2324;33654;47;60;23;3;20;.870;3600000;0
2325;2152;49;100;28;0;28;1.000;3600000;0
2325;4435;49;0;0;0;0;.00nan;0;0
2325;14351;40;62;28;4;24;.857;3600000;0
2325;26840;40;0;0;0;0;.00nan;0;0
2326;2016;61;60;21;2;19;.905;2581000;0
2326;6572;62;88;32;1;31;.969;3600000;0
2326;26919;62;0;0;0;0;.00nan;0;0
2326;30971;61;32;15;4;11;.733;1019000;0
2327;37;46;0;0;0;0;.00nan;0;0
2327;1592;63;0;0;0;0;.00nan;0;0
2327;2553;46;62;31;3;28;.903;3552000;0
2327;34814;63;76;28;2;26;.929;3600000;0
2328;5298;55;46;41;6;35;.854;3600000;0
2328;23493;51;0;0;0;0;.00nan;0;0
2328;31035;51;65;26;3;23;.885;3600000;0
2328;34770;55;0;0;0;0;.00nan;0;0
2329;4338;65;0;0;0;0;.00nan;0;0
2329;4987;65;68;19;1;18;.947;3600000;0
2329;5137;58;0;0;0;0;.00nan;0;0
2329;14321;58;76;33;3;30;.909;3585000;0
2330;2796;59;0;0;0;0;.00nan;0;0
2330;2900;36;66;25;2;23;.920;3556000;0
2330;14874;36;0;0;0;0;.00nan;0;0
2330;31858;59;90;32;1;31;.969;3600000;0
2331;2267;39;70;25;2;23;.920;3600000;0
2331;6081;56;0;0;0;0;.00nan;0;0
2331;9238;39;0;0;0;0;.00nan;0;0
2331;14061;56;60;40;6;34;.850;3600000;0
2332;1486;43;0;0;0;0;.00nan;0;0
2332;3625;43;81;29;2;27;.931;3600000;0
2332;4447;54;0;0;0;0;.00nan;0;0
2332;31643;54;80;38;3;35;.921;3564000;0
2333;1051;44;69;29;3;26;.897;3571000;0
2333;3281;44;0;0;0;0;.00nan;0;0
2333;34788;42;86;28;1;27;.964;3600000;0
2333;37416;42;0;0;0;0;.00nan;0;0
2334;780;52;0;0;0;0;.00nan;0;0
2334;7523;38;71;20;1;19;.950;3900000;0
2334;31021;38;0;0;0;0;.00nan;0;0
2334;32146;52;88;40;1;39;.975;3900000;0
2335;751;64;69;35;3;32;.914;3568000;0
2335;2296;37;0;0;0;0;.00nan;0;0
2335;5146;64;0;0;0;0;.00nan;0;0
2335;5883;37;65;25;2;23;.920;3600000;0
2336;3;50;82;35;2;33;.943;3656000;0
2336;376;45;0;0;0;0;.00nan;0;0
2336;2198;45;79;43;3;40;.930;3656000;0
2336;5048;50;0;0;0;0;.00nan;0;0
2337;4716;4619;58;37;4;33;.892;3880000;0
2337;7049;47;66;40;5;35;.875;3880000;0
2337;10698;4619;0;0;0;0;.00nan;0;0
2337;33654;47;0;0;0;0;.00nan;0;0
2338;3626;48;0;0;0;0;.00nan;0;0
2338;20717;60;0;0;0;0;.00nan;0;0
2338;35536;60;39;24;4;20;.833;3545000;0
2338;38547;48;84;38;2;36;.947;3600000;0
2339;2016;61;0;0;0;0;.00nan;0;0
2339;6572;62;0;0;0;0;.00nan;0;0
2339;26919;62;85;29;2;27;.931;3600000;0
2339;30971;61;71;33;3;30;.909;3600000;0
2340;19640;41;53;37;5;32;.865;3138000;0
2340;23075;41;42;3;1;2;.667;410000;0
2340;28772;53;0;0;0;0;.00nan;0;0
2340;31156;53;48;33;5;28;.848;3600000;0
2341;780;52;0;0;0;0;.00nan;0;0
2341;8046;57;0;0;0;0;.00nan;0;0
2341;26865;57;94;23;0;23;1.000;3600000;0
2341;32146;52;78;29;1;28;.966;3582000;0
2342;37;46;76;40;4;36;.900;3600000;0
2342;1592;63;64;24;2;22;.917;3600000;0
2342;2553;46;0;0;0;0;.00nan;0;0
2342;34814;63;0;0;0;0;.00nan;0;0
2343;751;64;0;0;0;0;.00nan;0;0
2343;1486;43;60;23;3;20;.870;3895000;0
2343;3625;43;0;0;0;0;.00nan;0;0
2343;5146;64;100;46;2;44;.957;3895000;0
2344;4338;65;93;24;0;24;1.000;3600000;0
2344;4987;65;0;0;0;0;.00nan;0;0
2344;5137;58;47;38;5;33;.868;3600000;0
2344;14321;58;0;0;0;0;.00nan;0;0
2345;1051;44;0;0;0;0;.00nan;0;0
2345;3281;44;97;55;3;52;.945;3600000;0
2345;34788;42;76;19;1;18;.947;3600000;0
2345;37416;42;0;0;0;0;.00nan;0;0
2346;3;50;0;0;0;0;.00nan;0;0
2346;376;45;73;31;3;28;.903;3567000;0
2346;2198;45;0;0;0;0;.00nan;0;0
2346;5048;50;72;29;2;27;.931;3600000;0
2347;2152;49;54;25;3;22;.880;3600000;0
2347;4435;49;0;0;0;0;.00nan;0;0
2347;14351;40;0;0;0;0;.00nan;0;0
2347;26840;40;28;36;7;29;.806;3600000;0
2348;3626;48;81;27;1;26;.963;3600000;0
2348;20717;60;98;42;2;40;.952;3570000;0
2348;35536;60;0;0;0;0;.00nan;0;0
2348;38547;48;0;0;0;0;.00nan;0;0
2349;6081;56;74;26;2;24;.923;3600000;0
2349;14061;56;0;0;0;0;.00nan;0;0
2349;28772;53;0;0;0;0;.00nan;0;0
2349;31156;53;75;38;3;35;.921;3572000;0
2350;37;46;0;0;0;0;.00nan;0;0
2350;1486;43;50;1;0;1;1.000;764000;0
2350;2553;46;66;31;4;27;.871;3600000;0
2350;3625;43;32;28;6;22;.786;2836000;0
2351;4338;65;57;24;3;21;.875;3563000;0
2351;4987;65;0;0;0;0;.00nan;0;0
2351;8046;57;0;0;0;0;.00nan;0;0
2351;26865;57;78;39;2;37;.949;3600000;0
2352;2900;36;0;0;0;0;.00nan;0;0
2352;5137;58;0;0;0;0;.00nan;0;0
2352;14321;58;70;32;3;29;.906;3600000;0
2352;14874;36;100;27;0;27;1.000;3600000;0
2353;2267;39;0;0;0;0;.00nan;0;0
2353;9238;39;81;31;2;29;.935;3600000;0
2353;23493;51;0;0;0;0;.00nan;0;0
2353;31035;51;76;39;4;35;.897;3522000;0
2354;376;45;0;0;0;0;.00nan;0;0
2354;751;64;61;28;3;25;.893;3600000;0
2354;2198;45;100;30;0;30;1.000;3600000;0
2354;5146;64;0;0;0;0;.00nan;0;0
2355;3;50;80;41;3;38;.927;3587000;0
2355;4447;54;55;19;2;17;.895;3600000;0
2355;5048;50;0;0;0;0;.00nan;0;0
2355;31643;54;0;0;0;0;.00nan;0;0
2356;7049;47;0;0;0;0;.00nan;0;0
2356;20717;60;0;0;0;0;.00nan;0;0
2356;33654;47;60;35;5;30;.857;3620000;0
2356;35536;60;38;32;6;26;.813;3620000;0
2357;3626;48;0;0;0;0;.00nan;0;0
2357;14351;40;0;0;0;0;.00nan;0;0
2357;26840;40;41;22;4;18;.818;3600000;0
2357;38547;48;54;51;6;45;.882;3585000;0
2358;2296;37;0;0;0;0;.00nan;0;0
2358;5883;37;90;31;1;30;.968;3600000;0
2358;34788;42;57;35;5;30;.857;3600000;0
2358;37416;42;0;0;0;0;.00nan;0;0
2359;1592;63;0;0;0;0;.00nan;0;0
2359;28772;53;0;0;0;0;.00nan;0;0
2359;31156;53;76;32;2;30;.938;3600000;0
2359;34814;63;87;23;1;22;.957;3600000;0
2360;1486;43;21;3;3;0;.000;515000;0
2360;3625;43;77;30;2;28;.933;3052000;0
2360;23493;51;0;0;0;0;.00nan;0;0
2360;31035;51;82;32;3;29;.906;3600000;0
2361;2900;36;0;0;0;0;.00nan;0;0
2361;5298;55;0;0;0;0;.00nan;0;0
2361;14874;36;94;44;2;42;.955;3580000;0
2361;34770;55;76;22;1;21;.955;3600000;0
2362;3;50;0;0;0;0;.00nan;0;0
2362;37;46;65;21;2;19;.905;3600000;0
2362;2553;46;0;0;0;0;.00nan;0;0
2362;5048;50;61;42;5;37;.881;3600000;0
2363;6847;52;0;0;0;0;.00nan;0;0
2363;8046;57;100;26;0;26;1.000;3600000;0
2363;26865;57;0;0;0;0;.00nan;0;0
2363;32146;52;81;47;4;43;.915;3600000;0
2364;2796;59;0;0;0;0;.00nan;0;0
2364;4338;65;0;0;0;0;.00nan;0;0
2364;4987;65;48;33;5;28;.848;3580000;0
2364;31858;59;56;23;3;20;.870;3600000;0
2365;5137;58;0;0;0;0;.00nan;0;0
2365;14321;58;100;31;0;31;1.000;3900000;0
2365;19640;41;97;36;0;36;1.000;3900000;0
2365;23075;41;0;0;0;0;.00nan;0;0
2366;376;45;0;0;0;0;.00nan;0;0
2366;751;64;98;29;1;28;.966;3600000;0
2366;2198;45;84;33;2;31;.939;3600000;0
2366;5146;64;0;0;0;0;.00nan;0;0
2367;2152;49;100;30;0;30;1.000;3600000;0
2367;4435;49;0;0;0;0;.00nan;0;0
2367;6572;62;0;0;0;0;.00nan;0;0
2367;26919;62;59;42;5;37;.881;3600000;0
2368;2016;61;0;0;0;0;.00nan;0;0
2368;20717;60;0;0;0;0;.00nan;0;0
2368;30971;61;92;30;2;28;.933;3561000;0
2368;35536;60;79;22;1;21;.955;3600000;0
2369;1051;44;84;38;3;35;.921;3900000;0
2369;3281;44;0;0;0;0;.00nan;0;0
2369;4716;4619;59;21;3;18;.857;3900000;0
2369;10698;4619;0;0;0;0;.00nan;0;0
2370;3626;48;0;0;0;0;.00nan;0;0
2370;14351;40;0;0;0;0;.00nan;0;0
2370;26840;40;75;17;1;16;.941;3600000;0
2370;38547;48;59;37;4;33;.892;3600000;0
2371;2296;37;48;0;0;0;.00nan;455000;0
2371;5883;37;43;34;6;28;.824;3145000;0
2371;34788;42;77;23;2;21;.913;3600000;0
2371;37416;42;0;0;0;0;.00nan;0;0
2372;2796;59;0;0;0;0;.00nan;0;0
2372;6847;52;0;0;0;0;.00nan;0;0
2372;31858;59;83;33;2;31;.939;3643000;0
2372;32146;52;63;24;3;21;.875;3643000;0
2373;5137;58;0;0;0;0;.00nan;0;0
2373;14321;58;81;42;4;38;.905;3584000;0
2373;19640;41;66;22;2;20;.909;3600000;0
2373;23075;41;0;0;0;0;.00nan;0;0
2374;1592;63;66;30;3;27;.900;3600000;0
2374;2900;36;33;25;5;20;.800;3571000;0
2374;14874;36;0;0;0;0;.00nan;0;0
2374;34814;63;0;0;0;0;.00nan;0;0
2375;1486;43;88;28;1;27;.964;3600000;0
2375;3625;43;0;0;0;0;.00nan;0;0
2375;23493;51;0;0;0;0;.00nan;0;0
2375;31035;51;84;49;4;45;.918;3600000;0
2376;5298;55;100;23;0;23;1.000;3600000;0
2376;6081;56;0;0;0;0;.00nan;0;0
2376;14061;56;50;31;4;27;.871;3600000;0
2376;34770;55;0;0;0;0;.00nan;0;0
2377;3;50;72;25;2;23;.920;3900000;0
2377;4447;54;57;18;2;16;.889;3900000;0
2377;5048;50;0;0;0;0;.00nan;0;0
2377;31643;54;0;0;0;0;.00nan;0;0
2378;7523;38;0;0;0;0;.00nan;0;0
2378;8046;57;82;22;1;21;.955;3600000;0
2378;26865;57;0;0;0;0;.00nan;0;0
2378;31021;38;91;36;3;33;.917;3554000;0
2379;2267;39;0;0;0;0;.00nan;0;0
2379;9238;39;76;29;2;27;.931;3600000;0
2379;28772;53;62;42;5;37;.881;3591000;0
2379;31156;53;0;0;0;0;.00nan;0;0
2380;376;45;72;32;4;28;.875;3900000;0
2380;751;64;0;0;0;0;.00nan;0;0
2380;2198;45;0;0;0;0;.00nan;0;0
2380;5146;64;64;36;4;32;.889;3900000;0
2381;2016;61;0;0;0;0;.00nan;0;0
2381;7049;47;0;0;0;0;.00nan;0;0
2381;30971;61;85;38;3;35;.921;3551000;0
2381;33654;47;95;31;1;30;.968;3600000;0
2382;2152;49;56;27;4;23;.852;3600000;0
2382;4435;49;0;0;0;0;.00nan;0;0
2382;6572;62;100;28;0;28;1.000;3600000;0
2382;26919;62;0;0;0;0;.00nan;0;0
2383;1051;44;0;0;0;0;.00nan;0;0
2383;3281;44;37;20;4;16;.800;3596000;0
2383;4716;4619;59;41;5;36;.878;3600000;0
2383;10698;4619;0;0;0;0;.00nan;0;0
2384;3626;48;63;36;4;32;.889;3600000;0
2384;14351;40;91;29;1;28;.966;3600000;0
2384;26840;40;0;0;0;0;.00nan;0;0
2384;38547;48;0;0;0;0;.00nan;0;0
2385;4338;65;48;27;4;23;.852;3900000;0
2385;4987;65;0;0;0;0;.00nan;0;0
2385;7523;38;56;28;4;24;.857;3900000;0
2385;31021;38;0;0;0;0;.00nan;0;0
2386;1486;43;0;0;0;0;.00nan;0;0
2386;3625;43;52;16;2;14;.875;3600000;0
2386;5298;55;54;37;4;33;.892;3533000;0
2386;34770;55;0;0;0;0;.00nan;0;0
2387;3;50;71;17;1;16;.941;2482000;0
2387;37;46;32;29;6;23;.793;3600000;0
2387;2553;46;0;0;0;0;.00nan;0;0
2387;5048;50;30;15;4;11;.733;1118000;0
2388;1486;43;70;26;2;24;.923;3569000;0
2388;3625;43;0;0;0;0;.00nan;0;0
2388;5298;55;0;0;0;0;.00nan;0;0
2388;34770;55;100;38;1;37;.974;3600000;0
2389;1592;63;0;0;0;0;.00nan;0;0
2389;6081;56;77;21;1;20;.952;3600000;0
2389;14061;56;0;0;0;0;.00nan;0;0
2389;34814;63;77;30;2;28;.933;3545000;0
2390;376;45;0;0;0;0;.00nan;0;0
2390;2198;45;99;37;1;36;.973;3600000;0
2390;4447;54;54;25;3;22;.880;3563000;0
2390;31643;54;0;0;0;0;.00nan;0;0
2391;37;46;0;0;0;0;.00nan;0;0
2391;2553;46;51;31;4;27;.871;3595000;0
2391;34788;42;60;24;3;21;.875;3600000;0
2391;37416;42;0;0;0;0;.00nan;0;0
2392;2152;49;99;35;1;34;.971;3600000;0
2392;4435;49;0;0;0;0;.00nan;0;0
2392;4716;4619;61;24;2;22;.917;3552000;0
2392;10698;4619;0;0;0;0;.00nan;0;0
2393;7049;47;0;0;0;0;.00nan;0;0
2393;20717;60;0;0;0;0;.00nan;0;0
2393;33654;47;65;28;4;24;.857;3600000;0
2393;35536;60;58;36;5;31;.861;3600000;0
2394;1051;44;75;27;1;26;.963;3576000;0
2394;3281;44;0;0;0;0;.00nan;0;0
2394;14351;40;0;0;0;0;.00nan;0;0
2394;26840;40;100;44;0;44;1.000;3600000;0
2395;2016;61;0;0;0;0;.00nan;0;0
2395;6572;62;65;28;3;25;.893;3900000;0
2395;26919;62;0;0;0;0;.00nan;0;0
2395;30971;61;82;34;3;31;.912;3900000;0
2396;19640;41;79;26;2;24;.923;3600000;0
2396;23075;41;0;0;0;0;.00nan;0;0
2396;28772;53;0;0;0;0;.00nan;0;0
2396;31156;53;67;44;5;39;.886;3600000;0
2397;6847;52;0;0;0;0;.00nan;0;0
2397;14321;58;46;17;3;14;.824;3784000;0
2397;21469;58;0;0;0;0;.00nan;0;0
2397;32146;52;95;35;2;33;.943;3784000;0
2398;2900;36;0;0;0;0;.00nan;0;0
2398;6081;56;63;34;4;30;.882;3600000;0
2398;14061;56;0;0;0;0;.00nan;0;0
2398;14874;36;69;19;1;18;.947;3600000;0
2399;2267;39;0;0;0;0;.00nan;0;0
2399;5298;55;0;0;0;0;.00nan;0;0
2399;9238;39;68;39;4;35;.897;3900000;0
2399;34770;55;52;32;4;28;.875;3900000;0
2400;1592;63;50;3;0;3;1.000;454000;0
2400;23493;51;0;0;0;0;.00nan;0;0
2400;31035;51;66;23;1;22;.957;3600000;0
2400;34814;63;34;34;6;28;.824;3146000;0
2401;37;46;0;0;0;0;.00nan;0;0
2401;751;64;0;0;0;0;.00nan;0;0
2401;2553;46;70;18;1;17;.944;3600000;0
2401;5146;64;56;41;4;37;.902;3600000;0
2402;2796;59;0;0;0;0;.00nan;0;0
2402;7523;38;78;26;1;25;.962;3600000;0
2402;31021;38;0;0;0;0;.00nan;0;0
2402;31858;59;76;35;2;33;.943;3600000;0
2403;4338;65;60;16;2;14;.875;3600000;0
2403;4987;65;0;0;0;0;.00nan;0;0
2403;8046;57;74;39;4;35;.897;3521000;0
2403;26865;57;0;0;0;0;.00nan;0;0
2404;3;50;0;0;0;0;.00nan;0;0
2404;376;45;80;37;3;34;.919;3546000;0
2404;2198;45;0;0;0;0;.00nan;0;0
2404;5048;50;64;22;2;20;.909;3600000;0
2405;2152;49;63;35;4;31;.886;3600000;0
2405;4435;49;0;0;0;0;.00nan;0;0
2405;4716;4619;81;24;1;23;.958;3600000;0
2405;10698;4619;0;0;0;0;.00nan;0;0
2406;1051;44;91;28;1;27;.964;3600000;0
2406;3281;44;0;0;0;0;.00nan;0;0
2406;7049;47;0;0;0;0;.00nan;0;0
2406;33654;47;55;30;4;26;.867;3600000;0
2407;2016;61;0;0;0;0;.00nan;0;0
2407;14351;40;0;0;0;0;.00nan;0;0
2407;26840;40;99;29;0;29;1.000;3600000;0
2407;30971;61;74;29;2;27;.931;3536000;0
2408;2796;59;78;36;3;33;.917;3576000;0
2408;14321;58;0;0;0;0;.00nan;0;0
2408;21469;58;91;27;1;26;.963;3600000;0
2408;31858;59;0;0;0;0;.00nan;0;0
2409;6847;52;0;0;0;0;.00nan;0;0
2409;28772;53;100;37;0;37;1.000;3600000;0
2409;31156;53;0;0;0;0;.00nan;0;0
2409;32146;52;59;35;5;30;.857;3600000;0
2410;4338;65;0;0;0;0;.00nan;0;0
2410;4987;65;55;24;3;21;.875;3600000;0
2410;8046;57;0;0;0;0;.00nan;0;0
2410;26865;57;64;36;4;32;.889;3543000;0
2411;2900;36;96;19;0;19;1.000;3600000;0
2411;14874;36;0;0;0;0;.00nan;0;0
2411;23493;51;0;0;0;0;.00nan;0;0
2411;31035;51;66;37;4;33;.892;3600000;0
2412;2296;37;0;0;0;0;.00nan;0;0
2412;5883;37;82;38;2;36;.947;3547000;0
2412;34788;42;79;29;1;28;.966;3600000;0
2412;37416;42;0;0;0;0;.00nan;0;0
2413;3;50;80;28;1;27;.964;3600000;0
2413;376;45;0;0;0;0;.00nan;0;0
2413;2198;45;52;27;3;24;.889;3567000;0
2413;5048;50;0;0;0;0;.00nan;0;0
2414;7523;38;0;0;0;0;.00nan;0;0
2414;19640;41;0;0;0;0;.00nan;0;0
2414;23075;41;89;27;1;26;.963;3600000;0
2414;31021;38;75;35;4;31;.886;3600000;0
2415;1486;43;0;0;0;0;.00nan;0;0
2415;2267;39;71;37;4;33;.892;3563000;0
2415;3625;43;70;26;2;24;.923;3600000;0
2415;9238;39;0;0;0;0;.00nan;0;0
2416;751;64;60;32;4;28;.875;3600000;0
2416;4447;54;6;15;6;9;.600;2420000;0
2416;5146;64;0;0;0;0;.00nan;0;0
2416;31643;54;59;8;0;8;1.000;1094000;0
2417;2152;49;0;0;0;0;.00nan;0;0
2417;4435;49;61;34;4;30;.882;3600000;0
2417;4716;4619;98;19;0;19;1.000;3600000;0
2417;10698;4619;0;0;0;0;.00nan;0;0
2418;7049;47;100;40;0;40;1.000;3829000;0
2418;14351;40;0;0;0;0;.00nan;0;0
2418;26840;40;92;27;1;26;.963;3829000;0
2418;33654;47;0;0;0;0;.00nan;0;0
2419;1051;44;0;0;0;0;.00nan;0;0
2419;3281;44;88;50;4;46;.920;3565000;0
2419;6572;62;0;0;0;0;.00nan;0;0
2419;26919;62;77;26;2;24;.923;3600000;0
2420;3626;48;0;0;0;0;.00nan;0;0
2420;20717;60;0;0;0;0;.00nan;0;0
2420;35536;60;92;33;2;31;.939;3900000;0
2420;38547;48;85;38;2;36;.947;3900000;0
2421;7523;38;53;21;3;18;.857;3573000;0
2421;14321;58;99;44;1;43;.977;3600000;0
2421;21469;58;0;0;0;0;.00nan;0;0
2421;31021;38;0;0;0;0;.00nan;0;0
2422;2796;59;0;0;0;0;.00nan;0;0
2422;28772;53;95;24;1;23;.958;3667000;0
2422;31156;53;0;0;0;0;.00nan;0;0
2422;31858;59;94;43;2;41;.953;3667000;0
2423;1486;43;54;25;3;22;.880;3600000;0
2423;2267;39;0;0;0;0;.00nan;0;0
2423;3625;43;0;0;0;0;.00nan;0;0
2423;9238;39;56;35;5;30;.857;3572000;0
2424;1592;63;0;0;0;0;.00nan;0;0
2424;6081;56;100;37;1;36;.973;3600000;0
2424;14061;56;0;0;0;0;.00nan;0;0
2424;34814;63;63;34;4;30;.882;3600000;0
2425;2296;37;0;0;0;0;.00nan;0;0
2425;4447;54;0;0;0;0;.00nan;0;0
2425;5883;37;77;42;3;39;.929;3600000;0
2425;31643;54;100;23;0;23;1.000;3600000;0
2426;37;46;24;12;4;8;.667;810000;0
2426;751;64;0;0;0;0;.00nan;0;0
2426;2553;46;54;19;2;17;.895;2790000;0
2426;5146;64;61;43;5;38;.884;3600000;0
2427;2900;36;0;0;0;0;.00nan;0;0
2427;4338;65;60;23;2;21;.913;3600000;0
2427;4987;65;0;0;0;0;.00nan;0;0
2427;14874;36;89;28;1;27;.964;3600000;0
2428;3;50;0;0;0;0;.00nan;0;0
2428;5048;50;64;39;5;34;.872;3600000;0
2428;34788;42;0;0;0;0;.00nan;0;0
2428;37416;42;54;29;4;25;.862;3600000;0
2429;3626;48;87;51;5;46;.902;3600000;0
2429;20717;60;69;21;2;19;.905;3600000;0
2429;35536;60;0;0;0;0;.00nan;0;0
2429;38547;48;0;0;0;0;.00nan;0;0
2925;780;52;0;0;0;0;.00nan;0;0
2925;14351;40;100;31;0;31;1.000;3600000;0
2925;23255;52;91;39;3;36;.923;3600000;0
2925;26840;40;0;0;0;0;.00nan;0;0
2927;2163;39;0;0;0;0;.00nan;0;0
2927;5146;64;62;47;6;41;.872;3519000;0
2927;9238;39;40;19;4;15;.789;3600000;0
2927;28845;64;0;0;0;0;.00nan;0;0
2929;1486;43;99;48;3;45;.938;3600000;0
2929;3625;43;0;0;0;0;.00nan;0;0
2929;34788;42;37;30;5;25;.833;3538000;0
2929;37416;42;0;0;0;0;.00nan;0;0
2931;37;46;0;0;0;0;.00nan;0;0
2931;2553;46;57;32;5;27;.844;3600000;0
2931;19640;41;0;0;0;0;.00nan;0;0
2931;23075;41;78;13;0;13;1.000;3600000;0
2933;376;45;89;28;1;27;.964;3600000;0
2933;2198;45;0;0;0;0;.00nan;0;0
2933;4447;54;0;0;0;0;.00nan;0;0
2933;31643;54;54;23;3;20;.870;3564000;0
2935;4338;65;0;0;0;0;.00nan;0;0
2935;4987;65;49;23;3;20;.870;3600000;0
2935;6572;62;0;0;0;0;.00nan;0;0
2935;26919;62;50;39;6;33;.846;3600000;0
2937;2900;36;61;25;3;22;.880;3566000;0
2937;3626;48;0;0;0;0;.00nan;0;0
2937;14874;36;0;0;0;0;.00nan;0;0
2937;38547;48;85;38;2;36;.947;3600000;0
2939;5137;58;0;0;0;0;.00nan;0;0
2939;5298;55;80;36;3;33;.917;3589000;0
2939;14321;58;68;27;2;25;.926;3600000;0
2939;34770;55;0;0;0;0;.00nan;0;0
2941;3847;38;0;0;0;0;.00nan;0;0
2941;20717;60;0;0;0;0;.00nan;0;0
2941;31021;38;52;23;3;20;.870;3600000;0
2941;35536;60;52;30;4;26;.867;3600000;0
2943;2296;37;0;0;0;0;.00nan;0;0
2943;5883;37;69;29;2;27;.931;3600000;0
2943;28772;53;0;0;0;0;.00nan;0;0
2943;31156;53;48;23;3;20;.870;3565000;0
2945;1051;44;66;31;3;28;.903;3600000;0
2945;3281;44;0;0;0;0;.00nan;0;0
2945;6081;56;69;26;2;24;.923;3600000;0
2945;26824;56;0;0;0;0;.00nan;0;0
2947;3;50;0;0;0;0;.00nan;0;0
2947;5048;50;67;28;3;25;.893;3600000;0
2947;7049;47;18;32;7;25;.781;3600000;0
2947;33654;47;0;0;0;0;.00nan;0;0
2949;2152;49;52;16;2;14;.875;1379000;0
2949;2796;59;0;0;0;0;.00nan;0;0
2949;4435;49;22;27;7;20;.741;2221000;0
2949;31858;59;53;30;4;26;.867;3600000;0
2951;1592;63;0;0;0;0;.00nan;0;0
2951;8046;57;0;0;0;0;.00nan;0;0
2951;26865;57;97;17;0;17;1.000;3600000;0
2951;26967;63;88;46;2;44;.957;3600000;0
2953;4716;4619;0;0;0;0;.00nan;0;0
2953;23493;51;91;51;4;47;.922;3585000;0
2953;31822;51;0;0;0;0;.00nan;0;0
2953;35210;4619;48;22;3;19;.864;3600000;0
2955;1592;63;0;0;0;0;.00nan;0;0
2955;3626;48;60;21;2;19;.905;3600000;0
2955;26967;63;55;30;4;26;.867;3561000;0
2955;38547;48;0;0;0;0;.00nan;0;0
2957;2900;36;98;38;1;37;.974;3600000;0
2957;14874;36;0;0;0;0;.00nan;0;0
2957;28845;64;54;28;3;25;.893;3512000;0
2957;32826;64;0;0;0;0;.00nan;0;0
2959;3;50;0;0;0;0;.00nan;0;0
2959;2163;39;0;0;0;0;.00nan;0;0
2959;5048;50;47;40;6;34;.850;3600000;0
2959;9238;39;61;15;1;14;.933;3600000;0
2961;2016;61;0;0;0;0;.00nan;0;0
2961;4447;54;74;24;1;23;.958;3600000;0
2961;30971;61;67;37;5;32;.865;3600000;0
2961;31643;54;0;0;0;0;.00nan;0;0
2963;4716;4619;74;22;2;20;.909;3600000;0
2963;34788;42;0;0;0;0;.00nan;0;0
2963;35210;4619;0;0;0;0;.00nan;0;0
2963;37416;42;50;28;4;24;.857;3585000;0
2965;7049;47;97;42;1;41;.976;3564000;0
2965;23493;51;0;0;0;0;.00nan;0;0
2965;31822;51;97;26;0;26;1.000;3600000;0
2965;33654;47;0;0;0;0;.00nan;0;0
2967;37;46;48;38;5;33;.868;3576000;0
2967;2553;46;0;0;0;0;.00nan;0;0
2967;5298;55;51;25;4;21;.840;3600000;0
2967;34770;55;0;0;0;0;.00nan;0;0
2969;1051;44;0;0;0;0;.00nan;0;0
2969;3281;44;74;30;1;29;.967;3600000;0
2969;20717;60;0;0;0;0;.00nan;0;0
2969;35536;60;65;26;3;23;.885;3513000;0
2971;780;52;0;0;0;0;.00nan;0;0
2971;23255;52;83;34;3;31;.912;3563000;0
2971;28772;53;49;15;2;13;.867;3600000;0
2971;31156;53;0;0;0;0;.00nan;0;0
2973;2796;59;0;0;0;0;.00nan;0;0
2973;4338;65;51;39;6;33;.846;3600000;0
2973;4987;65;0;0;0;0;.00nan;0;0
2973;31858;59;81;32;2;30;.938;3600000;0
2975;3847;38;0;0;0;0;.00nan;0;0
2975;8046;57;0;0;0;0;.00nan;0;0
2975;26865;57;68;31;3;28;.903;3536000;0
2975;31021;38;79;24;1;23;.958;3600000;0
2977;376;45;79;37;3;34;.919;3600000;0
2977;2198;45;0;0;0;0;.00nan;0;0
2977;19640;41;0;0;0;0;.00nan;0;0
2977;23075;41;75;32;2;30;.938;3600000;0
2979;5137;58;0;0;0;0;.00nan;0;0
2979;6572;62;77;32;2;30;.938;3801000;0
2979;14321;58;71;40;3;37;.925;3801000;0
2979;26919;62;0;0;0;0;.00nan;0;0
2981;2296;37;0;0;0;0;.00nan;0;0
2981;5883;37;100;30;0;30;1.000;3600000;0
2981;6081;56;0;0;0;0;.00nan;0;0
2981;26824;56;80;34;2;32;.941;3580000;0
2983;1486;43;43;22;4;18;.818;3548000;0
2983;3625;43;0;0;0;0;.00nan;0;0
2983;14351;40;50;17;2;15;.882;3600000;0
2983;26840;40;0;0;0;0;.00nan;0;0
2985;3626;48;0;0;0;0;.00nan;0;0
2985;19640;41;66;20;1;19;.950;3600000;0
2985;23075;41;0;0;0;0;.00nan;0;0
2985;38547;48;66;46;5;41;.891;3600000;0
2987;37;46;0;0;0;0;.00nan;0;0
2987;1592;63;60;42;5;37;.881;3600000;0
2987;2553;46;75;33;2;31;.939;3600000;0
2987;26967;63;0;0;0;0;.00nan;0;0
2989;2152;49;90;37;2;35;.946;3900000;0
2989;4435;49;0;0;0;0;.00nan;0;0
2989;5137;58;96;41;2;39;.951;3900000;0
2989;14321;58;0;0;0;0;.00nan;0;0
2991;2016;61;87;35;3;32;.914;3900000;0
2991;5298;55;0;0;0;0;.00nan;0;0
2991;30971;61;0;0;0;0;.00nan;0;0
2991;34770;55;70;32;3;29;.906;3900000;0
2993;23493;51;0;0;0;0;.00nan;0;0
2993;31822;51;65;32;3;29;.906;3600000;0
2993;34788;42;83;28;2;26;.929;3600000;0
2993;37416;42;0;0;0;0;.00nan;0;0
2995;3;50;80;26;1;25;.962;3600000;0
2995;2163;39;30;16;4;12;.750;1199000;0
2995;5048;50;0;0;0;0;.00nan;0;0
2995;9238;39;38;25;5;20;.800;2401000;0
2997;780;52;55;31;4;27;.871;3511000;0
2997;2296;37;0;0;0;0;.00nan;0;0
2997;5883;37;87;35;2;33;.943;3600000;0
2997;23255;52;0;0;0;0;.00nan;0;0
2999;1486;43;0;0;0;0;.00nan;0;0
2999;2900;36;0;0;0;0;.00nan;0;0
2999;3625;43;83;43;3;40;.930;3600000;0
2999;14874;36;25;21;5;16;.762;3533000;0
3001;3847;38;71;17;1;16;.941;3600000;0
3001;6081;56;98;51;2;49;.961;3573000;0
3001;26824;56;0;0;0;0;.00nan;0;0
3001;31021;38;0;0;0;0;.00nan;0;0
3003;376;45;0;0;0;0;.00nan;0;0
3003;1051;44;59;27;3;24;.889;3585000;0
3003;2198;45;79;27;2;25;.926;3600000;0
3003;3281;44;0;0;0;0;.00nan;0;0
3005;4716;4619;0;0;0;0;.00nan;0;0
3005;7049;47;0;0;0;0;.00nan;0;0
3005;33654;47;70;34;3;31;.912;3600000;0
3005;35210;4619;97;24;0;24;1.000;3600000;0
3007;4338;65;0;0;0;0;.00nan;0;0
3007;4987;65;84;26;1;25;.962;3600000;0
3007;6572;62;0;0;0;0;.00nan;0;0
3007;26919;62;97;44;2;42;.955;3570000;0
3009;14351;40;0;0;0;0;.00nan;0;0
3009;26840;40;83;39;3;36;.923;3600000;0
3009;28845;64;0;0;0;0;.00nan;0;0
3009;32826;64;74;25;2;23;.920;3600000;0
3011;4447;54;0;0;0;0;.00nan;0;0
3011;28772;53;0;0;0;0;.00nan;0;0
3011;31156;53;61;38;4;34;.895;3569000;0
3011;31643;54;79;30;2;28;.933;3600000;0
3013;2796;59;0;0;0;0;.00nan;0;0
3013;20717;60;89;35;1;34;.971;3753000;0
3013;31858;59;85;29;2;27;.931;3753000;0
3013;35536;60;0;0;0;0;.00nan;0;0
3015;4716;4619;26;21;5;16;.762;3600000;0
3015;7049;47;99;47;2;45;.957;3600000;0
3015;33654;47;0;0;0;0;.00nan;0;0
3015;35210;4619;0;0;0;0;.00nan;0;0
3017;37;46;59;32;4;28;.875;3900000;0
3017;2553;46;0;0;0;0;.00nan;0;0
3017;8046;57;0;0;0;0;.00nan;0;0
3017;26865;57;31;18;4;14;.778;3900000;0
3019;2796;59;0;0;0;0;.00nan;0;0
3019;2900;36;62;9;0;9;1.000;1022000;0
3019;14874;36;12;29;7;22;.759;2578000;0
3019;31858;59;96;43;2;41;.953;3600000;0
3021;1051;44;70;32;3;29;.906;3590000;0
3021;1486;43;73;21;1;20;.952;3600000;0
3021;3281;44;0;0;0;0;.00nan;0;0
3021;3625;43;0;0;0;0;.00nan;0;0
3023;14351;40;89;38;2;36;.947;3600000;0
3023;26840;40;0;0;0;0;.00nan;0;0
3023;34788;42;0;0;0;0;.00nan;0;0
3023;37416;42;34;32;6;26;.813;3600000;0
3025;376;45;67;33;4;29;.879;3600000;0
3025;1592;63;0;0;0;0;.00nan;0;0
3025;2198;45;0;0;0;0;.00nan;0;0
3025;26967;63;18;32;7;25;.781;3600000;0
3027;3;50;37;8;2;6;.750;1211000;0
3027;5048;50;15;20;6;14;.700;2389000;0
3027;6572;62;72;25;2;23;.920;3600000;0
3027;26919;62;0;0;0;0;.00nan;0;0
3029;5137;58;50;2;0;2;1.000;334000;0
3029;14321;58;29;38;7;31;.816;3266000;0
3029;28845;64;0;0;0;0;.00nan;0;0
3029;32826;64;60;31;4;27;.871;3600000;0
3031;3626;48;83;46;4;42;.913;3572000;0
3031;28772;53;0;0;0;0;.00nan;0;0
3031;31156;53;65;27;3;24;.889;3600000;0
3031;38547;48;0;0;0;0;.00nan;0;0
3033;780;52;0;0;0;0;.00nan;0;0
3033;2163;39;68;31;3;28;.903;3600000;0
3033;9238;39;0;0;0;0;.00nan;0;0
3033;23255;52;69;44;4;40;.909;3570000;0
3035;4447;54;0;0;0;0;.00nan;0;0
3035;23493;51;63;38;4;34;.895;3900000;0
3035;31643;54;64;38;4;34;.895;3900000;0
3035;31822;51;0;0;0;0;.00nan;0;0
3037;2296;37;81;24;1;23;.958;3600000;0
3037;5883;37;0;0;0;0;.00nan;0;0
3037;20717;60;52;38;5;33;.868;3600000;0
3037;35536;60;0;0;0;0;.00nan;0;0
3039;5298;55;0;0;0;0;.00nan;0;0
3039;19640;41;0;0;0;0;.00nan;0;0
3039;23075;41;59;29;3;26;.897;3900000;0
3039;34770;55;79;41;3;38;.927;3900000;0
3041;3847;38;0;0;0;0;.00nan;0;0
3041;4338;65;0;0;0;0;.00nan;0;0
3041;4987;65;67;31;3;28;.903;3600000;0
3041;31021;38;59;29;4;25;.862;3555000;0
3043;2016;61;0;0;0;0;.00nan;0;0
3043;6081;56;83;41;2;39;.951;3542000;0
3043;26824;56;0;0;0;0;.00nan;0;0
3043;30971;61;66;17;1;16;.941;3600000;0
3045;376;45;0;0;0;0;.00nan;0;0
3045;780;52;79;22;1;21;.955;3600000;0
3045;2198;45;59;25;3;22;.880;3515000;0
3045;23255;52;0;0;0;0;.00nan;0;0
3047;3626;48;0;0;0;0;.00nan;0;0
3047;14351;40;0;0;0;0;.00nan;0;0
3047;26840;40;39;20;4;16;.800;3571000;0
3047;38547;48;69;34;3;31;.912;3600000;0
3049;3;50;0;0;0;0;.00nan;0;0
3049;5048;50;100;30;0;30;1.000;3600000;0
3049;5298;55;34;27;5;22;.815;3600000;0
3049;34770;55;0;0;0;0;.00nan;0;0
3051;2796;59;83;31;2;29;.935;3600000;0
3051;4447;54;60;32;3;29;.906;3600000;0
3051;31643;54;0;0;0;0;.00nan;0;0
3051;31858;59;0;0;0;0;.00nan;0;0
3053;5137;58;44;29;4;25;.862;3900000;0
3053;8046;57;57;32;4;28;.875;3900000;0
3053;14321;58;0;0;0;0;.00nan;0;0
3053;26865;57;0;0;0;0;.00nan;0;0
3055;1592;63;22;5;3;2;.400;484000;0
3055;2900;36;59;22;2;20;.909;3600000;0
3055;14874;36;0;0;0;0;.00nan;0;0
3055;26967;63;59;29;3;26;.897;3116000;0
3057;2163;39;0;0;0;0;.00nan;0;0
3057;9238;39;70;28;2;26;.929;3600000;0
3057;28845;64;59;32;4;28;.875;3539000;0
3057;32826;64;0;0;0;0;.00nan;0;0
3059;1486;43;0;0;0;0;.00nan;0;0
3059;3625;43;48;17;3;14;.824;3600000;0
3059;4338;65;40;27;5;22;.815;2297000;0
3059;4987;65;45;14;2;12;.857;1303000;0
3061;1051;44;0;0;0;0;.00nan;0;0
3061;3281;44;59;23;3;20;.870;3600000;0
3061;7049;47;0;0;0;0;.00nan;0;0
3061;33654;47;100;26;0;26;1.000;3600000;0
3063;6572;62;0;0;0;0;.00nan;0;0
3063;23493;51;0;0;0;0;.00nan;0;0
3063;26919;62;37;34;6;28;.824;3600000;0
3063;31822;51;74;36;3;33;.917;3600000;0
3065;2152;49;0;0;0;0;.00nan;0;0
3065;4435;49;36;24;5;19;.792;3553000;0
3065;28772;53;46;28;4;24;.857;3600000;0
3065;31156;53;0;0;0;0;.00nan;0;0
3067;37;46;54;8;1;7;.875;3072000;0
3067;2553;46;25;5;3;2;.400;528000;0
3067;6081;56;63;14;1;13;.929;1256000;0
3067;26824;56;18;35;8;27;.771;2344000;0
3069;3847;38;43;30;5;25;.833;3600000;0
3069;20717;60;0;0;0;0;.00nan;0;0
3069;31021;38;0;0;0;0;.00nan;0;0
3069;35536;60;86;41;2;39;.951;3600000;0
3071;19640;41;49;24;3;21;.875;3554000;0
3071;23075;41;0;0;0;0;.00nan;0;0
3071;34788;42;79;30;2;28;.933;3600000;0
3071;37416;42;0;0;0;0;.00nan;0;0
3073;2296;37;0;0;0;0;.00nan;0;0
3073;4716;4619;0;0;0;0;.00nan;0;0
3073;5883;37;73;29;2;27;.931;3600000;0
3073;35210;4619;66;37;4;33;.892;3600000;0
3075;1592;63;0;0;0;0;.00nan;0;0
3075;20717;60;58;38;5;33;.868;3592000;0
3075;26967;63;55;24;3;21;.875;3600000;0
3075;35536;60;0;0;0;0;.00nan;0;0
3077;2296;37;0;0;0;0;.00nan;0;0
3077;5883;37;51;28;4;24;.857;3600000;0
3077;14351;40;35;36;6;30;.833;3528000;0
3077;26840;40;0;0;0;0;.00nan;0;0
3079;376;45;99;31;1;30;.968;3600000;0
3079;1486;43;90;40;2;38;.950;3600000;0
3079;2198;45;0;0;0;0;.00nan;0;0
3079;3625;43;0;0;0;0;.00nan;0;0
3081;2163;39;0;0;0;0;.00nan;0;0
3081;7049;47;0;0;0;0;.00nan;0;0
3081;9238;39;72;35;3;32;.914;3600000;0
3081;33654;47;63;35;4;31;.886;3600000;0
3083;3626;48;44;26;4;22;.846;3600000;0
3083;4447;54;0;0;0;0;.00nan;0;0
3083;31643;54;50;33;5;28;.848;3542000;0
3083;38547;48;0;0;0;0;.00nan;0;0
3085;6081;56;97;38;2;36;.947;3900000;0
3085;26824;56;0;0;0;0;.00nan;0;0
3085;28772;53;0;0;0;0;.00nan;0;0
3085;31156;53;65;21;2;19;.905;3900000;0
3087;2900;36;0;0;0;0;.00nan;0;0
3087;4338;65;0;0;0;0;.00nan;0;0
3087;4987;65;100;26;0;26;1.000;3600000;0
3087;14874;36;47;32;5;27;.844;3600000;0
3089;2016;61;0;0;0;0;.00nan;0;0
3089;19640;41;0;0;0;0;.00nan;0;0
3089;23075;41;66;34;4;30;.882;3573000;0
3089;30971;61;51;21;3;18;.857;3600000;0
3091;3;50;0;0;0;0;.00nan;0;0
3091;5048;50;67;31;3;28;.903;3567000;0
3091;5137;58;0;0;0;0;.00nan;0;0
3091;14321;58;68;18;1;17;.944;3600000;0
3093;8046;57;0;0;0;0;.00nan;0;0
3093;26865;57;62;36;4;32;.889;3600000;0
3093;28845;64;72;17;1;16;.941;3600000;0
3093;32826;64;0;0;0;0;.00nan;0;0
3095;4716;4619;37;33;6;27;.818;3600000;0
3095;6572;62;77;29;1;28;.966;3600000;0
3095;26919;62;0;0;0;0;.00nan;0;0
3095;35210;4619;0;0;0;0;.00nan;0;0
3097;37;46;0;0;0;0;.00nan;0;0
3097;2152;49;0;0;0;0;.00nan;0;0
3097;2553;46;64;20;1;19;.950;3600000;0
3097;4435;49;37;33;6;27;.818;3600000;0
3099;1051;44;43;33;6;27;.818;2809000;0
3099;2796;59;0;0;0;0;.00nan;0;0
3099;3281;44;64;10;0;10;1.000;791000;0
3099;31858;59;80;29;2;27;.931;3600000;0
3101;780;52;0;0;0;0;.00nan;0;0
3101;23255;52;51;22;3;19;.864;3563000;0
3101;34788;42;84;32;2;30;.938;3600000;0
3101;37416;42;0;0;0;0;.00nan;0;0
3103;3847;38;0;0;0;0;.00nan;0;0
3103;5298;55;100;34;0;34;1.000;3600000;0
3103;31021;38;54;37;5;32;.865;3600000;0
3103;34770;55;0;0;0;0;.00nan;0;0
3105;4447;54;80;35;2;33;.943;3900000;0
3105;23255;52;0;0;0;0;.00nan;0;0
3105;31408;52;78;40;2;38;.950;3900000;0
3105;35595;54;0;0;0;0;.00nan;0;0
3107;3;50;73;22;1;21;.955;3600000;0
3107;5571;50;0;0;0;0;.00nan;0;0
3107;7049;47;83;34;3;31;.912;3514000;0
3107;33654;47;0;0;0;0;.00nan;0;0
3109;6572;62;0;0;0;0;.00nan;0;0
3109;14321;58;0;0;0;0;.00nan;0;0
3109;21469;58;68;21;2;19;.905;3600000;0
3109;26919;62;89;51;4;47;.922;3584000;0
3111;26967;63;80;39;3;36;.923;3600000;0
3111;31433;63;0;0;0;0;.00nan;0;0
3111;31858;59;64;37;4;33;.892;3543000;0
3111;34819;59;0;0;0;0;.00nan;0;0
3113;23075;41;57;34;4;30;.882;3600000;0
3113;28772;53;46;29;5;24;.828;3600000;0
3113;31156;53;0;0;0;0;.00nan;0;0
3113;51213;41;0;0;0;0;.00nan;0;0
3115;37;46;77;33;2;31;.939;3543000;0
3115;9238;39;0;0;0;0;.00nan;0;0
3115;26929;46;0;0;0;0;.00nan;0;0
3115;31126;39;88;17;0;17;1.000;3600000;0
3117;4435;49;0;0;0;0;.00nan;0;0
3117;34788;42;0;0;0;0;.00nan;0;0
3117;37416;42;72;31;2;29;.935;3600000;0
3117;38817;49;76;33;3;30;.909;3591000;0
3119;714;51;100;28;0;28;1.000;3600000;0
3119;31822;51;0;0;0;0;.00nan;0;0
3119;34815;45;0;0;0;0;.00nan;0;0
3119;36703;45;79;25;1;24;.960;3574000;0
3121;20717;60;0;0;0;0;.00nan;0;0
3121;28845;64;0;0;0;0;.00nan;0;0
3121;32826;64;65;26;3;23;.885;3600000;0
3121;35536;60;91;20;0;20;1.000;3600000;0
3123;3281;44;89;39;2;37;.949;3600000;0
3123;8046;57;99;32;1;31;.969;3600000;0
3123;26865;57;0;0;0;0;.00nan;0;0
3123;31545;44;0;0;0;0;.00nan;0;0
3125;5298;55;0;0;0;0;.00nan;0;0
3125;30971;61;0;0;0;0;.00nan;0;0
3125;34770;55;75;31;3;28;.903;3600000;0
3125;35538;61;55;33;5;28;.848;3553000;0
3127;3625;43;60;31;4;27;.871;3857000;0
3127;22970;38;0;0;0;0;.00nan;0;0
3127;31021;38;64;32;3;29;.906;3857000;0
3127;36324;43;0;0;0;0;.00nan;0;0
3129;4716;4619;0;0;0;0;.00nan;0;0
3129;7523;40;87;41;3;38;.927;3549000;0
3129;14351;40;0;0;0;0;.00nan;0;0
3129;35210;4619;51;16;2;14;.875;3600000;0
3131;5883;37;98;23;0;23;1.000;3600000;0
3131;6081;56;0;0;0;0;.00nan;0;0
3131;23043;37;0;0;0;0;.00nan;0;0
3131;26824;56;88;39;2;37;.949;3536000;0
3133;351;65;0;0;0;0;.00nan;0;0
3133;14874;36;77;28;2;26;.929;3600000;0
3133;26622;65;33;28;6;22;.786;3600000;0
3133;42825;36;0;0;0;0;.00nan;0;0
