Game Id;PlayerId;TeamId;Game Rating;SA;GA;SV;SV%;TOI;PIM
0;233;29;54;20;3;17;.850;3600000;0
0;2423;15;59;28;4;24;.857;3565000;0
0;4106;15;0;0;0;0;.00nan;0;0
0;18351;29;0;0;0;0;.00nan;0;0
1;500;4182;0;0;0;0;.00nan;0;0
1;1572;4838;0;0;0;0;.00nan;0;0
1;2328;4838;20;35;8;27;.771;3600000;0
1;25521;4182;100;27;0;27;1.000;3600000;0
2;1074;0;42;18;4;14;.778;1843000;0
2;1821;3;73;28;3;25;.893;3600000;0
2;2054;3;0;0;0;0;.00nan;0;0
2;31035;0;66;17;1;16;.941;1689000;0
3;18104;10;34;27;5;22;.815;3900000;0
3;27488;10;0;0;0;0;.00nan;0;0
3;27739;22;69;19;2;17;.895;3344000;0
3;28026;22;33;8;3;5;.625;556000;0
4;1614;25;0;0;0;0;.00nan;0;0
4;5182;25;81;37;3;34;.919;3600000;0
4;15505;8;62;38;4;34;.895;3558000;0
4;25076;8;0;0;0;0;.00nan;0;0
5;335;18;0;0;0;0;.00nan;0;0
5;823;23;0;0;0;0;.00nan;0;0
5;5001;18;56;31;3;28;.903;3600000;0
5;10274;23;87;37;2;35;.946;3600000;0
6;1074;0;0;0;0;0;.00nan;0;0
6;5385;17;0;0;0;0;.00nan;0;0
6;31035;0;74;42;4;38;.905;3900000;0
6;34006;17;68;32;4;28;.875;3900000;0
7;1821;3;0;0;0;0;.00nan;0;0
7;2054;3;96;32;2;30;.938;3600000;0
7;2058;28;75;38;3;35;.921;3549000;0
7;14061;28;0;0;0;0;.00nan;0;0
8;233;29;83;35;2;33;.943;3600000;0
8;323;9;0;0;0;0;.00nan;0;0
8;18351;29;0;0;0;0;.00nan;0;0
8;20853;9;77;37;3;34;.919;3555000;0
9;61;31;94;35;2;33;.943;3600000;0
9;2423;15;71;44;5;39;.886;3600000;0
9;4106;15;0;0;0;0;.00nan;0;0
9;34797;31;0;0;0;0;.00nan;0;0
10;445;12;41;30;6;24;.800;3600000;0
10;18104;10;0;0;0;0;.00nan;0;0
10;27488;10;60;23;2;21;.913;3600000;0
10;34786;12;0;0;0;0;.00nan;0;0
11;10103;24;64;30;3;27;.900;3900000;0
11;13979;24;0;0;0;0;.00nan;0;0
11;18078;20;0;0;0;0;.00nan;0;0
11;32146;20;75;34;3;31;.912;3900000;0
12;13842;34;67;24;2;22;.917;3600000;0
12;15502;34;0;0;0;0;.00nan;0;0
12;22601;26;22;20;5;15;.750;1071000;0
12;32754;26;32;35;6;29;.829;2529000;0
13;1572;4838;0;0;0;0;.00nan;0;0
13;2328;4838;50;43;6;37;.860;3600000;0
13;15464;32;79;36;2;34;.944;3600000;0
13;16006;32;0;0;0;0;.00nan;0;0
14;1913;30;0;0;0;0;.00nan;0;0
14;4506;33;53;23;4;19;.826;3534000;0
14;4826;30;71;31;2;29;.935;3600000;0
14;34740;33;0;0;0;0;.00nan;0;0
15;500;4182;0;0;0;0;.00nan;0;0
15;724;11;0;0;0;0;.00nan;0;0
15;21522;11;90;46;3;43;.935;3557000;0
15;25521;4182;79;22;1;21;.955;3600000;0
16;51;21;31;25;5;20;.800;3600000;0
16;15505;8;0;0;0;0;.00nan;0;0
16;25076;8;78;28;2;26;.929;3600000;0
16;25843;21;0;0;0;0;.00nan;0;0
17;335;18;0;0;0;0;.00nan;0;0
17;1251;14;0;0;0;0;.00nan;0;0
17;5001;18;54;38;5;33;.868;3528000;0
17;25584;14;62;30;3;27;.900;3600000;0
18;262;35;0;0;0;0;.00nan;0;0
18;1430;35;69;26;2;24;.923;3600000;0
18;1913;30;60;30;3;27;.900;3586000;0
18;4826;30;0;0;0;0;.00nan;0;0
19;445;12;61;39;5;34;.872;3736000;0
19;4450;5;44;27;6;21;.778;3736000;0
19;19823;5;0;0;0;0;.00nan;0;0
19;34786;12;0;0;0;0;.00nan;0;0
20;5385;17;52;36;5;31;.861;3592000;0
20;22601;26;0;0;0;0;.00nan;0;0
20;32754;26;51;25;3;22;.880;3600000;0
20;34006;17;0;0;0;0;.00nan;0;0
21;1821;3;63;27;3;24;.889;3600000;0
21;2054;3;0;0;0;0;.00nan;0;0
21;2058;28;64;46;5;41;.891;3544000;0
21;14061;28;0;0;0;0;.00nan;0;0
22;1074;0;48;37;5;32;.865;3550000;0
22;18104;10;0;0;0;0;.00nan;0;0
22;27488;10;82;34;3;31;.912;3600000;0
22;31035;0;0;0;0;0;.00nan;0;0
23;323;9;90;46;3;43;.935;3600000;0
23;335;18;85;16;0;16;1.000;3600000;0
23;5001;18;0;0;0;0;.00nan;0;0
23;20853;9;0;0;0;0;.00nan;0;0
24;61;31;41;27;5;22;.815;3600000;0
24;18078;20;100;27;0;27;1.000;3600000;0
24;32146;20;0;0;0;0;.00nan;0;0
24;34797;31;0;0;0;0;.00nan;0;0
25;2423;15;0;0;0;0;.00nan;0;0
25;4106;15;86;32;2;30;.938;3600000;0
25;15505;8;29;29;6;23;.793;3600000;0
25;25076;8;0;0;0;0;.00nan;0;0
26;233;29;0;0;0;0;.00nan;0;0
26;18351;29;69;29;3;26;.897;3600000;0
26;27739;22;91;40;1;39;.975;3600000;0
26;28026;22;0;0;0;0;.00nan;0;0
27;1572;4838;89;39;2;37;.949;3900000;0
27;2328;4838;0;0;0;0;.00nan;0;0
27;13842;34;85;29;2;27;.931;3900000;0
27;15502;34;0;0;0;0;.00nan;0;0
28;10103;24;0;0;0;0;.00nan;0;0
28;13979;24;50;24;3;21;.875;3600000;0
28;15464;32;0;0;0;0;.00nan;0;0
28;16006;32;100;35;0;35;1.000;3600000;0
29;1614;25;0;0;0;0;.00nan;0;0
29;1796;16;0;0;0;0;.00nan;0;0
29;5182;25;91;52;3;49;.942;3582000;0
29;15437;16;74;26;2;24;.923;3600000;0
30;544;19;0;0;0;0;.00nan;0;0
30;823;23;100;27;0;27;1.000;3600000;0
30;10274;23;0;0;0;0;.00nan;0;0
30;31124;19;82;39;2;37;.949;3575000;0
31;262;35;74;37;3;34;.919;3513000;0
31;724;11;0;0;0;0;.00nan;0;0
31;1430;35;0;0;0;0;.00nan;0;0
31;21522;11;82;30;1;29;.967;3600000;0
32;738;27;0;0;0;0;.00nan;0;0
32;4506;33;84;26;1;25;.962;3600000;0
32;26623;27;70;33;3;30;.909;3555000;0
32;34740;33;0;0;0;0;.00nan;0;0
33;445;12;0;0;0;0;.00nan;0;0
33;2058;28;0;0;0;0;.00nan;0;0
33;14061;28;38;28;5;23;.821;3600000;0
33;34786;12;82;33;2;31;.939;3600000;0
34;1821;3;56;34;4;30;.882;3557000;0
34;2054;3;0;0;0;0;.00nan;0;0
34;18104;10;0;0;0;0;.00nan;0;0
34;27488;10;83;35;3;32;.914;3600000;0
35;1251;14;99;16;0;16;1.000;3600000;0
35;1572;4838;94;49;4;45;.918;3600000;0
35;2328;4838;0;0;0;0;.00nan;0;0
35;25584;14;0;0;0;0;.00nan;0;0
36;544;19;44;17;3;14;.824;3600000;0
36;1913;30;0;0;0;0;.00nan;0;0
36;4826;30;67;52;5;47;.904;3600000;0
36;31124;19;0;0;0;0;.00nan;0;0
37;1796;16;72;20;1;19;.950;3600000;0
37;15437;16;0;0;0;0;.00nan;0;0
37;22601;26;60;26;3;23;.885;3600000;0
37;32754;26;0;0;0;0;.00nan;0;0
38;335;18;48;25;4;21;.840;3600000;0
38;5001;18;0;0;0;0;.00nan;0;0
38;5385;17;59;42;5;37;.881;3573000;0
38;34006;17;0;0;0;0;.00nan;0;0
39;738;27;51;2;0;2;1.000;802000;0
39;1074;0;100;22;0;22;1.000;3600000;0
39;26623;27;42;34;6;28;.824;2798000;0
39;31035;0;0;0;0;0;.00nan;0;0
40;323;9;0;0;0;0;.00nan;0;0
40;13842;34;0;0;0;0;.00nan;0;0
40;15502;34;68;31;4;27;.871;3811000;0
40;20853;9;68;31;3;28;.903;3811000;0
41;61;31;83;31;2;29;.935;3600000;0
41;233;29;0;0;0;0;.00nan;0;0
41;18351;29;55;21;3;18;.857;3574000;0
41;34797;31;0;0;0;0;.00nan;0;0
42;51;21;0;0;0;0;.00nan;0;0
42;1572;4838;0;0;0;0;.00nan;0;0
42;2328;4838;97;43;2;41;.953;3593000;0
42;25843;21;100;29;0;29;1.000;3600000;0
43;445;12;81;27;1;26;.963;3600000;0
43;2423;15;0;0;0;0;.00nan;0;0
43;4106;15;80;40;3;37;.925;3554000;0
43;34786;12;0;0;0;0;.00nan;0;0
44;1614;25;57;35;4;31;.886;3600000;0
44;5182;25;0;0;0;0;.00nan;0;0
44;27739;22;0;0;0;0;.00nan;0;0
44;28026;22;45;33;5;28;.848;3556000;0
45;15505;8;0;0;0;0;.00nan;0;0
45;18078;20;61;27;3;24;.889;3560000;0
45;25076;8;90;34;1;33;.971;3600000;0
45;32146;20;0;0;0;0;.00nan;0;0
46;724;11;0;0;0;0;.00nan;0;0
46;15464;32;0;0;0;0;.00nan;0;0
46;16006;32;70;39;4;35;.897;3600000;0
46;21522;11;53;31;5;26;.839;3548000;0
47;262;35;26;15;4;11;.733;1204000;0
47;1430;35;55;27;4;23;.852;2396000;0
47;4506;33;63;33;4;29;.879;3600000;0
47;34740;33;0;0;0;0;.00nan;0;0
48;823;23;66;31;4;27;.871;3600000;0
48;1913;30;57;38;5;33;.868;3600000;0
48;4826;30;0;0;0;0;.00nan;0;0
48;10274;23;0;0;0;0;.00nan;0;0
49;1251;14;69;23;2;21;.913;3600000;0
49;4450;5;0;0;0;0;.00nan;0;0
49;19823;5;100;26;0;26;1.000;3600000;0
49;25584;14;0;0;0;0;.00nan;0;0
50;500;4182;76;22;1;21;.955;2405000;0
50;1796;16;68;25;2;23;.920;3600000;0
50;15437;16;0;0;0;0;.00nan;0;0
50;25521;4182;35;17;4;13;.765;1195000;0
51;1074;0;93;42;3;39;.929;3529000;0
51;10103;24;0;0;0;0;.00nan;0;0
51;13979;24;76;24;1;23;.958;3600000;0
51;31035;0;0;0;0;0;.00nan;0;0
52;738;27;24;6;3;3;.500;468000;0
52;2058;28;87;34;2;32;.941;3600000;0
52;14061;28;0;0;0;0;.00nan;0;0
52;26623;27;39;34;6;28;.824;3132000;0
53;323;9;0;0;0;0;.00nan;0;0
53;544;19;0;0;0;0;.00nan;0;0
53;20853;9;76;37;3;34;.919;3673000;0
53;31124;19;50;28;4;24;.857;3673000;0
54;61;31;0;0;0;0;.00nan;0;0
54;1614;25;55;26;3;23;.885;3900000;0
54;5182;25;0;0;0;0;.00nan;0;0
54;34797;31;79;37;3;34;.919;3900000;0
55;51;21;0;0;0;0;.00nan;0;0
55;25843;21;77;22;1;21;.955;3600000;0
55;27739;22;91;37;2;35;.946;3573000;0
55;28026;22;0;0;0;0;.00nan;0;0
56;13842;34;86;29;1;28;.966;3600000;0
56;15502;34;0;0;0;0;.00nan;0;0
56;18078;20;79;41;3;38;.927;3511000;0
56;32146;20;0;0;0;0;.00nan;0;0
57;335;18;0;0;0;0;.00nan;0;0
57;5001;18;92;43;2;41;.953;3600000;0
57;15505;8;59;30;4;26;.867;3600000;0
57;25076;8;0;0;0;0;.00nan;0;0
58;15464;32;0;0;0;0;.00nan;0;0
58;16006;32;75;27;2;25;.926;3600000;0
58;18104;10;0;0;0;0;.00nan;0;0
58;27488;10;44;36;6;30;.833;3600000;0
59;1913;30;0;0;0;0;.00nan;0;0
59;4506;33;57;21;2;19;.905;3600000;0
59;4826;30;25;41;8;33;.805;3600000;0
59;34740;33;0;0;0;0;.00nan;0;0
60;823;23;54;34;5;29;.853;3600000;0
60;10274;23;0;0;0;0;.00nan;0;0
60;22601;26;74;31;2;29;.935;3600000;0
60;32754;26;0;0;0;0;.00nan;0;0
61;4450;5;0;0;0;0;.00nan;0;0
61;5385;17;0;0;0;0;.00nan;0;0
61;19823;5;87;38;3;35;.921;3600000;0
61;34006;17;47;35;6;29;.829;3600000;0
62;738;27;76;33;3;30;.909;3600000;0
62;1821;3;51;42;6;36;.857;3600000;0
62;2054;3;0;0;0;0;.00nan;0;0
62;26623;27;0;0;0;0;.00nan;0;0
63;445;12;92;36;1;35;.972;3600000;0
63;724;11;0;0;0;0;.00nan;0;0
63;21522;11;82;36;2;34;.944;3544000;0
63;34786;12;0;0;0;0;.00nan;0;0
64;500;4182;0;0;0;0;.00nan;0;0
64;823;23;0;0;0;0;.00nan;0;0
64;10274;23;92;39;2;37;.949;3900000;0
64;25521;4182;85;32;2;30;.938;3900000;0
65;323;9;0;0;0;0;.00nan;0;0
65;1074;0;72;28;2;26;.929;3600000;0
65;20853;9;62;22;3;19;.864;3556000;0
65;31035;0;0;0;0;0;.00nan;0;0
66;2058;28;77;24;1;23;.958;3900000;0
66;14061;28;0;0;0;0;.00nan;0;0
66;18104;10;93;32;1;31;.969;3900000;0
66;27488;10;0;0;0;0;.00nan;0;0
67;233;29;76;27;2;25;.926;3571000;0
67;1614;25;98;39;1;38;.974;3600000;0
67;5182;25;0;0;0;0;.00nan;0;0
67;18351;29;0;0;0;0;.00nan;0;0
68;51;21;89;38;3;35;.921;3587000;0
68;5385;17;83;33;2;31;.939;3600000;0
68;25843;21;0;0;0;0;.00nan;0;0
68;34006;17;0;0;0;0;.00nan;0;0
69;61;31;72;39;3;36;.923;3600000;0
69;1251;14;59;30;4;26;.867;3588000;0
69;25584;14;0;0;0;0;.00nan;0;0
69;34797;31;0;0;0;0;.00nan;0;0
70;1821;3;0;0;0;0;.00nan;0;0
70;2054;3;50;21;3;18;.857;3600000;0
70;2423;15;68;42;5;37;.881;3582000;0
70;4106;15;0;0;0;0;.00nan;0;0
71;544;19;77;55;5;50;.909;3600000;0
71;27739;22;0;0;0;0;.00nan;0;0
71;28026;22;46;21;3;18;.857;3600000;0
71;31124;19;0;0;0;0;.00nan;0;0
72;10103;24;0;0;0;0;.00nan;0;0
72;13842;34;92;32;1;31;.969;3600000;0
72;13979;24;69;35;4;31;.886;3600000;0
72;15502;34;0;0;0;0;.00nan;0;0
73;724;11;72;43;4;39;.907;3581000;0
73;1796;16;64;17;2;15;.882;3600000;0
73;15437;16;0;0;0;0;.00nan;0;0
73;21522;11;0;0;0;0;.00nan;0;0
74;262;35;0;0;0;0;.00nan;0;0
74;1430;35;81;24;1;23;.958;3600000;0
74;1913;30;81;32;2;30;.938;3548000;0
74;4826;30;0;0;0;0;.00nan;0;0
75;4506;33;73;25;1;24;.960;3587000;0
75;15464;32;0;0;0;0;.00nan;0;0
75;16006;32;100;30;0;30;1.000;3600000;0
75;34740;33;0;0;0;0;.00nan;0;0
76;18078;20;0;0;0;0;.00nan;0;0
76;22601;26;0;0;0;0;.00nan;0;0
76;32146;20;60;23;2;21;.913;3580000;0
76;32754;26;100;37;0;37;1.000;3600000;0
77;335;18;66;29;2;27;.931;2984000;0
77;1572;4838;0;0;0;0;.00nan;0;0
77;2328;4838;67;35;4;31;.886;3600000;0
77;5001;18;30;9;3;6;.667;572000;0
78;738;27;36;37;6;31;.838;3600000;0
78;4450;5;0;0;0;0;.00nan;0;0
78;19823;5;74;22;2;20;.909;3600000;0
78;26623;27;0;0;0;0;.00nan;0;0
79;323;9;90;45;1;44;.978;3563000;0
79;15505;8;0;0;0;0;.00nan;0;0
79;20853;9;0;0;0;0;.00nan;0;0
79;25076;8;97;24;0;24;1.000;3600000;0
80;262;35;99;38;2;36;.947;3600000;0
80;1430;35;0;0;0;0;.00nan;0;0
80;15464;32;0;0;0;0;.00nan;0;0
80;16006;32;77;42;3;39;.929;3544000;0
81;500;4182;0;0;0;0;.00nan;0;0
81;18078;20;80;23;1;22;.957;3600000;0
81;25521;4182;65;44;5;39;.886;3600000;0
81;32146;20;0;0;0;0;.00nan;0;0
82;233;29;91;21;0;21;1.000;3600000;0
82;5385;17;0;0;0;0;.00nan;0;0
82;18351;29;0;0;0;0;.00nan;0;0
82;34006;17;79;27;2;25;.926;3521000;0
83;2058;28;0;0;0;0;.00nan;0;0
83;14061;28;96;41;1;40;.976;3600000;0
83;27739;22;85;42;3;39;.929;3518000;0
83;28026;22;0;0;0;0;.00nan;0;0
84;61;31;0;0;0;0;.00nan;0;0
84;22601;26;76;33;2;31;.939;3900000;0
84;32754;26;0;0;0;0;.00nan;0;0
84;34797;31;61;24;2;22;.917;3900000;0
85;544;19;65;34;4;30;.882;3565000;0
85;18104;10;0;0;0;0;.00nan;0;0
85;27488;10;97;46;2;44;.957;3600000;0
85;31124;19;0;0;0;0;.00nan;0;0
86;1821;3;70;26;2;24;.923;3600000;0
86;2054;3;0;0;0;0;.00nan;0;0
86;10103;24;77;35;3;32;.914;3551000;0
86;13979;24;0;0;0;0;.00nan;0;0
87;445;12;91;33;1;32;.970;3600000;0
87;13842;34;67;22;2;20;.909;3600000;0
87;15502;34;0;0;0;0;.00nan;0;0
87;34786;12;0;0;0;0;.00nan;0;0
88;724;11;75;28;2;26;.929;3600000;0
88;1796;16;52;19;3;16;.842;3590000;0
88;15437;16;0;0;0;0;.00nan;0;0
88;21522;11;0;0;0;0;.00nan;0;0
89;51;21;0;0;0;0;.00nan;0;0
89;544;19;0;0;0;0;.00nan;0;0
89;25843;21;60;20;3;17;.850;3543000;0
89;31124;19;77;27;2;25;.926;3600000;0
90;233;29;46;21;3;18;.857;3549000;0
90;2423;15;0;0;0;0;.00nan;0;0
90;4106;15;91;42;2;40;.952;3600000;0
90;18351;29;0;0;0;0;.00nan;0;0
91;738;27;0;0;0;0;.00nan;0;0
91;15464;32;0;0;0;0;.00nan;0;0
91;16006;32;93;27;2;25;.926;3600000;0
91;26623;27;79;53;5;48;.906;3600000;0
92;500;4182;0;0;0;0;.00nan;0;0
92;1614;25;59;28;4;24;.857;3900000;0
92;5182;25;0;0;0;0;.00nan;0;0
92;25521;4182;68;41;4;37;.902;3900000;0
93;262;35;75;27;2;25;.926;3527000;0
93;335;18;97;22;0;22;1.000;3600000;0
93;1430;35;0;0;0;0;.00nan;0;0
93;5001;18;0;0;0;0;.00nan;0;0
94;1913;30;0;0;0;0;.00nan;0;0
94;4506;33;72;17;1;16;.941;3600000;0
94;4826;30;97;53;2;51;.962;3547000;0
94;34740;33;0;0;0;0;.00nan;0;0
95;1074;0;76;34;2;32;.941;3600000;0
95;1572;4838;0;0;0;0;.00nan;0;0
95;2328;4838;69;35;4;31;.886;3600000;0
95;31035;0;0;0;0;0;.00nan;0;0
96;61;31;87;33;2;31;.939;3600000;0
96;4450;5;0;0;0;0;.00nan;0;0
96;19823;5;55;24;3;21;.875;3552000;0
96;34797;31;0;0;0;0;.00nan;0;0
97;323;9;0;0;0;0;.00nan;0;0
97;20853;9;64;35;4;31;.886;3600000;0
97;27739;22;0;0;0;0;.00nan;0;0
97;28026;22;94;24;0;24;1.000;3600000;0
98;1821;3;100;29;0;29;1.000;3600000;0
98;2054;3;0;0;0;0;.00nan;0;0
98;15505;8;0;0;0;0;.00nan;0;0
98;25076;8;87;39;3;36;.923;3600000;0
99;445;12;0;0;0;0;.00nan;0;0
99;500;4182;0;0;0;0;.00nan;0;0
99;25521;4182;52;27;4;23;.852;3807000;0
99;34786;12;80;40;3;37;.925;3807000;0
100;823;23;0;0;0;0;.00nan;0;0
100;1251;14;0;0;0;0;.00nan;0;0
100;10274;23;77;30;2;28;.933;3600000;0
100;25584;14;55;41;5;36;.878;3600000;0
101;233;29;0;0;0;0;.00nan;0;0
101;18351;29;86;33;3;30;.909;3549000;0
101;22601;26;0;0;0;0;.00nan;0;0
101;32754;26;94;36;2;34;.944;3600000;0
102;544;19;71;25;2;23;.920;3600000;0
102;2423;15;71;33;3;30;.909;3568000;0
102;4106;15;0;0;0;0;.00nan;0;0
102;31124;19;0;0;0;0;.00nan;0;0
103;4450;5;24;13;4;9;.692;1082000;0
103;10103;24;0;0;0;0;.00nan;0;0
103;13979;24;83;30;1;29;.967;3600000;0
103;19823;5;65;25;2;23;.920;2518000;0
104;1614;25;51;28;4;24;.857;3105000;0
104;1796;16;0;0;0;0;.00nan;0;0
104;5182;25;41;3;1;2;.667;447000;0
104;15437;16;59;20;2;18;.900;3600000;0
105;335;18;88;31;1;30;.968;3600000;0
105;1251;14;59;20;2;18;.900;3554000;0
105;5001;18;0;0;0;0;.00nan;0;0
105;25584;14;0;0;0;0;.00nan;0;0
106;1913;30;0;0;0;0;.00nan;0;0
106;4826;30;51;24;3;21;.875;3600000;0
106;5385;17;25;23;6;17;.739;2967000;0
106;34006;17;51;8;1;7;.875;633000;0
107;724;11;84;25;2;23;.920;3600000;0
107;4506;33;57;43;6;37;.860;3235000;0
107;21522;11;0;0;0;0;.00nan;0;0
107;34740;33;53;2;0;2;1.000;365000;0
108;738;27;0;0;0;0;.00nan;0;0
108;1074;0;100;41;0;41;1.000;3600000;0
108;26623;27;66;23;2;21;.913;3524000;0
108;31035;0;0;0;0;0;.00nan;0;0
109;262;35;86;33;2;31;.939;3600000;0
109;1430;35;0;0;0;0;.00nan;0;0
109;1572;4838;0;0;0;0;.00nan;0;0
109;2328;4838;62;30;3;27;.900;3563000;0
110;61;31;0;0;0;0;.00nan;0;0
110;323;9;74;35;3;32;.914;3857000;0
110;20853;9;0;0;0;0;.00nan;0;0
110;34797;31;83;28;2;26;.929;3857000;0
111;13842;34;87;46;4;42;.913;3600000;0
111;15502;34;0;0;0;0;.00nan;0;0
111;18104;10;0;0;0;0;.00nan;0;0
111;27488;10;68;25;2;23;.920;3600000;0
112;22601;26;85;35;2;33;.943;3600000;0
112;27739;22;0;0;0;0;.00nan;0;0
112;28026;22;75;32;3;29;.906;3548000;0
112;32754;26;0;0;0;0;.00nan;0;0
113;10103;24;35;18;4;14;.778;3600000;0
113;13979;24;0;0;0;0;.00nan;0;0
113;15505;8;0;0;0;0;.00nan;0;0
113;25076;8;29;30;6;24;.800;3515000;0
114;445;12;99;42;2;40;.952;3900000;0
114;2058;28;0;0;0;0;.00nan;0;0
114;14061;28;81;31;2;29;.935;3900000;0
114;34786;12;0;0;0;0;.00nan;0;0
115;500;4182;0;0;0;0;.00nan;0;0
115;1913;30;55;40;5;35;.875;3585000;0
115;4826;30;0;0;0;0;.00nan;0;0
115;25521;4182;65;28;3;25;.893;3600000;0
116;61;31;39;29;5;24;.828;3600000;0
116;4450;5;0;0;0;0;.00nan;0;0
116;19823;5;97;23;0;23;1.000;3600000;0
116;34797;31;0;0;0;0;.00nan;0;0
117;323;9;0;0;0;0;.00nan;0;0
117;1821;3;44;23;4;19;.826;3600000;0
117;2054;3;0;0;0;0;.00nan;0;0
117;20853;9;85;58;6;52;.897;3600000;0
118;51;21;0;0;0;0;.00nan;0;0
118;2423;15;59;29;3;26;.897;3600000;0
118;4106;15;0;0;0;0;.00nan;0;0
118;25843;21;54;35;4;31;.886;3600000;0
119;1796;16;58;17;2;15;.882;3600000;0
119;15437;16;0;0;0;0;.00nan;0;0
119;15505;8;63;48;5;43;.896;3600000;0
119;25076;8;0;0;0;0;.00nan;0;0
120;15464;32;0;0;0;0;.00nan;0;0
120;16006;32;94;33;1;32;.970;3600000;0
120;18078;20;0;0;0;0;.00nan;0;0
120;32146;20;53;18;2;16;.889;3600000;0
121;262;35;51;33;4;29;.879;3600000;0
121;1430;35;0;0;0;0;.00nan;0;0
121;1614;25;96;37;1;36;.973;3600000;0
121;5182;25;0;0;0;0;.00nan;0;0
122;544;19;0;0;0;0;.00nan;0;0
122;1251;14;81;42;3;39;.929;3900000;0
122;25584;14;0;0;0;0;.00nan;0;0
122;31124;19;49;19;3;16;.842;3900000;0
123;335;18;62;34;5;29;.853;3533000;0
123;823;23;64;26;3;23;.885;3600000;0
123;5001;18;0;0;0;0;.00nan;0;0
123;10274;23;0;0;0;0;.00nan;0;0
124;724;11;0;0;0;0;.00nan;0;0
124;1074;0;50;34;5;29;.853;3574000;0
124;21522;11;48;18;3;15;.833;3600000;0
124;31035;0;0;0;0;0;.00nan;0;0
125;738;27;0;0;0;0;.00nan;0;0
125;4506;33;25;6;3;3;.500;204000;0
125;26623;27;100;37;1;36;.973;3600000;0
125;34740;33;73;22;1;21;.955;3396000;0
126;51;21;57;26;3;23;.885;3600000;0
126;13842;34;0;0;0;0;.00nan;0;0
126;15502;34;100;30;0;30;1.000;3600000;0
126;25843;21;0;0;0;0;.00nan;0;0
127;10103;24;0;0;0;0;.00nan;0;0
127;13979;24;74;25;2;23;.920;3600000;0
127;22601;26;0;0;0;0;.00nan;0;0
127;32754;26;55;26;3;23;.885;3576000;0
128;1074;0;0;0;0;0;.00nan;0;0
128;1913;30;0;0;0;0;.00nan;0;0
128;4826;30;48;27;4;23;.852;3600000;0
128;31035;0;59;39;5;34;.872;3600000;0
129;724;11;82;34;3;31;.912;3889000;0
129;5385;17;80;46;4;42;.913;3889000;0
129;21522;11;0;0;0;0;.00nan;0;0
129;34006;17;0;0;0;0;.00nan;0;0
130;1572;4838;0;0;0;0;.00nan;0;0
130;2328;4838;71;47;5;42;.894;3564000;0
130;18104;10;0;0;0;0;.00nan;0;0
130;27488;10;47;24;4;20;.833;3600000;0
131;233;29;0;0;0;0;.00nan;0;0
131;18351;29;84;33;2;31;.939;3900000;0
131;27739;22;0;0;0;0;.00nan;0;0
131;28026;22;81;29;2;27;.931;3900000;0
132;2058;28;67;27;3;24;.889;3600000;0
132;14061;28;0;0;0;0;.00nan;0;0
132;15505;8;0;0;0;0;.00nan;0;0
132;25076;8;63;39;4;35;.897;3600000;0
133;823;23;58;24;3;21;.875;3600000;0
133;1572;4838;75;30;2;28;.933;3600000;0
133;2328;4838;0;0;0;0;.00nan;0;0
133;10274;23;0;0;0;0;.00nan;0;0
134;500;4182;59;32;4;28;.875;3600000;0
134;1821;3;49;22;4;18;.818;791000;0
134;2054;3;93;30;1;29;.967;2809000;0
134;25521;4182;0;0;0;0;.00nan;0;0
135;323;9;64;28;3;25;.893;3593000;0
135;1074;0;84;31;2;29;.935;3600000;0
135;20853;9;0;0;0;0;.00nan;0;0
135;31035;0;0;0;0;0;.00nan;0;0
136;1251;14;51;22;3;19;.864;3600000;0
136;22601;26;0;0;0;0;.00nan;0;0
136;25584;14;0;0;0;0;.00nan;0;0
136;32754;26;51;39;5;34;.872;3521000;0
137;262;35;0;0;0;0;.00nan;0;0
137;1430;35;81;30;2;28;.933;3600000;0
137;2058;28;0;0;0;0;.00nan;0;0
137;14061;28;58;24;3;21;.875;3572000;0
138;445;12;97;38;2;36;.947;3600000;0
138;4506;33;0;0;0;0;.00nan;0;0
138;34740;33;64;28;3;25;.893;3553000;0
138;34786;12;0;0;0;0;.00nan;0;0
139;544;19;0;0;0;0;.00nan;0;0
139;15464;32;0;0;0;0;.00nan;0;0
139;16006;32;70;34;3;31;.912;3600000;0
139;31124;19;69;18;1;17;.944;3600000;0
140;335;18;81;31;2;29;.935;3600000;0
140;5001;18;0;0;0;0;.00nan;0;0
140;18104;10;57;24;3;21;.875;3590000;0
140;27488;10;0;0;0;0;.00nan;0;0
141;51;21;0;0;0;0;.00nan;0;0
141;1913;30;0;0;0;0;.00nan;0;0
141;4826;30;94;41;2;39;.951;3567000;0
141;25843;21;100;26;0;26;1.000;3600000;0
142;738;27;0;0;0;0;.00nan;0;0
142;5385;17;100;28;0;28;1.000;3600000;0
142;26623;27;88;35;3;32;.914;3600000;0
142;34006;17;0;0;0;0;.00nan;0;0
143;10103;24;0;0;0;0;.00nan;0;0
143;13979;24;73;26;2;24;.923;3600000;0
143;15505;8;60;45;5;40;.889;3600000;0
143;25076;8;0;0;0;0;.00nan;0;0
144;1614;25;0;0;0;0;.00nan;0;0
144;5182;25;76;31;3;28;.903;3900000;0
144;13842;34;0;0;0;0;.00nan;0;0
144;15502;34;97;52;3;49;.942;3900000;0
145;823;23;96;34;1;33;.971;3591000;0
145;10274;23;0;0;0;0;.00nan;0;0
145;15464;32;100;31;0;31;1.000;3600000;0
145;16006;32;0;0;0;0;.00nan;0;0
146;724;11;100;29;1;28;.966;3600000;0
146;1796;16;63;30;3;27;.900;3581000;0
146;15437;16;0;0;0;0;.00nan;0;0
146;21522;11;0;0;0;0;.00nan;0;0
147;323;9;85;27;1;26;.963;3600000;0
147;4450;5;0;0;0;0;.00nan;0;0
147;19823;5;29;23;5;18;.783;3600000;0
147;20853;9;0;0;0;0;.00nan;0;0
148;233;29;77;26;1;25;.962;3600000;0
148;1821;3;93;46;3;43;.935;3524000;0
148;2054;3;0;0;0;0;.00nan;0;0
148;18351;29;0;0;0;0;.00nan;0;0
149;928;20;63;14;1;13;.929;3600000;0
149;1074;0;94;45;2;43;.956;3597000;0
149;18078;20;0;0;0;0;.00nan;0;0
149;31035;0;0;0;0;0;.00nan;0;0
150;500;4182;0;0;0;0;.00nan;0;0
150;2058;28;60;33;4;29;.879;3523000;0
150;14061;28;0;0;0;0;.00nan;0;0
150;25521;4182;63;29;3;26;.897;3600000;0
151;61;31;0;0;0;0;.00nan;0;0
151;27739;22;0;0;0;0;.00nan;0;0
151;28026;22;36;28;5;23;.821;3600000;0
151;34797;31;80;25;1;24;.960;3600000;0
152;1251;14;0;0;0;0;.00nan;0;0
152;2423;15;70;21;1;20;.952;3600000;0
152;4106;15;0;0;0;0;.00nan;0;0
152;25584;14;89;44;4;40;.909;3600000;0
153;445;12;0;0;0;0;.00nan;0;0
153;544;19;82;33;2;31;.939;3600000;0
153;31124;19;0;0;0;0;.00nan;0;0
153;34786;12;43;31;6;25;.806;3600000;0
154;738;27;81;42;4;38;.905;3569000;0
154;1796;16;0;0;0;0;.00nan;0;0
154;15437;16;69;23;2;21;.913;3600000;0
154;26623;27;0;0;0;0;.00nan;0;0
155;1572;4838;77;34;3;31;.912;3547000;0
155;2328;4838;0;0;0;0;.00nan;0;0
155;5385;17;84;33;2;31;.939;3600000;0
155;34006;17;0;0;0;0;.00nan;0;0
156;4506;33;63;26;3;23;.885;3600000;0
156;15505;8;55;38;5;33;.868;3564000;0
156;25076;8;0;0;0;0;.00nan;0;0
156;34740;33;0;0;0;0;.00nan;0;0
157;823;23;0;0;0;0;.00nan;0;0
157;10274;23;75;29;2;27;.931;3600000;0
157;18104;10;55;28;3;25;.893;3590000;0
157;27488;10;0;0;0;0;.00nan;0;0
158;335;18;66;25;2;23;.920;3600000;0
158;5001;18;0;0;0;0;.00nan;0;0
158;15464;32;38;22;4;18;.818;3559000;0
158;16006;32;0;0;0;0;.00nan;0;0
159;1913;30;0;0;0;0;.00nan;0;0
159;4826;30;49;30;4;26;.867;3563000;0
159;22601;26;0;0;0;0;.00nan;0;0
159;32754;26;72;36;3;33;.917;3600000;0
160;51;21;0;0;0;0;.00nan;0;0
160;724;11;90;38;2;36;.947;3543000;0
160;21522;11;0;0;0;0;.00nan;0;0
160;25843;21;92;25;1;24;.960;3600000;0
161;323;9;75;46;5;41;.891;3600000;0
161;5385;17;0;0;0;0;.00nan;0;0
161;20853;9;0;0;0;0;.00nan;0;0
161;34006;17;85;29;1;28;.966;3600000;0
162;1821;3;95;52;3;49;.942;3579000;0
162;2054;3;0;0;0;0;.00nan;0;0
162;4450;5;0;0;0;0;.00nan;0;0
162;19823;5;85;37;2;35;.946;3600000;0
163;500;4182;75;15;1;14;.933;3600000;0
163;1074;0;98;63;3;60;.952;3532000;0
163;25521;4182;0;0;0;0;.00nan;0;0
163;31035;0;0;0;0;0;.00nan;0;0
164;233;29;100;24;0;24;1.000;3600000;0
164;2058;28;36;29;6;23;.793;2565000;0
164;14061;28;71;17;0;17;1.000;1035000;0
164;18351;29;0;0;0;0;.00nan;0;0
165;61;31;89;38;2;36;.947;3600000;0
165;10103;24;0;0;0;0;.00nan;0;0
165;13979;24;77;31;4;27;.871;3536000;0
165;34797;31;0;0;0;0;.00nan;0;0
166;262;35;0;0;0;0;.00nan;0;0
166;1430;35;49;27;4;23;.852;3600000;0
166;2423;15;47;36;5;31;.861;3548000;0
166;4106;15;0;0;0;0;.00nan;0;0
167;1251;14;0;0;0;0;.00nan;0;0
167;25584;14;50;28;4;24;.857;3600000;0
167;27739;22;0;0;0;0;.00nan;0;0
167;28026;22;65;38;5;33;.868;3600000;0
168;1614;25;77;26;2;24;.923;3600000;0
168;5182;25;0;0;0;0;.00nan;0;0
168;13842;34;98;48;3;45;.938;3600000;0
168;15502;34;0;0;0;0;.00nan;0;0
169;928;20;0;0;0;0;.00nan;0;0
169;4506;33;0;0;0;0;.00nan;0;0
169;18078;20;97;45;2;43;.956;3559000;0
169;34740;33;65;14;1;13;.929;3600000;0
170;544;19;69;32;2;30;.938;3900000;0
170;18104;10;0;0;0;0;.00nan;0;0
170;27488;10;100;62;2;60;.968;3900000;0
170;31124;19;0;0;0;0;.00nan;0;0
171;1572;4838;82;24;1;23;.958;3600000;0
171;2328;4838;0;0;0;0;.00nan;0;0
171;22601;26;64;40;5;35;.875;3600000;0
171;32754;26;0;0;0;0;.00nan;0;0
172;51;21;60;39;5;34;.872;3600000;0
172;738;27;74;27;2;25;.926;3600000;0
172;25843;21;0;0;0;0;.00nan;0;0
172;26623;27;0;0;0;0;.00nan;0;0
173;323;9;0;0;0;0;.00nan;0;0
173;500;4182;0;0;0;0;.00nan;0;0
173;20853;9;100;44;2;42;.955;3900000;0
173;25521;4182;67;19;2;17;.895;3900000;0
174;15464;32;86;39;3;36;.923;3900000;0
174;15505;8;0;0;0;0;.00nan;0;0
174;16006;32;0;0;0;0;.00nan;0;0
174;25076;8;72;37;3;34;.919;3900000;0
175;262;35;58;38;5;33;.868;3571000;0
175;928;20;46;22;4;18;.818;3600000;0
175;1430;35;0;0;0;0;.00nan;0;0
175;18078;20;0;0;0;0;.00nan;0;0
176;335;18;75;32;2;30;.938;3600000;0
176;445;12;71;40;5;35;.875;3600000;0
176;5001;18;0;0;0;0;.00nan;0;0
176;34786;12;0;0;0;0;.00nan;0;0
177;1796;16;60;13;1;12;.923;3600000;0
177;1913;30;55;43;5;38;.884;3600000;0
177;4826;30;0;0;0;0;.00nan;0;0
177;15437;16;0;0;0;0;.00nan;0;0
178;724;11;91;36;3;33;.917;3557000;0
178;1821;3;54;16;2;14;.875;3600000;0
178;2054;3;0;0;0;0;.00nan;0;0
178;21522;11;0;0;0;0;.00nan;0;0
179;61;31;0;0;0;0;.00nan;0;0
179;18104;10;0;0;0;0;.00nan;0;0
179;27488;10;81;29;2;27;.931;3900000;0
179;34797;31;87;37;2;35;.946;3900000;0
180;5385;17;43;41;6;35;.854;3600000;0
180;27739;22;77;32;3;29;.906;3600000;0
180;28026;22;0;0;0;0;.00nan;0;0
180;34006;17;0;0;0;0;.00nan;0;0
181;2058;28;77;36;3;33;.917;3600000;0
181;4450;5;0;0;0;0;.00nan;0;0
181;14061;28;0;0;0;0;.00nan;0;0
181;19823;5;54;43;6;37;.860;3586000;0
182;724;11;0;0;0;0;.00nan;0;0
182;1074;0;93;31;1;30;.968;3600000;0
182;21522;11;54;25;3;22;.880;3556000;0
182;31035;0;0;0;0;0;.00nan;0;0
183;323;9;75;29;2;27;.931;3600000;0
183;823;23;0;0;0;0;.00nan;0;0
183;10274;23;44;33;5;28;.848;3600000;0
183;20853;9;0;0;0;0;.00nan;0;0
184;233;29;66;33;3;30;.909;3900000;0
184;10103;24;0;0;0;0;.00nan;0;0
184;13979;24;84;38;3;35;.921;3900000;0
184;18351;29;0;0;0;0;.00nan;0;0
185;51;21;46;36;7;29;.806;2773000;0
185;61;31;94;32;1;31;.969;3600000;0
185;25843;21;48;7;1;6;.857;827000;0
185;34797;31;0;0;0;0;.00nan;0;0
186;2423;15;93;32;1;31;.969;3600000;0
186;4106;15;0;0;0;0;.00nan;0;0
186;15505;8;50;45;6;39;.867;3600000;0
186;25076;8;0;0;0;0;.00nan;0;0
187;1796;16;76;34;3;31;.912;3784000;0
187;4506;33;52;35;4;31;.886;3784000;0
187;15437;16;0;0;0;0;.00nan;0;0
187;34740;33;0;0;0;0;.00nan;0;0
188;544;19;0;0;0;0;.00nan;0;0
188;738;27;0;0;0;0;.00nan;0;0
188;26623;27;56;20;2;18;.900;3561000;0
188;31124;19;100;34;1;33;.971;3600000;0
189;335;18;91;39;3;36;.923;3900000;0
189;1913;30;0;0;0;0;.00nan;0;0
189;4826;30;75;41;3;38;.927;3900000;0
189;5001;18;0;0;0;0;.00nan;0;0
190;500;4182;64;23;3;20;.870;3600000;0
190;1572;4838;52;26;3;23;.885;2714000;0
190;2328;4838;35;19;4;15;.789;886000;0
190;25521;4182;0;0;0;0;.00nan;0;0
191;1251;14;47;41;6;35;.854;3012000;0
191;1821;3;69;28;3;25;.893;3600000;0
191;2054;3;0;0;0;0;.00nan;0;0
191;25584;14;47;7;1;6;.857;588000;0
192;445;12;59;38;5;33;.868;3600000;0
192;15464;32;75;27;2;25;.926;3600000;0
192;16006;32;0;0;0;0;.00nan;0;0
192;34786;12;0;0;0;0;.00nan;0;0
193;262;35;0;0;0;0;.00nan;0;0
193;1430;35;57;30;4;26;.867;3563000;0
193;22601;26;0;0;0;0;.00nan;0;0
193;32754;26;92;44;3;41;.932;3600000;0
194;823;23;0;0;0;0;.00nan;0;0
194;4450;5;65;22;2;20;.909;3600000;0
194;10274;23;67;34;3;31;.912;3549000;0
194;19823;5;0;0;0;0;.00nan;0;0
195;544;19;70;36;3;33;.917;3600000;0
195;1074;0;56;40;5;35;.875;3532000;0
195;31035;0;0;0;0;0;.00nan;0;0
195;31124;19;0;0;0;0;.00nan;0;0
196;724;11;0;0;0;0;.00nan;0;0
196;2058;28;0;0;0;0;.00nan;0;0
196;14061;28;52;25;4;21;.840;3600000;0
196;21522;11;88;35;1;34;.971;3600000;0
197;323;9;99;44;1;43;.977;3600000;0
197;20853;9;0;0;0;0;.00nan;0;0
197;27739;22;0;0;0;0;.00nan;0;0
197;28026;22;48;33;5;28;.848;3600000;0
198;51;21;0;0;0;0;.00nan;0;0
198;928;20;59;30;4;26;.867;3600000;0
198;18078;20;0;0;0;0;.00nan;0;0
198;25843;21;85;27;1;26;.963;3600000;0
199;61;31;30;28;6;22;.786;3124000;0
199;2423;15;0;0;0;0;.00nan;0;0
199;4106;15;90;32;2;30;.938;3600000;0
199;34797;31;57;6;0;6;1.000;476000;0
200;1796;16;70;25;2;23;.920;3600000;0
200;15437;16;0;0;0;0;.00nan;0;0
200;15464;32;0;0;0;0;.00nan;0;0
200;16006;32;64;27;3;24;.889;3580000;0
201;738;27;49;34;4;30;.882;3576000;0
201;4506;33;54;30;3;27;.900;3600000;0
201;26623;27;0;0;0;0;.00nan;0;0
201;34740;33;0;0;0;0;.00nan;0;0
202;335;18;43;39;6;33;.846;2741000;0
202;1614;25;47;32;5;27;.844;3600000;0
202;5001;18;55;4;0;4;1.000;841000;0
202;5182;25;0;0;0;0;.00nan;0;0
203;262;35;49;33;5;28;.848;3600000;0
203;500;4182;64;16;1;15;.938;3600000;0
203;1430;35;0;0;0;0;.00nan;0;0
203;25521;4182;0;0;0;0;.00nan;0;0
204;1572;4838;54;31;4;27;.871;3600000;0
204;1913;30;45;15;2;13;.867;1390000;0
204;2328;4838;0;0;0;0;.00nan;0;0
204;4826;30;28;19;5;14;.737;2210000;0
205;823;23;74;24;2;22;.917;3600000;0
205;5385;17;0;0;0;0;.00nan;0;0
205;10274;23;0;0;0;0;.00nan;0;0
205;34006;17;44;35;6;29;.829;3600000;0
206;544;19;0;0;0;0;.00nan;0;0
206;1821;3;72;27;3;24;.889;3900000;0
206;2054;3;0;0;0;0;.00nan;0;0
206;31124;19;86;35;3;32;.914;3900000;0
207;1251;14;92;34;1;33;.971;3672000;0
207;10103;24;100;35;0;35;1.000;3672000;0
207;13979;24;0;0;0;0;.00nan;0;0
207;25584;14;0;0;0;0;.00nan;0;0
208;13842;34;77;38;3;35;.921;3900000;0
208;15502;34;0;0;0;0;.00nan;0;0
208;27739;22;70;37;3;34;.919;3900000;0
208;28026;22;0;0;0;0;.00nan;0;0
209;15505;8;0;0;0;0;.00nan;0;0
209;22601;26;0;0;0;0;.00nan;0;0
209;25076;8;100;23;0;23;1.000;3600000;0
209;32754;26;50;30;4;26;.867;3600000;0
210;1821;3;0;0;0;0;.00nan;0;0
210;2054;3;59;30;4;26;.867;3600000;0
210;5385;17;60;42;5;37;.881;3560000;0
210;34006;17;0;0;0;0;.00nan;0;0
211;2058;28;83;51;5;46;.902;3600000;0
211;2423;15;0;0;0;0;.00nan;0;0
211;4106;15;56;28;4;24;.857;3600000;0
211;14061;28;0;0;0;0;.00nan;0;0
212;323;9;94;33;1;32;.970;3600000;0
212;1074;0;47;24;4;20;.833;3600000;0
212;20853;9;0;0;0;0;.00nan;0;0
212;31035;0;0;0;0;0;.00nan;0;0
213;61;31;61;23;3;20;.870;2653000;0
213;233;29;0;0;0;0;.00nan;0;0
213;18351;29;100;34;1;33;.971;3600000;0
213;34797;31;27;13;4;9;.692;947000;0
214;51;21;0;0;0;0;.00nan;0;0
214;4450;5;87;19;0;19;1.000;3600000;0
214;19823;5;0;0;0;0;.00nan;0;0
214;25843;21;76;48;6;42;.875;3600000;0
215;1796;16;58;26;3;23;.885;3564000;0
215;10103;24;0;0;0;0;.00nan;0;0
215;13979;24;82;31;2;29;.935;3600000;0
215;15437;16;0;0;0;0;.00nan;0;0
216;13842;34;0;0;0;0;.00nan;0;0
216;15502;34;81;29;2;27;.931;3600000;0
216;18104;10;75;21;1;20;.952;3015000;0
216;27488;10;39;15;3;12;.800;517000;0
217;15464;32;0;0;0;0;.00nan;0;0
217;16006;32;95;22;0;22;1.000;3600000;0
217;22601;26;85;60;5;55;.917;3600000;0
217;32754;26;0;0;0;0;.00nan;0;0
218;445;12;0;0;0;0;.00nan;0;0
218;1251;14;41;22;4;18;.818;2296000;0
218;25584;14;40;16;3;13;.813;1304000;0
218;34786;12;74;32;2;30;.938;3600000;0
219;724;11;89;38;3;35;.921;3600000;0
219;4506;33;96;19;0;19;1.000;3600000;0
219;21522;11;0;0;0;0;.00nan;0;0
219;34740;33;0;0;0;0;.00nan;0;0
220;738;27;0;0;0;0;.00nan;0;0
220;1614;25;81;22;0;22;1.000;3900000;0
220;5182;25;0;0;0;0;.00nan;0;0
220;26623;27;100;39;0;39;1.000;3900000;0
221;335;18;64;27;2;25;.926;3571000;0
221;500;4182;86;27;1;26;.963;3600000;0
221;5001;18;0;0;0;0;.00nan;0;0
221;25521;4182;0;0;0;0;.00nan;0;0
222;262;35;0;0;0;0;.00nan;0;0
222;1430;35;59;29;4;25;.862;3600000;0
222;1572;4838;51;2;0;2;1.000;269000;0
222;2328;4838;47;37;6;31;.838;3254000;0
223;1074;0;63;36;4;32;.889;3600000;0
223;4450;5;55;23;3;20;.870;3600000;0
223;19823;5;0;0;0;0;.00nan;0;0
223;31035;0;0;0;0;0;.00nan;0;0
224;544;19;0;0;0;0;.00nan;0;0
224;2058;28;0;0;0;0;.00nan;0;0
224;14061;28;65;21;2;19;.905;3600000;0
224;31124;19;65;32;4;28;.875;3600000;0
225;51;21;65;48;5;43;.896;3600000;0
225;18104;10;0;0;0;0;.00nan;0;0
225;25843;21;0;0;0;0;.00nan;0;0
225;27488;10;79;21;1;20;.952;3600000;0
226;2423;15;47;31;5;26;.839;3841000;0
226;4106;15;0;0;0;0;.00nan;0;0
226;27739;22;0;0;0;0;.00nan;0;0
226;28026;22;86;44;4;40;.909;3841000;0
227;823;23;53;28;4;24;.857;3574000;0
227;1796;16;0;0;0;0;.00nan;0;0
227;10274;23;0;0;0;0;.00nan;0;0
227;15437;16;54;22;3;19;.864;3600000;0
228;335;18;0;0;0;0;.00nan;0;0
228;1913;30;0;0;0;0;.00nan;0;0
228;4826;30;65;26;2;24;.923;3600000;0
228;5001;18;66;27;3;24;.889;3558000;0
229;233;29;0;0;0;0;.00nan;0;0
229;928;20;95;48;5;43;.896;3600000;0
229;18078;20;0;0;0;0;.00nan;0;0
229;18351;29;50;39;6;33;.846;3592000;0
230;323;9;59;27;3;24;.889;3600000;0
230;13842;34;76;51;5;46;.902;3541000;0
230;15502;34;0;0;0;0;.00nan;0;0
230;20853;9;0;0;0;0;.00nan;0;0
231;1821;3;49;27;4;23;.852;3600000;0
231;2054;3;0;0;0;0;.00nan;0;0
231;15464;32;0;0;0;0;.00nan;0;0
231;16006;32;59;37;5;32;.865;3600000;0
232;61;31;40;30;5;25;.833;3600000;0
232;928;20;0;0;0;0;.00nan;0;0
232;18078;20;60;21;2;19;.905;3600000;0
232;34797;31;0;0;0;0;.00nan;0;0
233;51;21;0;0;0;0;.00nan;0;0
233;2058;28;81;28;2;26;.929;3600000;0
233;14061;28;0;0;0;0;.00nan;0;0
233;25843;21;69;32;3;29;.906;3543000;0
234;1074;0;57;31;4;27;.871;3600000;0
234;18104;10;0;0;0;0;.00nan;0;0
234;27488;10;89;38;2;36;.947;3600000;0
234;31035;0;0;0;0;0;.00nan;0;0
235;544;19;0;0;0;0;.00nan;0;0
235;1251;14;76;38;3;35;.921;3600000;0
235;25584;14;0;0;0;0;.00nan;0;0
235;31124;19;28;15;4;11;.733;3549000;0
236;2423;15;0;0;0;0;.00nan;0;0
236;4106;15;46;37;6;31;.838;3600000;0
236;5385;17;0;0;0;0;.00nan;0;0
236;34006;17;89;45;3;42;.933;3600000;0
237;1796;16;68;18;1;17;.944;3600000;0
237;15437;16;0;0;0;0;.00nan;0;0
237;22601;26;0;0;0;0;.00nan;0;0
237;32754;26;80;42;3;39;.929;3600000;0
238;323;9;25;28;7;21;.750;3280000;0
238;445;12;60;19;2;17;.895;3600000;0
238;20853;9;32;3;2;1;.333;320000;0
238;34786;12;0;0;0;0;.00nan;0;0
239;262;35;12;19;6;13;.684;2760000;0
239;738;27;0;0;0;0;.00nan;0;0
239;1430;35;55;11;1;10;.909;840000;0
239;26623;27;88;37;2;35;.946;3600000;0
240;823;23;0;0;0;0;.00nan;0;0
240;4506;33;76;21;1;20;.952;3652000;0
240;10274;23;94;37;2;35;.946;3652000;0
240;34740;33;0;0;0;0;.00nan;0;0
241;500;4182;0;0;0;0;.00nan;0;0
241;10103;24;100;46;0;46;1.000;3600000;0
241;13979;24;0;0;0;0;.00nan;0;0
241;25521;4182;80;31;1;30;.968;3600000;0
242;1913;30;0;0;0;0;.00nan;0;0
242;4826;30;99;35;1;34;.971;3600000;0
242;27739;22;0;0;0;0;.00nan;0;0
242;28026;22;39;25;6;19;.760;3600000;0
243;335;18;65;45;5;40;.889;3600000;0
243;1614;25;75;28;2;26;.929;3600000;0
243;5001;18;0;0;0;0;.00nan;0;0
243;5182;25;0;0;0;0;.00nan;0;0
244;724;11;34;42;7;35;.833;3140000;0
244;21522;11;48;0;0;0;.00nan;406000;0
244;27739;22;59;41;6;35;.854;3600000;0
244;28026;22;0;0;0;0;.00nan;0;0
245;1572;4838;0;0;0;0;.00nan;0;0
245;2328;4838;45;21;4;17;.810;3568000;0
245;15505;8;0;0;0;0;.00nan;0;0
245;25076;8;90;40;3;37;.925;3600000;0
246;544;19;76;36;3;33;.917;3600000;0
246;5385;17;57;36;4;32;.889;3560000;0
246;31124;19;0;0;0;0;.00nan;0;0
246;34006;17;0;0;0;0;.00nan;0;0
247;1821;3;79;34;3;31;.912;3600000;0
247;2054;3;0;0;0;0;.00nan;0;0
247;18104;10;100;37;1;36;.973;3600000;0
247;27488;10;0;0;0;0;.00nan;0;0
248;1074;0;49;22;3;19;.864;3569000;0
248;2423;15;0;0;0;0;.00nan;0;0
248;4106;15;93;35;1;34;.971;3600000;0
248;31035;0;0;0;0;0;.00nan;0;0
249;2058;28;66;30;2;28;.933;3900000;0
249;14061;28;0;0;0;0;.00nan;0;0
249;15464;32;64;17;2;15;.882;3900000;0
249;16006;32;0;0;0;0;.00nan;0;0
250;51;21;0;0;0;0;.00nan;0;0
250;61;31;0;0;0;0;.00nan;0;0
250;25843;21;87;31;2;29;.935;3600000;0
250;34797;31;76;42;4;38;.905;3600000;0
251;233;29;78;27;1;26;.963;3600000;0
251;1251;14;46;37;6;31;.838;3600000;0
251;18351;29;0;0;0;0;.00nan;0;0
251;25584;14;0;0;0;0;.00nan;0;0
252;738;27;0;0;0;0;.00nan;0;0
252;1796;16;28;17;5;12;.706;3520000;0
252;15437;16;0;0;0;0;.00nan;0;0
252;26623;27;82;40;3;37;.925;3600000;0
253;262;35;0;0;0;0;.00nan;0;0
253;445;12;0;0;0;0;.00nan;0;0
253;1430;35;93;20;0;20;1.000;3600000;0
253;34786;12;38;25;4;21;.840;3600000;0
254;823;23;0;0;0;0;.00nan;0;0
254;4506;33;60;24;3;21;.875;3600000;0
254;10274;23;100;27;0;27;1.000;3600000;0
254;34740;33;0;0;0;0;.00nan;0;0
255;13842;34;79;38;3;35;.921;3600000;0
255;15502;34;0;0;0;0;.00nan;0;0
255;22601;26;52;2;0;2;1.000;433000;0
255;32754;26;29;28;6;22;.786;3167000;0
256;323;9;85;39;2;37;.949;3530000;0
256;500;4182;99;21;0;21;1.000;3600000;0
256;20853;9;0;0;0;0;.00nan;0;0
256;25521;4182;0;0;0;0;.00nan;0;0
257;1913;30;0;0;0;0;.00nan;0;0
257;4826;30;99;39;1;38;.974;3600000;0
257;10103;24;91;37;2;35;.946;3581000;0
257;13979;24;0;0;0;0;.00nan;0;0
258;335;18;60;39;5;34;.872;3824000;0
258;4506;33;0;0;0;0;.00nan;0;0
258;5001;18;0;0;0;0;.00nan;0;0
258;34740;33;40;31;6;25;.806;3824000;0
259;1572;4838;0;0;0;0;.00nan;0;0
259;1614;25;30;23;5;18;.783;3525000;0
259;2328;4838;92;46;3;43;.935;3600000;0
259;5182;25;0;0;0;0;.00nan;0;0
260;1821;3;62;37;5;32;.865;3600000;0
260;2054;3;0;0;0;0;.00nan;0;0
260;2423;15;90;32;1;31;.969;3600000;0
260;4106;15;0;0;0;0;.00nan;0;0
261;1074;0;26;33;7;26;.788;3600000;0
261;15464;32;76;26;1;25;.962;3600000;0
261;16006;32;0;0;0;0;.00nan;0;0
261;31035;0;0;0;0;0;.00nan;0;0
262;2058;28;66;23;3;20;.870;3600000;0
262;14061;28;0;0;0;0;.00nan;0;0
262;18104;10;0;0;0;0;.00nan;0;0
262;27488;10;84;49;2;47;.959;3600000;0
263;51;21;0;0;0;0;.00nan;0;0
263;233;29;0;0;0;0;.00nan;0;0
263;18351;29;86;14;0;14;1.000;3600000;0
263;25843;21;82;33;2;31;.939;3571000;0
264;61;31;0;0;0;0;.00nan;0;0
264;262;35;0;0;0;0;.00nan;0;0
264;1430;35;63;33;3;30;.909;3557000;0
264;34797;31;68;27;2;25;.926;3600000;0
265;544;19;66;33;3;30;.909;3533000;0
265;928;20;92;33;1;32;.970;3600000;0
265;18078;20;0;0;0;0;.00nan;0;0
265;31124;19;0;0;0;0;.00nan;0;0
266;1251;14;0;0;0;0;.00nan;0;0
266;4450;5;46;20;3;17;.850;3516000;0
266;19823;5;0;0;0;0;.00nan;0;0
266;25584;14;78;24;1;23;.958;3600000;0
267;445;12;93;25;1;24;.960;3600000;0
267;1796;16;75;38;4;34;.895;3600000;0
267;15437;16;0;0;0;0;.00nan;0;0
267;34786;12;0;0;0;0;.00nan;0;0
268;823;23;0;0;0;0;.00nan;0;0
268;10274;23;71;37;4;33;.892;3600000;0
268;25076;8;97;32;1;31;.969;3600000;0
268;34788;8;0;0;0;0;.00nan;0;0
269;323;9;93;31;2;29;.935;3600000;0
269;20853;9;0;0;0;0;.00nan;0;0
269;22601;26;53;46;6;40;.870;3029000;0
269;32754;26;41;4;1;3;.750;571000;0
270;500;4182;69;31;3;28;.903;3600000;0
270;13842;34;96;47;2;45;.957;3600000;0
270;15502;34;0;0;0;0;.00nan;0;0
270;25521;4182;0;0;0;0;.00nan;0;0
271;724;11;0;0;0;0;.00nan;0;0
271;10103;24;0;0;0;0;.00nan;0;0
271;13979;24;80;30;1;29;.967;3600000;0
271;21522;11;83;36;2;34;.944;3591000;0
272;738;27;0;0;0;0;.00nan;0;0
272;26623;27;68;27;2;25;.926;3575000;0
272;27739;22;83;35;1;34;.971;3600000;0
272;28026;22;0;0;0;0;.00nan;0;0
273;544;19;57;32;4;28;.875;3519000;0
273;4450;5;0;0;0;0;.00nan;0;0
273;19823;5;69;24;2;22;.917;3600000;0
273;31124;19;0;0;0;0;.00nan;0;0
274;233;29;0;0;0;0;.00nan;0;0
274;262;35;37;33;6;27;.818;3600000;0
274;1430;35;0;0;0;0;.00nan;0;0
274;18351;29;80;29;2;27;.931;3600000;0
275;928;20;0;0;0;0;.00nan;0;0
275;1821;3;0;0;0;0;.00nan;0;0
275;2054;3;63;35;4;31;.886;3600000;0
275;18078;20;96;37;1;36;.973;3600000;0
276;5385;17;0;0;0;0;.00nan;0;0
276;18104;10;73;28;2;26;.929;3600000;0
276;27488;10;0;0;0;0;.00nan;0;0
276;34006;17;38;27;5;22;.815;3600000;0
277;335;18;0;0;0;0;.00nan;0;0
277;5001;18;76;35;3;32;.914;3516000;0
277;25076;8;0;0;0;0;.00nan;0;0
277;34788;8;88;27;1;26;.963;3600000;0
278;724;11;100;33;0;33;1.000;3600000;0
278;21522;11;0;0;0;0;.00nan;0;0
278;22601;26;0;0;0;0;.00nan;0;0
278;32754;26;56;28;3;25;.893;3600000;0
279;1572;4838;100;26;0;26;1.000;3600000;0
279;2328;4838;0;0;0;0;.00nan;0;0
279;27739;22;91;21;0;21;1.000;2641000;0
279;28026;22;25;13;4;9;.692;959000;0
280;5385;17;100;46;2;44;.957;3600000;0
280;13842;34;57;26;3;23;.885;3546000;0
280;15502;34;0;0;0;0;.00nan;0;0
280;34006;17;0;0;0;0;.00nan;0;0
281;500;4182;100;33;0;33;1.000;3600000;0
281;1796;16;69;22;2;20;.909;3571000;0
281;15437;16;0;0;0;0;.00nan;0;0
281;25521;4182;0;0;0;0;.00nan;0;0
282;1913;30;93;39;2;37;.949;3547000;0
282;4826;30;0;0;0;0;.00nan;0;0
282;15464;32;82;28;1;27;.964;3600000;0
282;16006;32;0;0;0;0;.00nan;0;0
283;2423;15;45;40;6;34;.850;3600000;0
283;4106;15;0;0;0;0;.00nan;0;0
283;4506;33;75;28;1;27;.964;3600000;0
283;34740;33;0;0;0;0;.00nan;0;0
284;1614;25;0;0;0;0;.00nan;0;0
284;2058;28;0;0;0;0;.00nan;0;0
284;5182;25;47;29;5;24;.828;3600000;0
284;14061;28;56;33;4;29;.879;3600000;0
285;738;27;71;32;3;29;.906;3600000;0
285;10103;24;0;0;0;0;.00nan;0;0
285;13979;24;39;27;4;23;.852;3579000;0
285;26623;27;0;0;0;0;.00nan;0;0
286;233;29;96;21;0;21;1.000;3600000;0
286;1251;14;0;0;0;0;.00nan;0;0
286;18351;29;0;0;0;0;.00nan;0;0
286;25584;14;70;41;4;37;.902;3600000;0
287;445;12;100;31;0;31;1.000;3600000;0
287;823;23;0;0;0;0;.00nan;0;0
287;10274;23;65;41;5;36;.878;3600000;0
287;34786;12;0;0;0;0;.00nan;0;0
288;544;19;0;0;0;0;.00nan;0;0
288;25076;8;0;0;0;0;.00nan;0;0
288;31124;19;87;25;1;24;.960;3600000;0
288;34788;8;65;41;4;37;.902;3600000;0
289;4450;5;64;22;2;20;.909;3600000;0
289;5385;17;36;8;2;6;.750;757000;0
289;19823;5;0;0;0;0;.00nan;0;0
289;34006;17;57;43;6;37;.860;2843000;0
290;323;9;0;0;0;0;.00nan;0;0
290;1796;16;67;16;1;15;.938;3600000;0
290;15437;16;0;0;0;0;.00nan;0;0
290;20853;9;91;45;3;42;.933;3516000;0
291;61;31;48;35;5;30;.857;3600000;0
291;1251;14;94;38;2;36;.947;3600000;0
291;25584;14;0;0;0;0;.00nan;0;0
291;34797;31;0;0;0;0;.00nan;0;0
292;51;21;82;25;1;24;.960;3900000;0
292;262;35;100;35;1;34;.971;3900000;0
292;1430;35;0;0;0;0;.00nan;0;0
292;25843;21;0;0;0;0;.00nan;0;0
293;928;20;67;36;4;32;.889;3600000;0
293;18078;20;0;0;0;0;.00nan;0;0
293;18104;10;57;29;3;26;.897;3600000;0
293;27488;10;0;0;0;0;.00nan;0;0
294;335;18;81;34;3;31;.912;3600000;0
294;2423;15;48;26;4;22;.846;3569000;0
294;4106;15;0;0;0;0;.00nan;0;0
294;5001;18;0;0;0;0;.00nan;0;0
295;1074;0;95;36;2;34;.944;3600000;0
295;27739;22;52;26;3;23;.885;3590000;0
295;28026;22;0;0;0;0;.00nan;0;0
295;31035;0;0;0;0;0;.00nan;0;0
296;4506;33;0;0;0;0;.00nan;0;0
296;13842;34;84;38;3;35;.921;3600000;0
296;15502;34;0;0;0;0;.00nan;0;0
296;34740;33;50;32;5;27;.844;3551000;0
297;500;4182;78;22;1;21;.955;3600000;0
297;15464;32;97;39;2;37;.949;3543000;0
297;16006;32;0;0;0;0;.00nan;0;0
297;25521;4182;0;0;0;0;.00nan;0;0
298;1614;25;76;35;3;32;.914;3530000;0
298;1913;30;65;28;2;26;.929;3600000;0
298;4826;30;0;0;0;0;.00nan;0;0
298;5182;25;0;0;0;0;.00nan;0;0
299;823;23;65;37;4;33;.892;3600000;0
299;10274;23;0;0;0;0;.00nan;0;0
299;22601;26;0;0;0;0;.00nan;0;0
299;32754;26;100;34;1;33;.971;3600000;0
300;724;11;55;28;4;24;.857;3600000;0
300;1821;3;75;33;3;30;.909;3600000;0
300;2054;3;0;0;0;0;.00nan;0;0
300;21522;11;0;0;0;0;.00nan;0;0
301;738;27;0;0;0;0;.00nan;0;0
301;2058;28;99;41;1;40;.976;3600000;0
301;14061;28;0;0;0;0;.00nan;0;0
301;26623;27;58;32;4;28;.875;3600000;0
302;1572;4838;96;34;1;33;.971;3600000;0
302;2328;4838;0;0;0;0;.00nan;0;0
302;10103;24;56;21;2;19;.905;3580000;0
302;13979;24;0;0;0;0;.00nan;0;0
303;4450;5;0;0;0;0;.00nan;0;0
303;18104;10;59;46;6;40;.870;3600000;0
303;19823;5;54;22;3;19;.864;3600000;0
303;27488;10;0;0;0;0;.00nan;0;0
304;1074;0;89;41;2;39;.951;3900000;0
304;5385;17;0;0;0;0;.00nan;0;0
304;31035;0;0;0;0;0;.00nan;0;0
304;34006;17;96;40;2;38;.950;3900000;0
305;233;29;99;28;0;28;1.000;3600000;0
305;1572;4838;58;35;4;31;.886;3600000;0
305;2328;4838;0;0;0;0;.00nan;0;0
305;18351;29;0;0;0;0;.00nan;0;0
306;928;20;73;33;3;30;.909;3569000;0
306;2423;15;83;34;2;32;.941;3600000;0
306;4106;15;0;0;0;0;.00nan;0;0
306;18078;20;0;0;0;0;.00nan;0;0
307;1251;14;0;0;0;0;.00nan;0;0
307;10103;24;0;0;0;0;.00nan;0;0
307;13979;24;94;31;1;30;.968;3600000;0
307;25584;14;68;39;4;35;.897;3600000;0
308;61;31;0;0;0;0;.00nan;0;0
308;27739;22;67;27;2;25;.926;3600000;0
308;28026;22;0;0;0;0;.00nan;0;0
308;34797;31;57;31;4;27;.871;3514000;0
309;335;18;83;27;1;26;.963;3600000;0
309;5001;18;0;0;0;0;.00nan;0;0
309;13842;34;32;28;5;23;.821;3600000;0
309;15502;34;0;0;0;0;.00nan;0;0
310;1796;16;73;19;1;18;.947;3600000;0
310;15437;16;0;0;0;0;.00nan;0;0
310;25076;8;54;39;6;33;.846;2694000;0
310;34788;8;52;9;1;8;.889;906000;0
311;51;21;0;0;0;0;.00nan;0;0
311;15464;32;71;34;3;31;.912;3600000;0
311;16006;32;0;0;0;0;.00nan;0;0
311;25843;21;47;33;5;28;.848;3561000;0
312;445;12;84;24;1;23;.958;3600000;0
312;1614;25;61;28;3;25;.893;3571000;0
312;5182;25;0;0;0;0;.00nan;0;0
312;34786;12;0;0;0;0;.00nan;0;0
313;262;35;0;0;0;0;.00nan;0;0
313;1430;35;75;26;2;24;.923;3600000;0
313;4506;33;0;0;0;0;.00nan;0;0
313;34740;33;56;24;3;21;.875;3546000;0
314;1913;30;0;0;0;0;.00nan;0;0
314;2058;28;99;22;0;22;1.000;3600000;0
314;4826;30;71;34;3;31;.912;3600000;0
314;14061;28;0;0;0;0;.00nan;0;0
315;738;27;0;0;0;0;.00nan;0;0
315;1821;3;100;29;0;29;1.000;3600000;0
315;2054;3;0;0;0;0;.00nan;0;0
315;26623;27;70;35;3;32;.914;3600000;0
316;323;9;89;28;1;27;.964;3600000;0
316;5385;17;66;38;4;34;.895;3600000;0
316;20853;9;0;0;0;0;.00nan;0;0
316;34006;17;0;0;0;0;.00nan;0;0
317;61;31;57;28;3;25;.893;3600000;0
317;1572;4838;53;3;0;3;1.000;474000;0
317;2328;4838;34;34;6;28;.824;3126000;0
317;34797;31;0;0;0;0;.00nan;0;0
318;1074;0;81;27;1;26;.963;3600000;0
318;2423;15;0;0;0;0;.00nan;0;0
318;4106;15;70;32;3;29;.906;3530000;0
318;31035;0;0;0;0;0;.00nan;0;0
319;1796;16;0;0;0;0;.00nan;0;0
319;13842;34;0;0;0;0;.00nan;0;0
319;15437;16;60;14;1;13;.929;3600000;0
319;15502;34;81;42;3;39;.929;3600000;0
320;1614;25;0;0;0;0;.00nan;0;0
320;5182;25;70;33;4;29;.879;3665000;0
320;15464;32;0;0;0;0;.00nan;0;0
320;16006;32;71;33;3;30;.909;3665000;0
321;544;19;0;0;0;0;.00nan;0;0
321;4506;33;87;34;2;32;.941;3584000;0
321;31124;19;91;30;1;29;.967;3600000;0
321;34740;33;0;0;0;0;.00nan;0;0
322;445;12;0;0;0;0;.00nan;0;0
322;22601;26;91;52;4;48;.923;3559000;0
322;32754;26;0;0;0;0;.00nan;0;0
322;34786;12;43;16;3;13;.813;3600000;0
323;500;4182;59;25;3;22;.880;3600000;0
323;823;23;85;54;4;50;.926;3574000;0
323;10274;23;0;0;0;0;.00nan;0;0
323;25521;4182;0;0;0;0;.00nan;0;0
324;724;11;90;34;2;32;.941;3900000;0
324;2058;28;99;37;2;35;.946;3900000;0
324;14061;28;0;0;0;0;.00nan;0;0
324;21522;11;0;0;0;0;.00nan;0;0
325;335;18;0;0;0;0;.00nan;0;0
325;4450;5;72;42;4;38;.905;3600000;0
325;5001;18;75;25;1;24;.960;3600000;0
325;19823;5;0;0;0;0;.00nan;0;0
326;51;21;75;33;3;30;.909;3600000;0
326;1251;14;0;0;0;0;.00nan;0;0
326;25584;14;34;26;5;21;.808;3571000;0
326;25843;21;0;0;0;0;.00nan;0;0
327;928;20;75;22;1;21;.955;3600000;0
327;18078;20;0;0;0;0;.00nan;0;0
327;18104;10;0;0;0;0;.00nan;0;0
327;27488;10;81;40;4;36;.900;3600000;0
328;10103;24;71;29;2;27;.931;3897000;0
328;13979;24;0;0;0;0;.00nan;0;0
328;27739;22;0;0;0;0;.00nan;0;0
328;28026;22;94;55;3;52;.945;3897000;0
329;738;27;51;2;0;2;1.000;252000;0
329;15505;8;0;0;0;0;.00nan;0;0
329;25076;8;93;37;2;35;.946;3600000;0
329;26623;27;48;42;6;36;.857;3348000;0
330;233;29;80;28;2;26;.929;3681000;0
330;262;35;71;27;3;24;.889;3681000;0
330;1430;35;0;0;0;0;.00nan;0;0
330;18351;29;0;0;0;0;.00nan;0;0
331;1821;3;52;26;4;22;.846;3578000;0
331;1913;30;0;0;0;0;.00nan;0;0
331;2054;3;0;0;0;0;.00nan;0;0
331;4826;30;91;46;2;44;.957;3600000;0
332;1572;4838;72;31;2;29;.935;3600000;0
332;2328;4838;0;0;0;0;.00nan;0;0
332;5385;17;0;0;0;0;.00nan;0;0
332;34006;17;69;34;3;31;.912;3565000;0
333;335;18;65;17;1;16;.941;3600000;0
333;1074;0;0;0;0;0;.00nan;0;0
333;5001;18;0;0;0;0;.00nan;0;0
333;31035;0;91;49;4;45;.918;3600000;0
334;4506;33;62;36;4;32;.889;3900000;0
334;22601;26;85;41;4;37;.902;3900000;0
334;32754;26;0;0;0;0;.00nan;0;0
334;34740;33;0;0;0;0;.00nan;0;0
335;544;19;58;30;4;26;.867;3900000;0
335;2423;15;0;0;0;0;.00nan;0;0
335;4106;15;64;37;4;33;.892;3900000;0
335;31124;19;0;0;0;0;.00nan;0;0
336;323;9;97;45;2;43;.956;3900000;0
336;4450;5;0;0;0;0;.00nan;0;0
336;19823;5;83;30;2;28;.933;3900000;0
336;20853;9;0;0;0;0;.00nan;0;0
337;61;31;0;0;0;0;.00nan;0;0
337;27739;22;0;0;0;0;.00nan;0;0
337;28026;22;100;55;3;52;.945;3900000;0
337;34797;31;66;28;3;25;.893;3900000;0
338;51;21;77;27;2;25;.926;3600000;0
338;738;27;72;33;4;29;.879;3586000;0
338;25843;21;0;0;0;0;.00nan;0;0
338;26623;27;0;0;0;0;.00nan;0;0
339;928;20;65;27;2;25;.926;3516000;0
339;1251;14;0;0;0;0;.00nan;0;0
339;18078;20;0;0;0;0;.00nan;0;0
339;25584;14;89;20;0;20;1.000;3600000;0
340;1796;16;54;19;3;16;.842;3600000;0
340;7139;29;66;33;4;29;.879;3565000;0
340;15437;16;0;0;0;0;.00nan;0;0
340;18351;29;0;0;0;0;.00nan;0;0
341;13842;34;77;38;4;34;.895;3900000;0
341;15464;32;52;23;4;19;.826;3900000;0
341;15502;34;0;0;0;0;.00nan;0;0
341;16006;32;0;0;0;0;.00nan;0;0
342;445;12;76;35;3;32;.914;3659000;0
342;10103;24;0;0;0;0;.00nan;0;0
342;13979;24;75;32;2;30;.938;3659000;0
342;34786;12;0;0;0;0;.00nan;0;0
343;262;35;48;31;5;26;.839;3600000;0
343;1430;35;0;0;0;0;.00nan;0;0
343;22601;26;0;0;0;0;.00nan;0;0
343;32754;26;82;37;3;34;.919;3600000;0
344;724;11;38;20;4;16;.800;3600000;0
344;1913;30;0;0;0;0;.00nan;0;0
344;4826;30;99;48;2;46;.958;3600000;0
344;21522;11;0;0;0;0;.00nan;0;0
345;1614;25;66;37;4;33;.892;3529000;0
345;1821;3;69;26;2;24;.923;3600000;0
345;2054;3;0;0;0;0;.00nan;0;0
345;5182;25;0;0;0;0;.00nan;0;0
346;335;18;36;32;6;26;.813;3600000;0
346;2058;28;99;48;1;47;.979;3600000;0
346;5001;18;0;0;0;0;.00nan;0;0
346;14061;28;0;0;0;0;.00nan;0;0
347;323;9;0;0;0;0;.00nan;0;0
347;1572;4838;80;29;2;27;.931;3777000;0
347;2328;4838;0;0;0;0;.00nan;0;0
347;20853;9;71;34;3;31;.912;3746000;0
348;1251;14;0;0;0;0;.00nan;0;0
348;18104;10;0;0;0;0;.00nan;0;0
348;25584;14;60;34;4;30;.882;3600000;0
348;27488;10;92;17;0;17;1.000;3600000;0
349;823;23;37;12;3;9;.750;1540000;0
349;2423;15;62;35;5;30;.857;3600000;0
349;4106;15;0;0;0;0;.00nan;0;0
349;10274;23;31;21;5;16;.762;2060000;0
350;500;4182;63;14;1;13;.929;3600000;0
350;1913;30;85;40;3;37;.925;3598000;0
350;4826;30;0;0;0;0;.00nan;0;0
350;25521;4182;0;0;0;0;.00nan;0;0
351;1074;0;100;25;0;25;1.000;3600000;0
351;1614;25;0;0;0;0;.00nan;0;0
351;5182;25;45;24;4;20;.833;3600000;0
351;31035;0;0;0;0;0;.00nan;0;0
352;1796;16;100;26;0;26;1.000;3600000;0
352;7139;29;0;0;0;0;.00nan;0;0
352;15437;16;0;0;0;0;.00nan;0;0
352;18351;29;91;47;4;43;.915;3600000;0
353;61;31;46;26;5;21;.808;3575000;0
353;5385;17;70;35;4;31;.886;3600000;0
353;34006;17;0;0;0;0;.00nan;0;0
353;34797;31;0;0;0;0;.00nan;0;0
354;738;27;0;0;0;0;.00nan;0;0
354;928;20;53;11;1;10;.909;1252000;0
354;18078;20;29;28;6;22;.786;2348000;0
354;26623;27;62;29;3;26;.897;3600000;0
355;15505;8;0;0;0;0;.00nan;0;0
355;25076;8;69;38;4;34;.895;3513000;0
355;27739;22;0;0;0;0;.00nan;0;0
355;28026;22;91;40;2;38;.950;3600000;0
356;2058;28;0;0;0;0;.00nan;0;0
356;10103;24;0;0;0;0;.00nan;0;0
356;13979;24;87;34;2;32;.941;3600000;0
356;14061;28;80;42;3;39;.929;3586000;0
357;4450;5;82;24;2;22;.917;3513000;0
357;15464;32;100;43;0;43;1.000;3600000;0
357;16006;32;0;0;0;0;.00nan;0;0
357;19823;5;0;0;0;0;.00nan;0;0
358;445;12;78;24;1;23;.958;3600000;0
358;13842;34;85;46;3;43;.935;3576000;0
358;15502;34;0;0;0;0;.00nan;0;0
358;34786;12;0;0;0;0;.00nan;0;0
359;51;21;70;50;6;44;.880;3582000;0
359;262;35;0;0;0;0;.00nan;0;0
359;1430;35;76;35;3;32;.914;3600000;0
359;25843;21;0;0;0;0;.00nan;0;0
360;544;19;48;12;2;10;.833;1217000;0
360;724;11;0;0;0;0;.00nan;0;0
360;21522;11;80;28;1;27;.964;3600000;0
360;31124;19;33;26;5;21;.808;2383000;0
361;738;27;0;0;0;0;.00nan;0;0
361;18104;10;0;0;0;0;.00nan;0;0
361;26623;27;34;26;5;21;.808;3587000;0
361;27488;10;72;41;4;37;.902;3600000;0
362;51;21;0;0;0;0;.00nan;0;0
362;4506;33;54;29;4;25;.862;3600000;0
362;25843;21;44;34;5;29;.853;3590000;0
362;34740;33;0;0;0;0;.00nan;0;0
363;500;4182;0;0;0;0;.00nan;0;0
363;22601;26;83;41;3;38;.927;3156000;0
363;25521;4182;71;25;2;23;.920;3600000;0
363;32754;26;31;8;3;5;.625;444000;0
364;544;19;54;23;3;20;.870;3600000;0
364;1913;30;89;38;2;36;.947;3600000;0
364;4826;30;0;0;0;0;.00nan;0;0
364;31124;19;0;0;0;0;.00nan;0;0
365;823;23;0;0;0;0;.00nan;0;0
365;1572;4838;71;37;3;34;.919;3558000;0
365;2328;4838;0;0;0;0;.00nan;0;0
365;10274;23;64;22;2;20;.909;3600000;0
366;4450;5;0;0;0;0;.00nan;0;0
366;7139;29;0;0;0;0;.00nan;0;0
366;18351;29;41;35;6;29;.829;3600000;0
366;19823;5;51;24;3;21;.875;3600000;0
367;1614;25;87;46;3;43;.935;3550000;0
367;2058;28;87;35;2;33;.943;3600000;0
367;5182;25;0;0;0;0;.00nan;0;0
367;14061;28;0;0;0;0;.00nan;0;0
368;323;9;74;37;3;34;.919;3600000;0
368;928;20;0;0;0;0;.00nan;0;0
368;18078;20;42;25;4;21;.840;3561000;0
368;20853;9;0;0;0;0;.00nan;0;0
369;61;31;0;0;0;0;.00nan;0;0
369;1796;16;52;33;5;28;.848;3587000;0
369;15437;16;0;0;0;0;.00nan;0;0
369;34797;31;64;25;3;22;.880;3600000;0
370;15505;8;90;31;1;30;.968;3167000;0
370;18104;10;86;37;1;36;.973;3600000;0
370;25076;8;25;6;3;3;.500;433000;0
370;27488;10;0;0;0;0;.00nan;0;0
371;13842;34;63;28;3;25;.893;3586000;0
371;15502;34;0;0;0;0;.00nan;0;0
371;27739;22;0;0;0;0;.00nan;0;0
371;28026;22;78;29;2;27;.931;3600000;0
372;5385;17;67;34;4;30;.882;3600000;0
372;10103;24;38;7;2;5;.714;1301000;0
372;13979;24;1;23;8;15;.652;2299000;0
372;34006;17;0;0;0;0;.00nan;0;0
373;1074;0;84;40;3;37;.925;3600000;0
373;15464;32;43;25;4;21;.840;3543000;0
373;16006;32;0;0;0;0;.00nan;0;0
373;31035;0;0;0;0;0;.00nan;0;0
374;262;35;0;0;0;0;.00nan;0;0
374;1430;35;72;30;3;27;.900;3610000;0
374;1821;3;65;32;4;28;.875;3610000;0
374;2054;3;0;0;0;0;.00nan;0;0
375;335;18;0;0;0;0;.00nan;0;0
375;2423;15;0;0;0;0;.00nan;0;0
375;4106;15;75;29;2;27;.931;3600000;0
375;5001;18;91;56;5;51;.911;3600000;0
376;1251;14;52;37;5;32;.865;3600000;0
376;7139;29;91;23;1;22;.957;3600000;0
376;18351;29;0;0;0;0;.00nan;0;0
376;25584;14;0;0;0;0;.00nan;0;0
377;738;27;0;0;0;0;.00nan;0;0
377;13842;34;0;0;0;0;.00nan;0;0
377;15502;34;76;25;1;24;.960;3600000;0
377;26623;27;48;15;3;12;.800;3522000;0
378;928;20;48;25;4;21;.840;3600000;0
378;15505;8;58;6;0;6;1.000;513000;0
378;18078;20;0;0;0;0;.00nan;0;0
378;25076;8;22;30;7;23;.767;3087000;0
379;1821;3;77;33;2;31;.939;3600000;0
379;2054;3;0;0;0;0;.00nan;0;0
379;4506;33;85;42;3;39;.929;3557000;0
379;34740;33;0;0;0;0;.00nan;0;0
380;724;11;51;25;4;21;.840;3900000;0
380;823;23;29;7;3;4;.571;339000;0
380;10274;23;86;22;1;21;.955;3561000;0
380;21522;11;0;0;0;0;.00nan;0;0
381;500;4182;82;15;0;15;1.000;3600000;0
381;544;19;41;51;8;43;.843;3600000;0
381;25521;4182;0;0;0;0;.00nan;0;0
381;31124;19;0;0;0;0;.00nan;0;0
382;1251;14;0;0;0;0;.00nan;0;0
382;1614;25;72;24;1;23;.958;3900000;0
382;5182;25;0;0;0;0;.00nan;0;0
382;25584;14;97;36;1;35;.972;3900000;0
383;1913;30;97;35;1;34;.971;3900000;0
383;4826;30;0;0;0;0;.00nan;0;0
383;27739;22;0;0;0;0;.00nan;0;0
383;28026;22;86;30;1;29;.967;3900000;0
384;445;12;73;29;2;27;.931;3600000;0
384;22601;26;0;0;0;0;.00nan;0;0
384;32754;26;61;32;3;29;.906;3581000;0
384;34786;12;0;0;0;0;.00nan;0;0
385;335;18;67;14;1;13;.929;3812000;0
385;724;11;0;0;0;0;.00nan;0;0
385;5001;18;0;0;0;0;.00nan;0;0
385;21522;11;92;43;2;41;.953;3812000;0
386;1572;4838;36;13;3;10;.769;775000;0
386;2328;4838;19;25;7;18;.720;2825000;0
386;2423;15;72;19;1;18;.947;3600000;0
386;4106;15;0;0;0;0;.00nan;0;0
387;1913;30;0;0;0;0;.00nan;0;0
387;4826;30;73;33;4;29;.879;3600000;0
387;5385;17;0;0;0;0;.00nan;0;0
387;34006;17;34;29;6;23;.793;3550000;0
388;1821;3;59;43;7;36;.837;3600000;0
388;2054;3;0;0;0;0;.00nan;0;0
388;13842;34;82;28;2;26;.929;3600000;0
388;15502;34;0;0;0;0;.00nan;0;0
389;1074;0;57;39;5;34;.872;3571000;0
389;7139;29;0;0;0;0;.00nan;0;0
389;18351;29;75;31;3;28;.903;3600000;0
389;31035;0;0;0;0;0;.00nan;0;0
390;928;20;0;0;0;0;.00nan;0;0
390;2058;28;67;34;3;31;.912;3600000;0
390;14061;28;0;0;0;0;.00nan;0;0
390;18078;20;44;37;5;32;.865;3523000;0
391;323;9;80;31;2;29;.935;3557000;0
391;15464;32;100;30;0;30;1.000;3600000;0
391;16006;32;0;0;0;0;.00nan;0;0
391;20853;9;0;0;0;0;.00nan;0;0
392;15505;8;0;0;0;0;.00nan;0;0
392;18104;10;0;0;0;0;.00nan;0;0
392;25076;8;43;33;5;28;.848;3600000;0
392;27488;10;50;30;4;26;.867;3600000;0
393;61;31;0;0;0;0;.00nan;0;0
393;1796;16;66;32;3;29;.906;3900000;0
393;15437;16;0;0;0;0;.00nan;0;0
393;34797;31;74;31;3;28;.903;3900000;0
394;4506;33;0;0;0;0;.00nan;0;0
394;10103;24;0;0;0;0;.00nan;0;0
394;13979;24;57;30;4;26;.867;3585000;0
394;34740;33;85;29;2;27;.931;3600000;0
395;262;35;0;0;0;0;.00nan;0;0
395;823;23;0;0;0;0;.00nan;0;0
395;1430;35;57;23;3;20;.870;3600000;0
395;10274;23;54;24;4;20;.833;3543000;0
396;544;19;0;0;0;0;.00nan;0;0
396;738;27;0;0;0;0;.00nan;0;0
396;26623;27;69;22;2;20;.909;3600000;0
396;31124;19;69;38;3;35;.921;3569000;0
397;51;21;39;34;6;28;.824;3557000;0
397;1251;14;0;0;0;0;.00nan;0;0
397;25584;14;27;22;5;17;.773;3600000;0
397;25843;21;0;0;0;0;.00nan;0;0
398;1614;25;47;38;6;32;.842;3600000;0
398;5182;25;0;0;0;0;.00nan;0;0
398;18104;10;86;34;3;31;.912;3600000;0
398;27488;10;0;0;0;0;.00nan;0;0
399;335;18;0;0;0;0;.00nan;0;0
399;4450;5;65;25;2;23;.920;3600000;0
399;5001;18;67;31;3;28;.903;3572000;0
399;19823;5;0;0;0;0;.00nan;0;0
400;445;12;63;36;4;32;.889;3900000;0
400;500;4182;59;30;4;26;.867;3900000;0
400;25521;4182;0;0;0;0;.00nan;0;0
400;34786;12;0;0;0;0;.00nan;0;0
401;1821;3;47;34;6;28;.824;2350000;0
401;2054;3;60;16;1;15;.938;1250000;0
401;7139;29;0;0;0;0;.00nan;0;0
401;18351;29;83;29;2;27;.931;3600000;0
402;1074;0;74;37;4;33;.892;3565000;0
402;15505;8;0;0;0;0;.00nan;0;0
402;25076;8;73;28;3;25;.893;3600000;0
402;31035;0;0;0;0;0;.00nan;0;0
403;928;20;62;31;3;28;.903;3600000;0
403;15464;32;68;42;4;38;.905;3548000;0
403;16006;32;0;0;0;0;.00nan;0;0
403;18078;20;0;0;0;0;.00nan;0;0
404;1913;30;0;0;0;0;.00nan;0;0
404;4826;30;64;51;6;45;.882;3600000;0
404;13842;34;71;24;2;22;.917;3600000;0
404;15502;34;0;0;0;0;.00nan;0;0
405;323;9;24;9;4;5;.556;1149000;0
405;1796;16;31;23;5;18;.783;3600000;0
405;15437;16;0;0;0;0;.00nan;0;0
405;20853;9;53;24;4;20;.833;2451000;0
406;544;19;0;0;0;0;.00nan;0;0
406;10103;24;94;31;1;30;.968;3600000;0
406;13979;24;0;0;0;0;.00nan;0;0
406;31124;19;76;32;2;30;.938;3543000;0
407;823;23;0;0;0;0;.00nan;0;0
407;4450;5;0;0;0;0;.00nan;0;0
407;10274;23;59;30;4;26;.867;3600000;0
407;19823;5;100;35;0;35;1.000;3600000;0
408;445;12;0;0;0;0;.00nan;0;0
408;724;11;51;25;3;22;.880;3600000;0
408;21522;11;0;0;0;0;.00nan;0;0
408;34786;12;64;30;4;26;.867;3600000;0
409;262;35;80;30;2;28;.933;3600000;0
409;738;27;0;0;0;0;.00nan;0;0
409;1430;35;0;0;0;0;.00nan;0;0
409;26623;27;47;19;3;16;.842;3600000;0
410;1572;4838;62;25;3;22;.880;3547000;0
410;2328;4838;0;0;0;0;.00nan;0;0
410;4506;33;76;22;1;21;.955;3600000;0
410;34740;33;0;0;0;0;.00nan;0;0
411;5385;17;48;49;7;42;.857;3305000;0
411;18104;10;0;0;0;0;.00nan;0;0
411;27488;10;56;22;3;19;.864;3600000;0
411;34006;17;51;3;0;3;1.000;295000;0
412;51;21;72;29;2;27;.931;3900000;0
412;15464;32;89;36;2;34;.944;3900000;0
412;16006;32;0;0;0;0;.00nan;0;0
412;25843;21;0;0;0;0;.00nan;0;0
413;2423;15;0;0;0;0;.00nan;0;0
413;4106;15;79;32;2;30;.938;3553000;0
413;27739;22;0;0;0;0;.00nan;0;0
413;28026;22;84;26;1;25;.962;3600000;0
414;323;9;80;40;4;36;.900;3889000;0
414;1614;25;0;0;0;0;.00nan;0;0
414;5182;25;49;35;5;30;.857;3889000;0
414;20853;9;0;0;0;0;.00nan;0;0
415;61;31;0;0;0;0;.00nan;0;0
415;22601;26;0;0;0;0;.00nan;0;0
415;32754;26;63;31;4;27;.871;3783000;0
415;34797;31;81;47;5;42;.894;3812000;0
416;335;18;88;40;3;37;.925;3900000;0
416;4506;33;0;0;0;0;.00nan;0;0
416;5001;18;0;0;0;0;.00nan;0;0
416;34740;33;65;30;3;27;.900;3900000;0
417;500;4182;83;36;2;34;.944;3600000;0
417;1251;14;0;0;0;0;.00nan;0;0
417;25521;4182;0;0;0;0;.00nan;0;0
417;25584;14;51;30;4;26;.867;3517000;0
418;5385;17;0;0;0;0;.00nan;0;0
418;27739;22;43;26;4;22;.846;3546000;0
418;28026;22;0;0;0;0;.00nan;0;0
418;34006;17;91;46;3;43;.935;3600000;0
419;1821;3;65;25;3;22;.880;3600000;0
419;2054;3;0;0;0;0;.00nan;0;0
419;15505;8;51;2;0;2;1.000;557000;0
419;25076;8;52;46;7;39;.848;3043000;0
420;2058;28;67;30;3;27;.900;3600000;0
420;7139;29;0;0;0;0;.00nan;0;0
420;14061;28;0;0;0;0;.00nan;0;0
420;18351;29;29;15;4;11;.733;3568000;0
421;51;21;0;0;0;0;.00nan;0;0
421;928;20;0;0;0;0;.00nan;0;0
421;18078;20;48;40;6;34;.850;3600000;0
421;25843;21;85;34;2;32;.941;3600000;0
422;1913;30;0;0;0;0;.00nan;0;0
422;2423;15;100;26;0;26;1.000;3600000;0
422;4106;15;0;0;0;0;.00nan;0;0
422;4826;30;77;46;5;41;.891;3600000;0
423;1074;0;74;30;3;27;.900;3553000;0
423;1796;16;0;0;0;0;.00nan;0;0
423;15437;16;94;30;1;29;.967;3600000;0
423;31035;0;0;0;0;0;.00nan;0;0
424;544;19;79;37;2;35;.946;3600000;0
424;4450;5;0;0;0;0;.00nan;0;0
424;19823;5;50;19;3;16;.842;3563000;0
424;31124;19;0;0;0;0;.00nan;0;0
425;823;23;0;0;0;0;.00nan;0;0
425;10103;24;70;29;3;26;.897;3547000;0
425;10274;23;87;43;2;41;.953;3600000;0
425;13979;24;0;0;0;0;.00nan;0;0
426;1251;14;67;28;3;25;.893;3600000;0
426;22601;26;63;42;5;37;.881;3564000;0
426;25584;14;0;0;0;0;.00nan;0;0
426;32754;26;0;0;0;0;.00nan;0;0
427;262;35;80;29;1;28;.966;3900000;0
427;724;11;0;0;0;0;.00nan;0;0
427;1430;35;0;0;0;0;.00nan;0;0
427;21522;11;100;42;1;41;.976;3900000;0
428;445;12;69;17;1;16;.941;3600000;0
428;738;27;0;0;0;0;.00nan;0;0
428;26623;27;75;40;3;37;.925;3600000;0
428;34786;12;0;0;0;0;.00nan;0;0
429;1572;4838;0;0;0;0;.00nan;0;0
429;2328;4838;50;25;4;21;.840;3900000;0
429;13842;34;66;48;4;44;.917;3900000;0
429;15502;34;0;0;0;0;.00nan;0;0
430;15464;32;82;34;2;32;.941;3543000;0
430;16006;32;0;0;0;0;.00nan;0;0
430;18104;10;0;0;0;0;.00nan;0;0
430;27488;10;76;22;1;21;.955;3600000;0
431;1796;16;64;18;2;16;.889;3600000;0
431;1913;30;42;36;6;30;.833;3600000;0
431;4826;30;0;0;0;0;.00nan;0;0
431;15437;16;0;0;0;0;.00nan;0;0
432;61;31;70;34;3;31;.912;3550000;0
432;1614;25;71;32;2;30;.938;3600000;0
432;5182;25;0;0;0;0;.00nan;0;0
432;34797;31;0;0;0;0;.00nan;0;0
433;335;18;0;0;0;0;.00nan;0;0
433;5001;18;95;43;2;41;.953;3600000;0
433;10103;24;0;0;0;0;.00nan;0;0
433;13979;24;48;28;4;24;.857;3566000;0
434;262;35;0;0;0;0;.00nan;0;0
434;500;4182;0;0;0;0;.00nan;0;0
434;1430;35;82;27;1;26;.963;3600000;0
434;25521;4182;47;20;3;17;.850;3581000;0
435;544;19;63;26;2;24;.923;3900000;0
435;15505;8;0;0;0;0;.00nan;0;0
435;25076;8;92;38;2;36;.947;3900000;0
435;31124;19;0;0;0;0;.00nan;0;0
436;500;4182;0;0;0;0;.00nan;0;0
436;4450;5;62;32;4;28;.875;3581000;0
436;19823;5;0;0;0;0;.00nan;0;0
436;25521;4182;81;26;2;24;.923;3600000;0
437;323;9;57;30;4;26;.867;3600000;0
437;928;20;0;0;0;0;.00nan;0;0
437;18078;20;71;24;2;22;.917;3600000;0
437;20853;9;0;0;0;0;.00nan;0;0
438;233;29;60;22;2;20;.909;3600000;0
438;724;11;32;14;4;10;.714;1177000;0
438;18351;29;0;0;0;0;.00nan;0;0
438;21522;11;19;29;7;22;.759;2423000;0
439;61;31;100;42;1;41;.976;3600000;0
439;2058;28;32;34;8;26;.765;3142000;0
439;14061;28;49;1;0;1;1.000;458000;0
439;34797;31;0;0;0;0;.00nan;0;0
440;51;21;0;0;0;0;.00nan;0;0
440;1251;14;0;0;0;0;.00nan;0;0
440;25584;14;86;17;0;17;1.000;3600000;0
440;25843;21;62;35;4;31;.886;3600000;0
441;1074;0;72;41;5;36;.878;3562000;0
441;2423;15;72;30;3;27;.900;3600000;0
441;4106;15;0;0;0;0;.00nan;0;0
441;31035;0;0;0;0;0;.00nan;0;0
442;544;19;0;0;0;0;.00nan;0;0
442;15464;32;78;27;2;25;.926;3600000;0
442;16006;32;0;0;0;0;.00nan;0;0
442;31124;19;23;20;5;15;.750;3600000;0
443;445;12;57;35;5;30;.857;3600000;0
443;1796;16;84;34;2;32;.941;3600000;0
443;15437;16;0;0;0;0;.00nan;0;0
443;34786;12;0;0;0;0;.00nan;0;0
444;262;35;0;0;0;0;.00nan;0;0
444;1430;35;78;34;3;31;.912;3596000;0
444;10103;24;87;39;2;37;.949;3600000;0
444;13979;24;0;0;0;0;.00nan;0;0
445;4506;33;80;26;1;25;.962;3600000;0
445;5385;17;0;0;0;0;.00nan;0;0
445;34006;17;74;34;3;31;.912;3595000;0
445;34740;33;0;0;0;0;.00nan;0;0
446;1614;25;85;40;2;38;.950;3600000;0
446;5182;25;0;0;0;0;.00nan;0;0
446;18104;10;0;0;0;0;.00nan;0;0
446;27488;10;46;29;4;25;.862;3557000;0
447;823;23;0;0;0;0;.00nan;0;0
447;1821;3;44;24;4;20;.833;3544000;0
447;2054;3;0;0;0;0;.00nan;0;0
447;10274;23;86;41;3;38;.927;3600000;0
448;335;18;50;22;3;19;.864;3600000;0
448;5001;18;0;0;0;0;.00nan;0;0
448;13842;34;76;46;6;40;.870;3558000;0
448;15502;34;0;0;0;0;.00nan;0;0
449;738;27;0;0;0;0;.00nan;0;0
449;1572;4838;79;33;2;31;.939;2483000;0
449;2328;4838;26;13;4;9;.692;1117000;0
449;26623;27;81;26;1;25;.962;3600000;0
450;15505;8;48;21;3;18;.857;3584000;0
450;25076;8;0;0;0;0;.00nan;0;0
450;27739;22;90;32;1;31;.969;3600000;0
450;28026;22;0;0;0;0;.00nan;0;0
451;18104;10;61;21;2;19;.905;3600000;0
451;22601;26;0;0;0;0;.00nan;0;0
451;27488;10;0;0;0;0;.00nan;0;0
451;32754;26;83;44;4;40;.909;3520000;0
452;1572;4838;0;0;0;0;.00nan;0;0
452;1913;30;0;0;0;0;.00nan;0;0
452;2328;4838;93;18;0;18;1.000;3600000;0
452;4826;30;69;30;4;26;.867;3600000;0
453;1074;0;100;28;0;28;1.000;3600000;0
453;1251;14;0;0;0;0;.00nan;0;0
453;25584;14;70;22;1;21;.955;3543000;0
453;31035;0;0;0;0;0;.00nan;0;0
454;233;29;72;32;3;29;.906;3511000;0
454;2058;28;0;0;0;0;.00nan;0;0
454;14061;28;99;33;1;32;.970;3600000;0
454;18351;29;0;0;0;0;.00nan;0;0
455;61;31;0;0;0;0;.00nan;0;0
455;724;11;79;35;3;32;.914;3600000;0
455;21522;11;0;0;0;0;.00nan;0;0
455;34797;31;79;29;2;27;.931;3600000;0
456;51;21;57;34;4;30;.882;3521000;0
456;500;4182;71;26;2;24;.923;3600000;0
456;25521;4182;0;0;0;0;.00nan;0;0
456;25843;21;0;0;0;0;.00nan;0;0
457;928;20;0;0;0;0;.00nan;0;0
457;4450;5;54;24;3;21;.875;3600000;0
457;18078;20;67;43;4;39;.907;3561000;0
457;19823;5;0;0;0;0;.00nan;0;0
458;323;9;99;45;2;43;.956;3900000;0
458;10103;24;84;29;2;27;.931;3900000;0
458;13979;24;0;0;0;0;.00nan;0;0
458;20853;9;0;0;0;0;.00nan;0;0
459;1614;25;0;0;0;0;.00nan;0;0
459;5182;25;84;30;1;29;.967;3600000;0
459;15464;32;71;25;2;23;.920;3546000;0
459;16006;32;0;0;0;0;.00nan;0;0
460;262;35;0;0;0;0;.00nan;0;0
460;1430;35;100;29;0;29;1.000;3600000;0
460;5385;17;0;0;0;0;.00nan;0;0
460;34006;17;88;43;3;40;.930;3600000;0
461;544;19;59;32;4;28;.875;3600000;0
461;1821;3;85;30;2;28;.933;3600000;0
461;2054;3;0;0;0;0;.00nan;0;0
461;31124;19;0;0;0;0;.00nan;0;0
462;823;23;0;0;0;0;.00nan;0;0
462;10274;23;67;41;5;36;.878;3600000;0
462;13842;34;37;40;7;33;.825;3342000;0
462;15502;34;50;2;0;2;1.000;212000;0
463;335;18;50;1;0;1;1.000;261000;0
463;738;27;0;0;0;0;.00nan;0;0
463;5001;18;37;32;6;26;.813;3339000;0
463;26623;27;59;36;4;32;.889;3600000;0
464;500;4182;0;0;0;0;.00nan;0;0
464;18104;10;0;0;0;0;.00nan;0;0
464;25521;4182;60;30;3;27;.900;3600000;0
464;27488;10;76;28;2;26;.929;3600000;0
465;2423;15;0;0;0;0;.00nan;0;0
465;4106;15;78;39;4;35;.897;3900000;0
465;5385;17;80;44;4;40;.909;3900000;0
465;34006;17;0;0;0;0;.00nan;0;0
466;15464;32;73;28;2;26;.929;3600000;0
466;15505;8;0;0;0;0;.00nan;0;0
466;16006;32;0;0;0;0;.00nan;0;0
466;25076;8;53;29;4;25;.862;3550000;0
467;445;12;65;45;5;40;.889;3600000;0
467;1796;16;80;23;1;22;.957;3600000;0
467;15437;16;0;0;0;0;.00nan;0;0
467;34786;12;0;0;0;0;.00nan;0;0
468;4506;33;100;39;1;38;.974;3600000;0
468;27739;22;64;23;2;21;.913;3600000;0
468;28026;22;0;0;0;0;.00nan;0;0
468;34740;33;0;0;0;0;.00nan;0;0
469;1913;30;88;34;1;33;.971;3600000;0
469;4826;30;0;0;0;0;.00nan;0;0
469;22601;26;0;0;0;0;.00nan;0;0
469;32754;26;30;23;5;18;.783;3600000;0
470;1074;0;86;38;2;36;.947;3581000;0
470;4450;5;0;0;0;0;.00nan;0;0
470;19823;5;78;22;1;21;.955;3600000;0
470;31035;0;0;0;0;0;.00nan;0;0
471;51;21;41;28;4;24;.857;3546000;0
471;323;9;0;0;0;0;.00nan;0;0
471;20853;9;76;36;3;33;.917;3600000;0
471;25843;21;0;0;0;0;.00nan;0;0
472;1251;14;0;0;0;0;.00nan;0;0
472;2058;28;76;41;4;37;.902;3600000;0
472;14061;28;0;0;0;0;.00nan;0;0
472;25584;14;68;21;1;20;.952;3600000;0
473;724;11;87;48;4;44;.917;3558000;0
473;10103;24;0;0;0;0;.00nan;0;0
473;13979;24;68;29;3;26;.897;3600000;0
473;21522;11;0;0;0;0;.00nan;0;0
474;445;12;87;34;2;32;.941;3600000;0
474;15505;8;60;31;4;27;.871;2371000;0
474;25076;8;44;16;3;13;.813;1229000;0
474;34786;12;0;0;0;0;.00nan;0;0
475;61;31;60;31;4;27;.871;3554000;0
475;262;35;0;0;0;0;.00nan;0;0
475;1430;35;68;28;3;25;.893;3600000;0
475;34797;31;0;0;0;0;.00nan;0;0
476;233;29;0;0;0;0;.00nan;0;0
476;1614;25;70;31;2;29;.935;3551000;0
476;5182;25;0;0;0;0;.00nan;0;0
476;18351;29;90;40;1;39;.975;3600000;0
477;544;19;78;22;1;21;.955;3600000;0
477;13842;34;64;43;5;38;.884;3600000;0
477;15502;34;0;0;0;0;.00nan;0;0
477;31124;19;0;0;0;0;.00nan;0;0
478;335;18;0;0;0;0;.00nan;0;0
478;1821;3;63;41;5;36;.878;3560000;0
478;2054;3;0;0;0;0;.00nan;0;0
478;5001;18;76;38;3;35;.921;3600000;0
479;823;23;0;0;0;0;.00nan;0;0
479;1572;4838;0;0;0;0;.00nan;0;0
479;2328;4838;61;25;3;22;.880;3600000;0
479;10274;23;48;28;4;24;.857;3559000;0
480;2058;28;0;0;0;0;.00nan;0;0
480;4450;5;81;24;2;22;.917;3600000;0
480;14061;28;47;30;5;25;.833;3600000;0
480;19823;5;0;0;0;0;.00nan;0;0
481;51;21;0;0;0;0;.00nan;0;0
481;2423;15;70;23;2;21;.913;3600000;0
481;4106;15;0;0;0;0;.00nan;0;0
481;25843;21;68;52;6;46;.885;3600000;0
482;500;4182;100;44;1;43;.977;3900000;0
482;928;20;0;0;0;0;.00nan;0;0
482;18078;20;96;37;1;36;.973;3900000;0
482;25521;4182;0;0;0;0;.00nan;0;0
483;724;11;85;31;2;29;.935;3600000;0
483;4987;22;0;0;0;0;.00nan;0;0
483;21522;11;0;0;0;0;.00nan;0;0
483;28026;22;92;36;1;35;.972;3600000;0
484;10103;24;68;28;2;26;.929;3600000;0
484;13979;24;0;0;0;0;.00nan;0;0
484;15464;32;74;35;3;32;.914;3575000;0
484;16006;32;0;0;0;0;.00nan;0;0
485;1796;16;65;26;3;23;.885;3600000;0
485;4506;33;0;0;0;0;.00nan;0;0
485;15437;16;0;0;0;0;.00nan;0;0
485;34740;33;58;34;4;30;.882;3537000;0
486;335;18;64;37;4;33;.892;3541000;0
486;5001;18;0;0;0;0;.00nan;0;0
486;22601;26;0;0;0;0;.00nan;0;0
486;32754;26;89;34;2;32;.941;3600000;0
487;1572;4838;78;32;3;29;.906;3557000;0
487;1821;3;77;26;2;24;.923;3600000;0
487;2054;3;0;0;0;0;.00nan;0;0
487;2328;4838;0;0;0;0;.00nan;0;0
488;5385;17;0;0;0;0;.00nan;0;0
488;13842;34;88;28;1;27;.964;3600000;0
488;15502;34;0;0;0;0;.00nan;0;0
488;34006;17;82;40;3;37;.925;3594000;0
489;323;9;70;39;4;35;.897;3563000;0
489;1614;25;43;18;3;15;.833;3600000;0
489;5182;25;0;0;0;0;.00nan;0;0
489;20853;9;0;0;0;0;.00nan;0;0
490;928;20;65;37;4;33;.892;3600000;0
490;1074;0;100;36;1;35;.972;3600000;0
490;18078;20;0;0;0;0;.00nan;0;0
490;31035;0;0;0;0;0;.00nan;0;0
491;262;35;0;0;0;0;.00nan;0;0
491;445;12;99;30;1;29;.967;3600000;0
491;1430;35;49;32;4;28;.875;3600000;0
491;34786;12;0;0;0;0;.00nan;0;0
492;823;23;0;0;0;0;.00nan;0;0
492;1913;30;0;0;0;0;.00nan;0;0
492;4826;30;41;23;4;19;.826;3533000;0
492;10274;23;100;38;2;36;.947;3600000;0
493;4450;5;0;0;0;0;.00nan;0;0
493;10103;24;84;40;4;36;.900;3597000;0
493;13979;24;0;0;0;0;.00nan;0;0
493;19823;5;95;39;2;37;.949;3600000;0
494;1796;16;69;28;3;25;.893;3719000;0
494;2058;28;58;31;4;27;.871;3719000;0
494;14061;28;0;0;0;0;.00nan;0;0
494;15437;16;0;0;0;0;.00nan;0;0
495;1251;14;0;0;0;0;.00nan;0;0
495;4987;22;0;0;0;0;.00nan;0;0
495;25584;14;72;28;2;26;.929;3544000;0
495;28026;22;93;20;0;20;1.000;3600000;0
496;51;21;0;0;0;0;.00nan;0;0
496;2423;15;61;25;2;23;.920;3600000;0
496;4106;15;0;0;0;0;.00nan;0;0
496;25843;21;67;50;6;44;.880;3600000;0
497;61;31;71;28;2;26;.929;3600000;0
497;15505;8;0;0;0;0;.00nan;0;0
497;25076;8;57;28;3;25;.893;3585000;0
497;34797;31;0;0;0;0;.00nan;0;0
498;4506;33;0;0;0;0;.00nan;0;0
498;15464;32;0;0;0;0;.00nan;0;0
498;16006;32;93;38;2;36;.947;3600000;0
498;34740;33;51;25;4;21;.840;3538000;0
499;544;19;0;0;0;0;.00nan;0;0
499;1913;30;90;64;4;60;.938;3600000;0
499;4826;30;0;0;0;0;.00nan;0;0
499;31124;19;76;12;0;12;1.000;3600000;0
500;233;29;0;0;0;0;.00nan;0;0
500;500;4182;61;26;2;24;.923;3600000;0
500;18351;29;89;36;3;33;.917;3560000;0
500;25521;4182;0;0;0;0;.00nan;0;0
501;335;18;0;0;0;0;.00nan;0;0
501;738;27;0;0;0;0;.00nan;0;0
501;5001;18;56;30;3;27;.900;3900000;0
501;26623;27;70;31;3;28;.903;3900000;0
502;1572;4838;66;42;4;38;.905;3832000;0
502;2328;4838;0;0;0;0;.00nan;0;0
502;22601;26;0;0;0;0;.00nan;0;0
502;32754;26;67;32;3;29;.906;3832000;0
503;1614;25;65;31;3;28;.903;3600000;0
503;5182;25;0;0;0;0;.00nan;0;0
503;5385;17;0;0;0;0;.00nan;0;0
503;34006;17;80;47;4;43;.915;3543000;0
504;1074;0;38;49;9;40;.816;3328000;0
504;18104;10;0;0;0;0;.00nan;0;0
504;27488;10;70;25;2;23;.920;3600000;0
504;31035;0;52;3;0;3;1.000;272000;0
505;445;12;100;25;0;25;1.000;3600000;0
505;4506;33;95;49;3;46;.939;3600000;0
505;34740;33;0;0;0;0;.00nan;0;0
505;34786;12;0;0;0;0;.00nan;0;0
506;724;11;0;0;0;0;.00nan;0;0
506;823;23;0;0;0;0;.00nan;0;0
506;10274;23;61;33;4;29;.879;3584000;0
506;21522;11;65;19;2;17;.895;3600000;0
507;1614;25;0;0;0;0;.00nan;0;0
507;4450;5;0;0;0;0;.00nan;0;0
507;5182;25;36;31;6;25;.806;3591000;0
507;19823;5;42;19;4;15;.789;3600000;0
508;1796;16;51;30;4;26;.867;3600000;0
508;1821;3;0;0;0;0;.00nan;0;0
508;2054;3;98;43;3;40;.930;3600000;0
508;15437;16;0;0;0;0;.00nan;0;0
509;2058;28;51;24;4;20;.833;3728000;0
509;10103;24;0;0;0;0;.00nan;0;0
509;13979;24;86;38;3;35;.921;3732000;0
509;14061;28;0;0;0;0;.00nan;0;0
510;61;31;0;0;0;0;.00nan;0;0
510;15464;32;67;30;3;27;.900;3531000;0
510;16006;32;0;0;0;0;.00nan;0;0
510;34797;31;99;33;1;32;.970;3600000;0
511;51;21;0;0;0;0;.00nan;0;0
511;1074;0;76;33;4;29;.879;3600000;0
511;25843;21;42;32;5;27;.844;3545000;0
511;31035;0;0;0;0;0;.00nan;0;0
512;928;20;0;0;0;0;.00nan;0;0
512;4987;22;0;0;0;0;.00nan;0;0
512;18078;20;81;27;1;26;.963;3900000;0
512;28026;22;78;22;1;21;.955;3900000;0
513;1251;14;98;33;1;32;.970;3062000;0
513;2423;15;85;28;1;27;.964;3600000;0
513;4106;15;0;0;0;0;.00nan;0;0
513;25584;14;35;11;3;8;.727;538000;0
514;5385;17;75;37;4;33;.892;3600000;0
514;13842;34;39;28;5;23;.821;3552000;0
514;15502;34;0;0;0;0;.00nan;0;0
514;34006;17;0;0;0;0;.00nan;0;0
515;445;12;38;34;6;28;.824;3600000;0
515;15505;8;0;0;0;0;.00nan;0;0
515;25076;8;78;28;2;26;.929;3600000;0
515;34786;12;0;0;0;0;.00nan;0;0
516;262;35;0;0;0;0;.00nan;0;0
516;323;9;72;38;4;34;.895;3788000;0
516;1430;35;77;36;3;33;.917;3788000;0
516;20853;9;0;0;0;0;.00nan;0;0
517;544;19;0;0;0;0;.00nan;0;0
517;1572;4838;0;0;0;0;.00nan;0;0
517;2328;4838;100;24;0;24;1.000;3600000;0
517;31124;19;68;32;3;29;.906;3600000;0
518;233;29;85;27;1;26;.963;3600000;0
518;18351;29;0;0;0;0;.00nan;0;0
518;22601;26;62;34;4;30;.882;3600000;0
518;32754;26;0;0;0;0;.00nan;0;0
519;335;18;0;0;0;0;.00nan;0;0
519;1913;30;51;2;0;2;1.000;252000;0
519;4826;30;34;38;8;30;.789;3348000;0
519;5001;18;74;22;1;21;.955;3600000;0
520;500;4182;38;29;5;24;.828;3544000;0
520;724;11;74;35;4;31;.886;3600000;0
520;21522;11;0;0;0;0;.00nan;0;0
520;25521;4182;0;0;0;0;.00nan;0;0
521;738;27;0;0;0;0;.00nan;0;0
521;823;23;89;39;3;36;.923;3900000;0
521;10274;23;0;0;0;0;.00nan;0;0
521;26623;27;65;26;3;23;.885;3900000;0
522;2423;15;0;0;0;0;.00nan;0;0
522;4106;15;87;32;1;31;.969;3600000;0
522;4450;5;46;24;4;20;.833;2427000;0
522;19823;5;35;17;4;13;.765;1173000;0
523;928;20;0;0;0;0;.00nan;0;0
523;5385;17;0;0;0;0;.00nan;0;0
523;18078;20;99;23;0;23;1.000;3600000;0
523;34006;17;98;38;1;37;.974;3594000;0
524;323;9;56;37;5;32;.865;3600000;0
524;18104;10;0;0;0;0;.00nan;0;0
524;20853;9;0;0;0;0;.00nan;0;0
524;27488;10;89;31;1;30;.968;3600000;0
525;2058;28;0;0;0;0;.00nan;0;0
525;14061;28;71;38;4;34;.895;3649000;0
525;27739;22;0;0;0;0;.00nan;0;0
525;28026;22;41;27;5;22;.815;3649000;0
526;61;31;0;0;0;0;.00nan;0;0
526;10103;24;65;30;3;27;.900;3600000;0
526;13979;24;0;0;0;0;.00nan;0;0
526;34797;31;100;23;0;23;1.000;3600000;0
527;1821;3;82;37;2;35;.946;3600000;0
527;2054;3;0;0;0;0;.00nan;0;0
527;13842;34;56;43;6;37;.860;3600000;0
527;15502;34;0;0;0;0;.00nan;0;0
528;51;21;86;30;1;29;.967;3600000;0
528;1796;16;0;0;0;0;.00nan;0;0
528;15437;16;67;26;2;24;.923;3548000;0
528;25843;21;0;0;0;0;.00nan;0;0
529;445;12;72;36;4;32;.889;3900000;0
529;15464;32;50;28;4;24;.857;3900000;0
529;16006;32;0;0;0;0;.00nan;0;0
529;34786;12;0;0;0;0;.00nan;0;0
530;262;35;0;0;0;0;.00nan;0;0
530;1430;35;67;31;3;28;.903;3545000;0
530;4506;33;65;23;2;21;.913;3600000;0
530;34740;33;0;0;0;0;.00nan;0;0
531;544;19;0;0;0;0;.00nan;0;0
531;823;23;0;0;0;0;.00nan;0;0
531;10274;23;67;31;3;28;.903;3600000;0
531;31124;19;53;37;5;32;.865;3600000;0
532;724;11;64;23;2;21;.913;3900000;0
532;21522;11;0;0;0;0;.00nan;0;0
532;22601;26;94;34;2;32;.941;3900000;0
532;32754;26;0;0;0;0;.00nan;0;0
533;335;18;0;0;0;0;.00nan;0;0
533;1572;4838;0;0;0;0;.00nan;0;0
533;2328;4838;70;32;3;29;.906;3900000;0
533;5001;18;62;24;3;21;.875;3900000;0
534;500;4182;100;33;0;33;1.000;3600000;0
534;1614;25;50;30;4;26;.867;3600000;0
534;5182;25;0;0;0;0;.00nan;0;0
534;25521;4182;0;0;0;0;.00nan;0;0
535;738;27;0;0;0;0;.00nan;0;0
535;1913;30;72;29;2;27;.931;3568000;0
535;4826;30;0;0;0;0;.00nan;0;0
535;26623;27;100;26;0;26;1.000;3600000;0
536;233;29;62;19;2;17;.895;3600000;0
536;1074;0;67;39;5;34;.872;3600000;0
536;18351;29;0;0;0;0;.00nan;0;0
536;31035;0;0;0;0;0;.00nan;0;0
537;13842;34;0;0;0;0;.00nan;0;0
537;15502;34;85;38;3;35;.921;3600000;0
537;15505;8;56;37;5;32;.865;3530000;0
537;25076;8;0;0;0;0;.00nan;0;0
538;500;4182;46;19;3;16;.842;3555000;0
538;724;11;0;0;0;0;.00nan;0;0
538;21522;11;99;45;2;43;.956;3600000;0
538;25521;4182;0;0;0;0;.00nan;0;0
539;738;27;0;0;0;0;.00nan;0;0
539;22601;26;53;15;2;13;.867;1226000;0
539;26623;27;81;15;0;15;1.000;3600000;0
539;32754;26;37;30;6;24;.800;2374000;0
540;51;21;0;0;0;0;.00nan;0;0
540;5385;17;0;0;0;0;.00nan;0;0
540;25843;21;97;41;1;40;.976;3900000;0
540;34006;17;100;46;1;45;.978;3900000;0
541;1821;3;80;28;2;26;.929;3600000;0
541;2054;3;0;0;0;0;.00nan;0;0
541;2423;15;86;35;3;32;.914;3558000;0
541;4106;15;0;0;0;0;.00nan;0;0
542;2058;28;100;29;0;29;1.000;3600000;0
542;4450;5;75;24;2;22;.917;3570000;0
542;14061;28;0;0;0;0;.00nan;0;0
542;19823;5;0;0;0;0;.00nan;0;0
543;61;31;0;0;0;0;.00nan;0;0
543;18104;10;0;0;0;0;.00nan;0;0
543;27488;10;70;24;2;22;.917;3600000;0
543;34797;31;27;31;6;25;.806;3600000;0
544;323;9;0;0;0;0;.00nan;0;0
544;928;20;0;0;0;0;.00nan;0;0
544;18078;20;75;26;2;24;.923;3600000;0
544;20853;9;63;26;3;23;.885;3548000;0
545;15464;32;31;18;4;14;.778;3600000;0
545;16006;32;0;0;0;0;.00nan;0;0
545;27739;22;0;0;0;0;.00nan;0;0
545;28026;22;64;40;5;35;.875;3600000;0
546;823;23;0;0;0;0;.00nan;0;0
546;1796;16;60;19;2;17;.895;3600000;0
546;10274;23;98;53;4;49;.925;3600000;0
546;15437;16;0;0;0;0;.00nan;0;0
547;4506;33;69;27;3;24;.889;3600000;0
547;15505;8;0;0;0;0;.00nan;0;0
547;25076;8;42;42;6;36;.857;3600000;0
547;34740;33;0;0;0;0;.00nan;0;0
548;445;12;62;36;4;32;.889;3600000;0
548;1614;25;46;33;5;28;.848;3565000;0
548;5182;25;0;0;0;0;.00nan;0;0
548;34786;12;0;0;0;0;.00nan;0;0
549;335;18;0;0;0;0;.00nan;0;0
549;1913;30;80;44;3;41;.932;3566000;0
549;4826;30;0;0;0;0;.00nan;0;0
549;5001;18;83;23;2;21;.913;3600000;0
550;1251;14;0;0;0;0;.00nan;0;0
550;1572;4838;0;0;0;0;.00nan;0;0
550;2328;4838;91;31;1;30;.968;3600000;0
550;25584;14;62;26;3;23;.885;3600000;0
551;61;31;98;39;2;37;.949;3600000;0
551;233;29;0;0;0;0;.00nan;0;0
551;18351;29;51;23;3;20;.870;3560000;0
551;34797;31;0;0;0;0;.00nan;0;0
552;928;20;60;35;4;31;.886;3900000;0
552;5385;17;87;49;4;45;.918;3900000;0
552;18078;20;0;0;0;0;.00nan;0;0
552;34006;17;0;0;0;0;.00nan;0;0
553;1074;0;97;36;2;34;.944;3600000;0
553;10103;24;0;0;0;0;.00nan;0;0
553;13979;24;82;44;3;41;.932;3552000;0
553;31035;0;0;0;0;0;.00nan;0;0
554;13842;34;88;35;2;33;.943;3900000;0
554;15464;32;69;25;2;23;.920;3900000;0
554;15502;34;0;0;0;0;.00nan;0;0
554;16006;32;0;0;0;0;.00nan;0;0
555;335;18;62;40;6;34;.850;2638000;0
555;724;11;0;0;0;0;.00nan;0;0
555;5001;18;71;11;0;11;1.000;1262000;0
555;21522;11;65;45;6;39;.867;3900000;0
556;738;27;0;0;0;0;.00nan;0;0
556;1251;14;74;31;3;28;.903;3704000;0
556;25584;14;0;0;0;0;.00nan;0;0
556;26623;27;85;31;2;29;.935;3704000;0
557;544;19;64;21;2;19;.905;3726000;0
557;1572;4838;65;35;3;32;.914;3766000;0
557;2328;4838;0;0;0;0;.00nan;0;0
557;31124;19;0;0;0;0;.00nan;0;0
558;2058;28;75;38;4;34;.895;3600000;0
558;2423;15;95;37;1;36;.973;3600000;0
558;4106;15;0;0;0;0;.00nan;0;0
558;14061;28;0;0;0;0;.00nan;0;0
559;323;9;67;22;2;20;.909;3900000;0
559;20853;9;0;0;0;0;.00nan;0;0
559;27739;22;94;44;2;42;.955;3900000;0
559;28026;22;0;0;0;0;.00nan;0;0
560;233;29;69;29;2;27;.931;3552000;0
560;18104;10;0;0;0;0;.00nan;0;0
560;18351;29;0;0;0;0;.00nan;0;0
560;27488;10;80;22;1;21;.955;3600000;0
561;51;21;0;0;0;0;.00nan;0;0
561;823;23;0;0;0;0;.00nan;0;0
561;10274;23;40;31;6;25;.806;3600000;0
561;25843;21;99;43;1;42;.977;3600000;0
562;445;12;0;0;0;0;.00nan;0;0
562;1614;25;0;0;0;0;.00nan;0;0
562;5182;25;63;44;5;39;.886;3600000;0
562;34786;12;73;38;4;34;.895;3600000;0
563;544;19;0;0;0;0;.00nan;0;0
563;4506;33;100;31;0;31;1.000;3600000;0
563;31124;19;35;32;6;26;.813;3600000;0
563;34740;33;0;0;0;0;.00nan;0;0
564;500;4182;0;0;0;0;.00nan;0;0
564;1913;30;0;0;0;0;.00nan;0;0
564;4826;30;62;38;5;33;.868;3600000;0
564;25521;4182;41;23;4;19;.826;3600000;0
565;4450;5;0;0;0;0;.00nan;0;0
565;5385;17;87;33;2;31;.939;3600000;0
565;19823;5;89;17;0;17;1.000;3600000;0
565;34006;17;0;0;0;0;.00nan;0;0
566;1821;3;82;35;3;32;.914;3600000;0
566;2054;3;0;0;0;0;.00nan;0;0
566;2058;28;27;16;4;12;.750;1149000;0
566;14061;28;79;22;1;21;.955;2428000;0
567;61;31;0;0;0;0;.00nan;0;0
567;1074;0;22;9;4;5;.556;616000;0
567;31035;0;83;40;3;37;.925;2984000;0
567;34797;31;71;20;1;19;.950;3600000;0
568;823;23;99;45;3;42;.933;3600000;0
568;928;20;0;0;0;0;.00nan;0;0
568;10274;23;0;0;0;0;.00nan;0;0
568;18078;20;58;33;4;29;.879;3576000;0
569;10103;24;0;0;0;0;.00nan;0;0
569;13842;34;75;37;4;33;.892;3900000;0
569;13979;24;63;29;4;25;.862;3900000;0
569;15502;34;0;0;0;0;.00nan;0;0
570;15464;32;0;0;0;0;.00nan;0;0
570;15505;8;0;0;0;0;.00nan;0;0
570;16006;32;76;19;1;18;.947;3600000;0
570;25076;8;70;29;2;27;.931;3560000;0
571;262;35;0;0;0;0;.00nan;0;0
571;1430;35;96;51;2;49;.961;3900000;0
571;1796;16;71;25;2;23;.920;3900000;0
571;15437;16;0;0;0;0;.00nan;0;0
572;724;11;90;36;2;34;.944;3600000;0
572;1251;14;62;28;3;25;.893;3555000;0
572;21522;11;0;0;0;0;.00nan;0;0
572;25584;14;0;0;0;0;.00nan;0;0
573;335;18;0;0;0;0;.00nan;0;0
573;1572;4838;0;0;0;0;.00nan;0;0
573;2328;4838;78;34;2;32;.941;3600000;0
573;5001;18;47;19;3;16;.842;3573000;0
574;323;9;60;28;3;25;.893;2493000;0
574;4450;5;57;20;2;18;.900;3600000;0
574;19823;5;0;0;0;0;.00nan;0;0
574;20853;9;34;21;4;17;.810;1107000;0
575;233;29;81;38;3;35;.921;3900000;0
575;18104;10;0;0;0;0;.00nan;0;0
575;18351;29;0;0;0;0;.00nan;0;0
575;27488;10;66;32;3;29;.906;3900000;0
576;738;27;0;0;0;0;.00nan;0;0
576;2423;15;84;31;1;30;.968;3600000;0
576;4106;15;0;0;0;0;.00nan;0;0
576;26623;27;71;46;4;42;.913;3600000;0
577;51;21;44;37;6;31;.838;3210000;0
577;25843;21;43;4;1;3;.750;390000;0
577;27739;22;0;0;0;0;.00nan;0;0
577;28026;22;79;23;1;22;.957;3600000;0
578;544;19;0;0;0;0;.00nan;0;0
578;15505;8;83;35;2;33;.943;3887000;0
578;25076;8;0;0;0;0;.00nan;0;0
578;31124;19;67;31;3;28;.903;3887000;0
579;1614;25;33;25;5;20;.800;3600000;0
579;1913;30;100;48;2;46;.958;3600000;0
579;4826;30;0;0;0;0;.00nan;0;0
579;5182;25;0;0;0;0;.00nan;0;0
580;445;12;62;31;4;27;.871;3600000;0
580;22601;26;0;0;0;0;.00nan;0;0
580;32754;26;6;44;11;33;.750;3600000;0
580;34786;12;0;0;0;0;.00nan;0;0
581;500;4182;79;38;4;34;.895;3600000;0
581;4506;33;100;29;0;29;1.000;3600000;0
581;25521;4182;0;0;0;0;.00nan;0;0
581;34740;33;0;0;0;0;.00nan;0;0
582;1821;3;81;26;1;25;.962;3600000;0
582;2054;3;0;0;0;0;.00nan;0;0
582;10103;24;0;0;0;0;.00nan;0;0
582;13979;24;88;42;3;39;.929;3536000;0
583;262;35;0;0;0;0;.00nan;0;0
583;1430;35;88;31;3;28;.903;3900000;0
583;2058;28;46;24;3;21;.875;3900000;0
583;14061;28;0;0;0;0;.00nan;0;0
584;823;23;0;0;0;0;.00nan;0;0
584;10274;23;80;32;2;30;.938;3600000;0
584;18104;10;40;34;6;28;.824;3306000;0
584;27488;10;48;0;0;0;.00nan;294000;0
585;51;21;94;41;3;38;.927;3600000;0
585;4450;5;76;46;4;42;.913;3571000;0
585;19823;5;0;0;0;0;.00nan;0;0
585;25843;21;0;0;0;0;.00nan;0;0
586;1074;0;71;42;5;37;.881;3600000;0
586;27739;22;0;0;0;0;.00nan;0;0
586;28026;22;85;28;1;27;.964;3600000;0
586;31035;0;0;0;0;0;.00nan;0;0
587;323;9;90;34;2;32;.941;3600000;0
587;738;27;0;0;0;0;.00nan;0;0
587;20853;9;0;0;0;0;.00nan;0;0
587;26623;27;100;43;1;42;.977;3600000;0
588;61;31;0;0;0;0;.00nan;0;0
588;544;19;0;0;0;0;.00nan;0;0
588;31124;19;77;25;1;24;.960;3600000;0
588;34797;31;58;26;3;23;.885;3521000;0
589;233;29;82;27;1;26;.963;3600000;0
589;13842;34;91;46;3;43;.935;3584000;0
589;15502;34;0;0;0;0;.00nan;0;0
589;18351;29;0;0;0;0;.00nan;0;0
590;1614;25;80;36;3;33;.917;3563000;0
590;5182;25;0;0;0;0;.00nan;0;0
590;15505;8;0;0;0;0;.00nan;0;0
590;25076;8;90;39;2;37;.949;3600000;0
591;4506;33;69;29;3;26;.897;3600000;0
591;22601;26;94;35;2;33;.943;3600000;0
591;32754;26;0;0;0;0;.00nan;0;0
591;34740;33;0;0;0;0;.00nan;0;0
592;500;4182;94;34;1;33;.971;3600000;0
592;15464;32;82;35;2;33;.943;3542000;0
592;16006;32;0;0;0;0;.00nan;0;0
592;25521;4182;0;0;0;0;.00nan;0;0
593;1251;14;0;0;0;0;.00nan;0;0
593;1913;30;91;35;1;34;.971;3600000;0
593;4826;30;0;0;0;0;.00nan;0;0
593;25584;14;48;31;4;27;.871;3600000;0
594;928;20;0;0;0;0;.00nan;0;0
594;1572;4838;0;0;0;0;.00nan;0;0
594;2328;4838;43;27;5;22;.815;3536000;0
594;18078;20;62;25;3;22;.880;3600000;0
595;823;23;95;58;4;54;.931;3900000;0
595;1821;3;49;25;4;21;.840;3900000;0
595;2054;3;0;0;0;0;.00nan;0;0
595;10274;23;0;0;0;0;.00nan;0;0
596;1796;16;71;25;2;23;.920;3900000;0
596;2423;15;92;40;2;38;.950;3893000;0
596;4106;15;0;0;0;0;.00nan;0;0
596;15437;16;0;0;0;0;.00nan;0;0
597;335;18;0;0;0;0;.00nan;0;0
597;928;20;0;0;0;0;.00nan;0;0
597;5001;18;72;21;1;20;.952;3600000;0
597;18078;20;79;40;3;37;.925;3559000;0
598;262;35;75;55;6;49;.891;3600000;0
598;1430;35;0;0;0;0;.00nan;0;0
598;4450;5;0;0;0;0;.00nan;0;0
598;19823;5;46;17;3;14;.824;3600000;0
599;738;27;0;0;0;0;.00nan;0;0
599;5385;17;0;0;0;0;.00nan;0;0
599;26623;27;73;32;4;28;.875;3517000;0
599;34006;17;88;38;2;36;.947;3600000;0
600;1074;0;43;44;7;37;.841;3600000;0
600;1821;3;0;0;0;0;.00nan;0;0
600;2054;3;95;38;2;36;.947;3600000;0
600;31035;0;0;0;0;0;.00nan;0;0
601;233;29;92;37;1;36;.973;3600000;0
601;544;19;38;26;6;20;.769;2521000;0
601;18351;29;0;0;0;0;.00nan;0;0
601;31124;19;41;17;3;14;.824;1079000;0
602;51;21;80;25;1;24;.960;3900000;0
602;13842;34;92;31;1;30;.968;3900000;0
602;15502;34;0;0;0;0;.00nan;0;0
602;25843;21;0;0;0;0;.00nan;0;0
603;1251;14;0;0;0;0;.00nan;0;0
603;2423;15;0;0;0;0;.00nan;0;0
603;4106;15;81;29;1;28;.966;3900000;0
603;25584;14;88;30;1;29;.967;3900000;0
604;61;31;89;14;0;14;1.000;3600000;0
604;445;12;81;36;3;33;.917;3600000;0
604;34786;12;0;0;0;0;.00nan;0;0
604;34797;31;0;0;0;0;.00nan;0;0
605;1614;25;75;27;1;26;.963;3900000;0
605;4506;33;84;24;1;23;.958;3900000;0
605;5182;25;0;0;0;0;.00nan;0;0
605;34740;33;0;0;0;0;.00nan;0;0
606;15505;8;0;0;0;0;.00nan;0;0
606;22601;26;0;0;0;0;.00nan;0;0
606;25076;8;73;37;4;33;.892;3600000;0
606;32754;26;51;33;5;28;.848;3566000;0
607;500;4182;99;34;1;33;.971;3600000;0
607;18104;10;0;0;0;0;.00nan;0;0
607;25521;4182;0;0;0;0;.00nan;0;0
607;27488;10;87;43;4;39;.907;3600000;0
608;323;9;0;0;0;0;.00nan;0;0
608;1913;30;62;28;3;25;.893;3556000;0
608;4826;30;0;0;0;0;.00nan;0;0
608;20853;9;68;23;2;21;.913;3600000;0
609;724;11;0;0;0;0;.00nan;0;0
609;15464;32;47;28;4;24;.857;3593000;0
609;16006;32;0;0;0;0;.00nan;0;0
609;21522;11;77;31;3;28;.903;3600000;0
610;1572;4838;0;0;0;0;.00nan;0;0
610;2058;28;44;30;5;25;.833;3900000;0
610;2328;4838;72;42;5;37;.881;3900000;0
610;14061;28;0;0;0;0;.00nan;0;0
611;544;19;0;0;0;0;.00nan;0;0
611;10103;24;0;0;0;0;.00nan;0;0
611;13979;24;53;33;5;28;.848;3600000;0
611;31124;19;59;19;2;17;.895;3600000;0
612;1796;16;0;0;0;0;.00nan;0;0
612;15437;16;94;32;1;31;.969;3600000;0
612;27739;22;0;0;0;0;.00nan;0;0
612;28026;22;52;29;4;25;.862;3600000;0
613;1074;0;66;28;3;25;.893;3900000;0
613;5385;17;0;0;0;0;.00nan;0;0
613;31035;0;0;0;0;0;.00nan;0;0
613;34006;17;67;29;3;26;.897;3900000;0
614;233;29;62;29;3;26;.897;3558000;0
614;4450;5;88;33;2;31;.939;3600000;0
614;18351;29;0;0;0;0;.00nan;0;0
614;19823;5;0;0;0;0;.00nan;0;0
615;738;27;0;0;0;0;.00nan;0;0
615;1251;14;0;0;0;0;.00nan;0;0
615;25584;14;100;26;0;26;1.000;3600000;0
615;26623;27;57;31;4;27;.871;3600000;0
616;61;31;98;38;1;37;.974;3564000;0
616;10103;24;100;24;0;24;1.000;3600000;0
616;13979;24;0;0;0;0;.00nan;0;0
616;34797;31;0;0;0;0;.00nan;0;0
617;51;21;0;0;0;0;.00nan;0;0
617;13842;34;79;39;4;35;.897;3880000;0
617;15502;34;0;0;0;0;.00nan;0;0
617;25843;21;57;24;3;21;.875;3880000;0
618;445;12;54;39;6;33;.846;3600000;0
618;2423;15;84;26;1;25;.962;3600000;0
618;4106;15;0;0;0;0;.00nan;0;0
618;34786;12;0;0;0;0;.00nan;0;0
619;262;35;0;0;0;0;.00nan;0;0
619;1430;35;97;37;1;36;.973;3900000;0
619;27739;22;100;32;1;31;.969;3900000;0
619;28026;22;0;0;0;0;.00nan;0;0
620;1572;4838;0;0;0;0;.00nan;0;0
620;2328;4838;75;33;3;30;.909;3784000;0
620;4506;33;0;0;0;0;.00nan;0;0
620;34740;33;82;35;2;33;.943;3784000;0
621;1614;25;0;0;0;0;.00nan;0;0
621;1821;3;0;0;0;0;.00nan;0;0
621;2054;3;98;37;2;35;.946;3900000;0
621;5182;25;91;42;2;40;.952;3900000;0
622;823;23;0;0;0;0;.00nan;0;0
622;928;20;0;0;0;0;.00nan;0;0
622;10274;23;99;39;1;38;.974;3600000;0
622;18078;20;52;27;4;23;.852;3600000;0
623;15464;32;97;28;0;28;1.000;3600000;0
623;16006;32;0;0;0;0;.00nan;0;0
623;22601;26;0;0;0;0;.00nan;0;0
623;32754;26;98;41;3;38;.927;3600000;0
624;335;18;0;0;0;0;.00nan;0;0
624;2058;28;84;27;2;25;.926;3600000;0
624;5001;18;71;41;3;38;.927;3600000;0
624;14061;28;0;0;0;0;.00nan;0;0
625;500;4182;73;21;1;20;.952;3600000;0
625;15505;8;73;32;3;29;.906;3584000;0
625;25076;8;0;0;0;0;.00nan;0;0
625;25521;4182;0;0;0;0;.00nan;0;0
626;1913;30;34;31;6;25;.806;1793000;0
626;4826;30;46;14;2;12;.857;1807000;0
626;18104;10;0;0;0;0;.00nan;0;0
626;27488;10;71;26;2;24;.923;3600000;0
627;323;9;86;23;0;23;1.000;1481000;0
627;724;11;100;27;0;27;1.000;3600000;0
627;20853;9;43;24;4;20;.833;2119000;0
627;21522;11;0;0;0;0;.00nan;0;0
628;445;12;81;38;3;35;.921;3600000;0
628;1796;16;66;20;2;18;.900;3600000;0
628;15437;16;0;0;0;0;.00nan;0;0
628;34786;12;0;0;0;0;.00nan;0;0
629;1074;0;74;33;3;30;.909;3590000;0
629;13842;34;66;25;2;23;.920;3600000;0
629;15502;34;0;0;0;0;.00nan;0;0
629;31035;0;0;0;0;0;.00nan;0;0
630;51;21;95;46;3;43;.935;3577000;0
630;233;29;70;21;2;19;.905;3600000;0
630;18351;29;0;0;0;0;.00nan;0;0
630;25843;21;0;0;0;0;.00nan;0;0
631;4450;5;0;0;0;0;.00nan;0;0
631;19823;5;95;33;1;32;.970;3685000;0
631;27739;22;0;0;0;0;.00nan;0;0
631;28026;22;81;31;2;29;.935;3685000;0
632;262;35;83;38;2;36;.947;3600000;0
632;1430;35;0;0;0;0;.00nan;0;0
632;4506;33;78;41;4;37;.902;3579000;0
632;34740;33;0;0;0;0;.00nan;0;0
633;1572;4838;0;0;0;0;.00nan;0;0
633;1614;25;73;28;2;26;.929;3600000;0
633;2328;4838;96;50;3;47;.940;3544000;0
633;5182;25;0;0;0;0;.00nan;0;0
634;823;23;77;33;3;30;.909;3600000;0
634;2058;28;35;24;5;19;.792;2109000;0
634;10274;23;0;0;0;0;.00nan;0;0
634;14061;28;51;10;1;9;.900;1491000;0
635;724;11;93;43;3;40;.930;3600000;0
635;18104;10;0;0;0;0;.00nan;0;0
635;21522;11;0;0;0;0;.00nan;0;0
635;27488;10;87;17;0;17;1.000;3600000;0
636;233;29;0;0;0;0;.00nan;0;0
636;5385;17;23;27;6;21;.778;2006000;0
636;18351;29;83;26;1;25;.962;3600000;0
636;34006;17;34;12;3;9;.750;1594000;0
637;61;31;0;0;0;0;.00nan;0;0
637;335;18;0;0;0;0;.00nan;0;0
637;5001;18;72;25;2;23;.920;3600000;0
637;34797;31;88;43;3;40;.930;3553000;0
638;1251;14;0;0;0;0;.00nan;0;0
638;10103;24;72;36;4;32;.889;3555000;0
638;13979;24;0;0;0;0;.00nan;0;0
638;25584;14;74;38;3;35;.921;3600000;0
639;13842;34;98;38;1;37;.974;3600000;0
639;15502;34;0;0;0;0;.00nan;0;0
639;15505;8;71;35;3;32;.914;3575000;0
639;25076;8;0;0;0;0;.00nan;0;0
640;1614;25;55;20;2;18;.900;3315000;0
640;5182;25;23;5;3;2;.400;585000;0
640;15464;32;71;45;5;40;.889;3900000;0
640;16006;32;0;0;0;0;.00nan;0;0
641;544;19;70;20;2;18;.900;3600000;0
641;928;20;0;0;0;0;.00nan;0;0
641;18078;20;61;29;4;25;.862;3524000;0
641;31124;19;0;0;0;0;.00nan;0;0
642;500;4182;75;38;3;35;.921;3574000;0
642;1821;3;75;30;2;28;.933;3600000;0
642;2054;3;0;0;0;0;.00nan;0;0
642;25521;4182;0;0;0;0;.00nan;0;0
643;1913;30;82;28;2;26;.929;3555000;0
643;2423;15;0;0;0;0;.00nan;0;0
643;4106;15;89;28;1;27;.964;3600000;0
643;4826;30;0;0;0;0;.00nan;0;0
644;323;9;0;0;0;0;.00nan;0;0
644;738;27;0;0;0;0;.00nan;0;0
644;20853;9;63;35;3;32;.914;3593000;0
644;26623;27;66;27;2;25;.926;3600000;0
645;1074;0;96;53;4;49;.925;3590000;0
645;4450;5;0;0;0;0;.00nan;0;0
645;19823;5;48;18;3;15;.833;3600000;0
645;31035;0;0;0;0;0;.00nan;0;0
646;445;12;91;56;5;51;.911;3600000;0
646;1572;4838;0;0;0;0;.00nan;0;0
646;2328;4838;83;23;1;22;.957;3600000;0
646;34786;12;0;0;0;0;.00nan;0;0
647;262;35;0;0;0;0;.00nan;0;0
647;823;23;0;0;0;0;.00nan;0;0
647;1430;35;89;30;2;28;.933;3900000;0
647;10274;23;77;33;2;31;.939;3900000;0
648;1821;3;0;0;0;0;.00nan;0;0
648;2054;3;63;23;2;21;.913;3600000;0
648;22601;26;0;0;0;0;.00nan;0;0
648;32754;26;72;36;3;33;.917;3580000;0
649;1251;14;0;0;0;0;.00nan;0;0
649;4450;5;35;24;5;19;.792;3600000;0
649;19823;5;0;0;0;0;.00nan;0;0
649;25584;14;86;30;1;29;.967;3600000;0
650;323;9;47;26;5;21;.808;3548000;0
650;4506;33;47;22;4;18;.818;3600000;0
650;20853;9;0;0;0;0;.00nan;0;0
650;34740;33;0;0;0;0;.00nan;0;0
651;233;29;33;37;7;30;.811;2107000;0
651;335;18;0;0;0;0;.00nan;0;0
651;5001;18;67;34;4;30;.882;3600000;0
651;18351;29;65;10;0;10;1.000;1493000;0
652;51;21;100;34;0;34;1.000;3600000;0
652;928;20;0;0;0;0;.00nan;0;0
652;18078;20;75;25;1;24;.960;3562000;0
652;25843;21;0;0;0;0;.00nan;0;0
653;10103;24;0;0;0;0;.00nan;0;0
653;13842;34;97;51;2;49;.961;3595000;0
653;13979;24;74;18;1;17;.944;3600000;0
653;15502;34;0;0;0;0;.00nan;0;0
654;1074;0;0;0;0;0;.00nan;0;0
654;15505;8;92;35;1;34;.971;3600000;0
654;25076;8;0;0;0;0;.00nan;0;0
654;31035;0;51;28;4;24;.857;3600000;0
655;1572;4838;91;34;1;33;.971;3600000;0
655;1796;16;0;0;0;0;.00nan;0;0
655;2328;4838;0;0;0;0;.00nan;0;0
655;15437;16;31;17;4;13;.765;3600000;0
656;5385;17;0;0;0;0;.00nan;0;0
656;15464;32;32;21;5;16;.762;3581000;0
656;16006;32;0;0;0;0;.00nan;0;0
656;34006;17;62;33;4;29;.879;3600000;0
657;544;19;0;0;0;0;.00nan;0;0
657;2058;28;52;21;3;18;.857;3544000;0
657;14061;28;0;0;0;0;.00nan;0;0
657;31124;19;69;23;2;21;.913;3600000;0
658;724;11;91;43;3;40;.930;3900000;0
658;2423;15;57;27;3;24;.889;3900000;0
658;4106;15;0;0;0;0;.00nan;0;0
658;21522;11;0;0;0;0;.00nan;0;0
659;738;27;0;0;0;0;.00nan;0;0
659;18104;10;0;0;0;0;.00nan;0;0
659;26623;27;94;45;3;42;.933;3600000;0
659;27488;10;54;32;4;28;.875;3600000;0
660;61;31;0;0;0;0;.00nan;0;0
660;445;12;0;0;0;0;.00nan;0;0
660;34786;12;51;30;4;26;.867;3540000;0
660;34797;31;84;34;2;32;.941;3600000;0
661;262;35;0;0;0;0;.00nan;0;0
661;1430;35;63;23;2;21;.913;3600000;0
661;1913;30;74;33;3;30;.909;3583000;0
661;4826;30;0;0;0;0;.00nan;0;0
662;1614;25;0;0;0;0;.00nan;0;0
662;5182;25;69;19;1;18;.947;3600000;0
662;22601;26;38;30;6;24;.800;2083000;0
662;32754;26;71;13;0;13;1.000;1517000;0
663;500;4182;65;42;4;38;.905;3900000;0
663;823;23;59;30;4;26;.867;3900000;0
663;10274;23;0;0;0;0;.00nan;0;0
663;25521;4182;0;0;0;0;.00nan;0;0
664;4450;5;0;0;0;0;.00nan;0;0
664;15464;32;90;40;3;37;.925;3700000;0
664;16006;32;0;0;0;0;.00nan;0;0
664;19823;5;40;22;4;18;.818;3700000;0
665;51;21;60;13;1;12;.923;3900000;0
665;1074;0;87;29;1;28;.966;3900000;0
665;25843;21;0;0;0;0;.00nan;0;0
665;31035;0;0;0;0;0;.00nan;0;0
666;323;9;90;47;3;44;.936;3900000;0
666;5385;17;0;0;0;0;.00nan;0;0
666;20853;9;0;0;0;0;.00nan;0;0
666;34006;17;76;30;3;27;.900;3900000;0
667;233;29;19;9;4;5;.556;624000;0
667;445;12;83;26;1;25;.962;3600000;0
667;18351;29;55;26;4;22;.846;2976000;0
667;34786;12;0;0;0;0;.00nan;0;0
668;61;31;0;0;0;0;.00nan;0;0
668;13842;34;47;41;6;35;.854;3600000;0
668;15502;34;0;0;0;0;.00nan;0;0
668;34797;31;94;22;0;22;1.000;3600000;0
669;928;20;100;49;2;47;.959;3600000;0
669;18078;20;0;0;0;0;.00nan;0;0
669;27739;22;48;28;4;24;.857;3588000;0
669;28026;22;0;0;0;0;.00nan;0;0
670;1251;14;0;0;0;0;.00nan;0;0
670;18104;10;0;0;0;0;.00nan;0;0
670;25584;14;87;13;0;13;1.000;3600000;0
670;27488;10;55;44;6;38;.864;3600000;0
671;335;18;0;0;0;0;.00nan;0;0
671;5001;18;53;23;3;20;.870;3600000;0
671;10103;24;80;41;4;37;.902;3566000;0
671;13979;24;0;0;0;0;.00nan;0;0
672;1913;30;0;0;0;0;.00nan;0;0
672;4826;30;99;37;1;36;.973;3600000;0
672;15505;8;0;0;0;0;.00nan;0;0
672;25076;8;60;34;4;30;.882;3600000;0
673;1796;16;100;35;1;34;.971;3639000;0
673;1821;3;76;24;2;22;.917;3639000;0
673;2054;3;0;0;0;0;.00nan;0;0
673;15437;16;0;0;0;0;.00nan;0;0
674;2058;28;0;0;0;0;.00nan;0;0
674;4506;33;0;0;0;0;.00nan;0;0
674;14061;28;83;41;3;38;.927;3561000;0
674;34740;33;99;33;1;32;.970;3600000;0
675;500;4182;69;18;1;17;.944;3600000;0
675;544;19;84;34;2;32;.941;3600000;0
675;25521;4182;0;0;0;0;.00nan;0;0
675;31124;19;0;0;0;0;.00nan;0;0
676;1614;25;45;35;5;30;.857;3600000;0
676;5182;25;0;0;0;0;.00nan;0;0
676;22601;26;0;0;0;0;.00nan;0;0
676;32754;26;66;27;2;25;.926;3600000;0
677;738;27;0;0;0;0;.00nan;0;0
677;2423;15;69;25;2;23;.920;3600000;0
677;4106;15;0;0;0;0;.00nan;0;0
677;26623;27;86;40;3;37;.925;3590000;0
678;1572;4838;0;0;0;0;.00nan;0;0
678;2328;4838;77;30;2;28;.933;3600000;0
678;4435;11;0;0;0;0;.00nan;0;0
678;21522;11;81;34;3;31;.912;3577000;0
679;335;18;19;21;6;15;.714;3600000;0
679;5001;18;0;0;0;0;.00nan;0;0
679;27739;22;0;0;0;0;.00nan;0;0
679;28026;22;76;41;3;38;.927;3600000;0
680;823;23;93;42;2;40;.952;3742000;0
680;4506;33;84;27;1;26;.963;3742000;0
680;10274;23;0;0;0;0;.00nan;0;0
680;34740;33;0;0;0;0;.00nan;0;0
681;323;9;0;0;0;0;.00nan;0;0
681;5385;17;0;0;0;0;.00nan;0;0
681;20853;9;86;43;3;40;.930;3900000;0
681;34006;17;61;29;3;26;.897;3886000;0
682;51;21;37;33;6;27;.818;3600000;0
682;1821;3;60;26;3;23;.885;3600000;0
682;2054;3;0;0;0;0;.00nan;0;0
682;25843;21;0;0;0;0;.00nan;0;0
683;928;20;0;0;0;0;.00nan;0;0
683;1251;14;0;0;0;0;.00nan;0;0
683;18078;20;84;32;2;30;.938;3600000;0
683;25584;14;54;30;4;26;.867;3531000;0
684;1796;16;0;0;0;0;.00nan;0;0
684;15437;16;65;28;2;26;.929;3600000;0
684;15464;32;54;38;5;33;.868;3600000;0
684;16006;32;0;0;0;0;.00nan;0;0
685;262;35;58;8;0;8;1.000;620000;0
685;1430;35;21;36;8;28;.778;2980000;0
685;1614;25;0;0;0;0;.00nan;0;0
685;5182;25;67;16;1;15;.938;3600000;0
686;1074;0;82;42;3;39;.929;3600000;0
686;22601;26;0;0;0;0;.00nan;0;0
686;31035;0;0;0;0;0;.00nan;0;0
686;32754;26;47;31;5;26;.839;3542000;0
687;500;4182;59;39;5;34;.872;3814000;0
687;2423;15;67;49;6;43;.878;3814000;0
687;4106;15;0;0;0;0;.00nan;0;0
687;25521;4182;0;0;0;0;.00nan;0;0
688;738;27;0;0;0;0;.00nan;0;0
688;4435;11;90;40;2;38;.950;3600000;0
688;21522;11;0;0;0;0;.00nan;0;0
688;26623;27;38;19;4;15;.789;3584000;0
689;1572;4838;0;0;0;0;.00nan;0;0
689;2328;4838;75;21;1;20;.952;3600000;0
689;15505;8;56;37;4;33;.892;3600000;0
689;25076;8;0;0;0;0;.00nan;0;0
690;4450;5;0;0;0;0;.00nan;0;0
690;10103;24;80;47;4;43;.915;3528000;0
690;13979;24;0;0;0;0;.00nan;0;0
690;19823;5;97;41;2;39;.951;3600000;0
691;2058;28;83;34;2;32;.941;3600000;0
691;5385;17;63;29;3;26;.897;3566000;0
691;14061;28;0;0;0;0;.00nan;0;0
691;34006;17;0;0;0;0;.00nan;0;0
692;928;20;72;42;3;39;.929;3900000;0
692;13842;34;74;36;3;33;.917;3900000;0
692;15502;34;0;0;0;0;.00nan;0;0
692;18078;20;0;0;0;0;.00nan;0;0
693;323;9;64;53;7;46;.868;3600000;0
693;1251;14;40;20;4;16;.800;3600000;0
693;20853;9;0;0;0;0;.00nan;0;0
693;25584;14;0;0;0;0;.00nan;0;0
694;4506;33;44;29;6;23;.793;3600000;0
694;27739;22;0;0;0;0;.00nan;0;0
694;28026;22;53;26;3;23;.885;3600000;0
694;34740;33;0;0;0;0;.00nan;0;0
695;335;18;0;0;0;0;.00nan;0;0
695;5001;18;82;35;3;32;.914;3600000;0
695;15464;32;0;0;0;0;.00nan;0;0
695;16006;32;76;40;5;35;.875;3581000;0
696;445;12;31;29;6;23;.793;3332000;0
696;1074;0;83;27;2;25;.926;3600000;0
696;31035;0;0;0;0;0;.00nan;0;0
696;34786;12;48;0;0;0;.00nan;268000;0
697;61;31;0;0;0;0;.00nan;0;0
697;544;19;0;0;0;0;.00nan;0;0
697;31124;19;60;31;4;27;.871;3600000;0
697;34797;31;53;31;5;26;.839;3566000;0
698;823;23;0;0;0;0;.00nan;0;0
698;10274;23;37;24;5;19;.792;3597000;0
698;15505;8;0;0;0;0;.00nan;0;0
698;25076;8;72;41;4;37;.902;3600000;0
699;233;29;79;11;0;11;1.000;3600000;0
699;4435;11;65;11;0;11;1.000;1076000;0
699;18351;29;0;0;0;0;.00nan;0;0
699;21522;11;52;36;6;30;.833;2524000;0
700;51;21;53;34;4;30;.882;3545000;0
700;22601;26;0;0;0;0;.00nan;0;0
700;25843;21;0;0;0;0;.00nan;0;0
700;32754;26;70;24;2;22;.917;3600000;0
701;1821;3;91;33;2;31;.939;3600000;0
701;2054;3;0;0;0;0;.00nan;0;0
701;18104;10;0;0;0;0;.00nan;0;0
701;27488;10;85;36;3;33;.917;3592000;0
702;1614;25;51;16;2;14;.875;3563000;0
702;1913;30;0;0;0;0;.00nan;0;0
702;4826;30;99;49;1;48;.980;3600000;0
702;5182;25;0;0;0;0;.00nan;0;0
703;4450;5;66;28;2;26;.929;3600000;0
703;19823;5;0;0;0;0;.00nan;0;0
703;27739;22;76;27;2;25;.926;2591000;0
703;28026;22;29;15;4;11;.733;1009000;0
704;445;12;85;30;2;28;.933;3600000;0
704;5385;17;0;0;0;0;.00nan;0;0
704;34006;17;46;43;7;36;.837;3600000;0
704;34786;12;0;0;0;0;.00nan;0;0
705;1251;14;0;0;0;0;.00nan;0;0
705;13842;34;50;51;8;43;.843;3600000;0
705;15502;34;0;0;0;0;.00nan;0;0
705;25584;14;100;27;0;27;1.000;3600000;0
706;2058;28;78;34;2;32;.941;3900000;0
706;2423;15;84;34;2;32;.941;3900000;0
706;4106;15;0;0;0;0;.00nan;0;0
706;14061;28;0;0;0;0;.00nan;0;0
707;4506;33;69;27;3;24;.889;3656000;0
707;15464;32;66;37;4;33;.892;3656000;0
707;16006;32;0;0;0;0;.00nan;0;0
707;34740;33;0;0;0;0;.00nan;0;0
708;61;31;0;0;0;0;.00nan;0;0
708;823;23;94;34;1;33;.971;3600000;0
708;10274;23;0;0;0;0;.00nan;0;0
708;34797;31;88;43;3;40;.930;3547000;0
709;500;4182;74;17;1;16;.941;3600000;0
709;1074;0;98;51;4;47;.922;3600000;0
709;25521;4182;0;0;0;0;.00nan;0;0
709;31035;0;0;0;0;0;.00nan;0;0
710;1614;25;93;36;1;35;.972;3600000;0
710;4435;11;42;32;5;27;.844;2689000;0
710;5182;25;0;0;0;0;.00nan;0;0
710;21522;11;22;20;5;15;.750;911000;0
711;738;27;0;0;0;0;.00nan;0;0
711;1572;4838;0;0;0;0;.00nan;0;0
711;2328;4838;95;30;1;29;.967;3600000;0
711;26623;27;70;30;3;27;.900;3513000;0
712;323;9;0;0;0;0;.00nan;0;0
712;445;12;0;0;0;0;.00nan;0;0
712;20853;9;49;31;5;26;.839;3856000;0
712;34786;12;79;44;4;40;.909;3856000;0
713;928;20;0;0;0;0;.00nan;0;0
713;18078;20;82;23;1;22;.957;3600000;0
713;22601;26;70;33;3;30;.909;3548000;0
713;32754;26;0;0;0;0;.00nan;0;0
714;10103;24;50;30;4;26;.867;3600000;0
714;13979;24;0;0;0;0;.00nan;0;0
714;18104;10;0;0;0;0;.00nan;0;0
714;27488;10;94;15;0;15;1.000;3600000;0
715;2423;15;63;23;3;20;.870;3600000;0
715;4106;15;0;0;0;0;.00nan;0;0
715;13842;34;0;0;0;0;.00nan;0;0
715;15502;34;66;38;4;34;.895;3564000;0
716;262;35;0;0;0;0;.00nan;0;0
716;1430;35;79;45;5;40;.889;3563000;0
716;15505;8;52;31;4;27;.871;3600000;0
716;25076;8;0;0;0;0;.00nan;0;0
717;61;31;72;55;6;49;.891;2870000;0
717;335;18;0;0;0;0;.00nan;0;0
717;5001;18;76;25;1;24;.960;3600000;0
717;34797;31;33;5;2;3;.600;730000;0
718;233;29;95;30;1;29;.967;3600000;0
718;1913;30;0;0;0;0;.00nan;0;0
718;4826;30;79;40;3;37;.925;3584000;0
718;18351;29;0;0;0;0;.00nan;0;0
719;1572;4838;100;23;0;23;1.000;3600000;0
719;1796;16;57;25;3;22;.880;3600000;0
719;2328;4838;0;0;0;0;.00nan;0;0
719;15437;16;0;0;0;0;.00nan;0;0
720;4450;5;0;0;0;0;.00nan;0;0
720;4506;33;91;37;2;35;.946;3600000;0
720;19823;5;59;28;3;25;.893;3547000;0
720;34740;33;0;0;0;0;.00nan;0;0
721;1251;14;0;0;0;0;.00nan;0;0
721;5385;17;0;0;0;0;.00nan;0;0
721;25584;14;61;21;1;20;.952;3600000;0
721;34006;17;82;44;3;41;.932;3600000;0
722;928;20;74;38;4;34;.895;3532000;0
722;1821;3;0;0;0;0;.00nan;0;0
722;2054;3;90;27;2;25;.926;3600000;0
722;18078;20;0;0;0;0;.00nan;0;0
723;51;21;0;0;0;0;.00nan;0;0
723;10103;24;0;0;0;0;.00nan;0;0
723;13979;24;86;35;3;32;.914;3600000;0
723;25843;21;44;30;5;25;.833;3551000;0
724;18104;10;0;0;0;0;.00nan;0;0
724;22601;26;0;0;0;0;.00nan;0;0
724;27488;10;72;27;2;25;.926;3600000;0
724;32754;26;84;29;1;28;.966;3600000;0
725;2058;28;0;0;0;0;.00nan;0;0
725;14061;28;48;37;5;32;.865;3541000;0
725;27739;22;0;0;0;0;.00nan;0;0
725;28026;22;81;33;3;30;.909;3600000;0
726;323;9;66;36;3;33;.917;3850000;0
726;15464;32;59;28;4;24;.857;3850000;0
726;16006;32;0;0;0;0;.00nan;0;0
726;20853;9;0;0;0;0;.00nan;0;0
727;262;35;48;39;5;34;.872;3585000;0
727;1430;35;0;0;0;0;.00nan;0;0
727;15505;8;0;0;0;0;.00nan;0;0
727;25076;8;85;33;3;30;.909;3600000;0
728;1074;0;67;35;4;31;.886;3600000;0
728;1614;25;0;0;0;0;.00nan;0;0
728;5182;25;77;27;1;26;.963;3600000;0
728;31035;0;0;0;0;0;.00nan;0;0
729;544;19;72;36;4;32;.889;3600000;0
729;823;23;0;0;0;0;.00nan;0;0
729;10274;23;55;38;5;33;.868;3575000;0
729;31124;19;0;0;0;0;.00nan;0;0
730;233;29;0;0;0;0;.00nan;0;0
730;738;27;0;0;0;0;.00nan;0;0
730;18351;29;100;41;2;39;.951;3600000;0
730;26623;27;48;21;3;18;.857;3551000;0
731;51;21;100;45;0;45;1.000;3600000;0
731;724;11;40;32;6;26;.813;2870000;0
731;21522;11;59;5;0;5;1.000;730000;0
731;25843;21;0;0;0;0;.00nan;0;0
732;2423;15;82;31;2;29;.935;3572000;0
732;4106;15;0;0;0;0;.00nan;0;0
732;4506;33;0;0;0;0;.00nan;0;0
732;34740;33;99;42;1;41;.976;3600000;0
733;2058;28;62;33;4;29;.879;3600000;0
733;13842;34;100;43;0;43;1.000;3600000;0
733;14061;28;0;0;0;0;.00nan;0;0
733;15502;34;0;0;0;0;.00nan;0;0
734;335;18;0;0;0;0;.00nan;0;0
734;1796;16;94;33;2;31;.939;3566000;0
734;5001;18;100;38;1;37;.974;3600000;0
734;15437;16;0;0;0;0;.00nan;0;0
735;61;31;73;38;4;34;.895;3542000;0
735;1572;4838;0;0;0;0;.00nan;0;0
735;2328;4838;75;39;3;36;.923;3600000;0
735;34797;31;0;0;0;0;.00nan;0;0
736;1913;30;68;14;1;13;.929;1116000;0
736;4450;5;0;0;0;0;.00nan;0;0
736;4826;30;39;35;6;29;.829;2484000;0
736;19823;5;64;18;2;16;.889;3600000;0
737;724;11;49;24;4;20;.833;2483000;0
737;18104;10;0;0;0;0;.00nan;0;0
737;21522;11;24;15;4;11;.733;1117000;0
737;27488;10;47;28;5;23;.821;3600000;0
738;445;12;71;25;2;23;.920;3876000;0
738;1251;14;0;0;0;0;.00nan;0;0
738;25584;14;85;44;3;41;.932;3876000;0
738;34786;12;0;0;0;0;.00nan;0;0
739;500;4182;55;29;4;25;.862;3600000;0
739;25521;4182;0;0;0;0;.00nan;0;0
739;27739;22;0;0;0;0;.00nan;0;0
739;28026;22;87;27;1;26;.963;3600000;0
740;262;35;0;0;0;0;.00nan;0;0
740;1074;0;92;43;2;41;.953;3531000;0
740;1430;35;85;17;0;17;1.000;3600000;0
740;31035;0;0;0;0;0;.00nan;0;0
741;1614;25;94;34;1;33;.971;3600000;0
741;5182;25;0;0;0;0;.00nan;0;0
741;15505;8;0;0;0;0;.00nan;0;0
741;25076;8;62;24;3;21;.875;3554000;0
742;544;19;56;27;4;23;.852;3900000;0
742;1796;16;0;0;0;0;.00nan;0;0
742;15437;16;42;26;4;22;.846;3900000;0
742;31124;19;0;0;0;0;.00nan;0;0
743;2058;28;0;0;0;0;.00nan;0;0
743;5385;17;0;0;0;0;.00nan;0;0
743;14061;28;59;27;3;24;.889;3900000;0
743;34006;17;100;64;3;61;.953;3900000;0
744;51;21;64;33;3;30;.909;3549000;0
744;445;12;88;34;2;32;.941;3600000;0
744;25843;21;0;0;0;0;.00nan;0;0
744;34786;12;0;0;0;0;.00nan;0;0
745;928;20;0;0;0;0;.00nan;0;0
745;1251;14;0;0;0;0;.00nan;0;0
745;18078;20;66;26;2;24;.923;3600000;0
745;25584;14;54;32;4;28;.875;3600000;0
746;2423;15;71;29;2;27;.931;3600000;0
746;4106;15;0;0;0;0;.00nan;0;0
746;22601;26;0;0;0;0;.00nan;0;0
746;32754;26;83;44;4;40;.909;3549000;0
747;500;4182;76;29;2;27;.931;3600000;0
747;10103;24;43;28;4;24;.857;3600000;0
747;13979;24;0;0;0;0;.00nan;0;0
747;25521;4182;0;0;0;0;.00nan;0;0
748;61;31;0;0;0;0;.00nan;0;0
748;4506;33;76;39;3;36;.923;3900000;0
748;34740;33;0;0;0;0;.00nan;0;0
748;34797;31;80;32;3;29;.906;3900000;0
749;335;18;0;0;0;0;.00nan;0;0
749;823;23;93;44;3;41;.932;3900000;0
749;5001;18;55;22;3;19;.864;3900000;0
749;10274;23;0;0;0;0;.00nan;0;0
750;1572;4838;0;0;0;0;.00nan;0;0
750;2328;4838;45;31;5;26;.839;3551000;0
750;15464;32;46;17;3;14;.824;3600000;0
750;16006;32;0;0;0;0;.00nan;0;0
751;1821;3;48;29;5;24;.828;3580000;0
751;1913;30;0;0;0;0;.00nan;0;0
751;2054;3;0;0;0;0;.00nan;0;0
751;4826;30;68;31;4;27;.871;3600000;0
752;323;9;97;52;3;49;.942;3900000;0
752;15505;8;0;0;0;0;.00nan;0;0
752;20853;9;0;0;0;0;.00nan;0;0
752;25076;8;73;37;3;34;.919;3900000;0
753;738;27;62;9;0;9;1.000;1134000;0
753;26623;27;42;38;6;32;.842;2466000;0
753;27739;22;0;0;0;0;.00nan;0;0
753;28026;22;65;22;2;20;.909;3600000;0
754;544;19;62;34;4;30;.882;3600000;0
754;13842;34;50;32;5;27;.844;3555000;0
754;15502;34;0;0;0;0;.00nan;0;0
754;31124;19;0;0;0;0;.00nan;0;0
755;1614;25;85;46;4;42;.913;3900000;0
755;4450;5;44;21;4;17;.810;3900000;0
755;5182;25;0;0;0;0;.00nan;0;0
755;19823;5;0;0;0;0;.00nan;0;0
756;1074;0;100;36;1;35;.972;3600000;0
756;1913;30;75;38;3;35;.921;3578000;0
756;4826;30;0;0;0;0;.00nan;0;0
756;31035;0;0;0;0;0;.00nan;0;0
757;2058;28;98;34;1;33;.971;3600000;0
757;10103;24;0;0;0;0;.00nan;0;0
757;13979;24;52;26;4;22;.846;3600000;0
757;14061;28;0;0;0;0;.00nan;0;0
758;51;21;74;38;3;35;.921;3600000;0
758;233;29;100;38;0;38;1.000;3600000;0
758;18351;29;0;0;0;0;.00nan;0;0
758;25843;21;0;0;0;0;.00nan;0;0
759;61;31;0;0;0;0;.00nan;0;0
759;500;4182;78;31;1;30;.968;3600000;0
759;25521;4182;0;0;0;0;.00nan;0;0
759;34797;31;41;22;4;18;.818;3600000;0
760;724;11;0;0;0;0;.00nan;0;0
760;928;20;0;0;0;0;.00nan;0;0
760;18078;20;53;31;4;27;.871;3900000;0
760;21522;11;76;45;4;41;.911;3900000;0
761;1572;4838;43;4;1;3;.750;257000;0
761;2328;4838;58;41;6;35;.854;3343000;0
761;2423;15;59;17;2;15;.882;3600000;0
761;4106;15;0;0;0;0;.00nan;0;0
762;13842;34;91;40;3;37;.925;3600000;0
762;15502;34;0;0;0;0;.00nan;0;0
762;18104;10;0;0;0;0;.00nan;0;0
762;27488;10;68;25;2;23;.920;3600000;0
763;544;19;0;0;0;0;.00nan;0;0
763;1796;16;79;35;2;33;.943;3600000;0
763;15437;16;0;0;0;0;.00nan;0;0
763;31124;19;89;32;1;31;.969;3600000;0
764;335;18;0;0;0;0;.00nan;0;0
764;4506;33;0;0;0;0;.00nan;0;0
764;5001;18;64;32;3;29;.906;3548000;0
764;34740;33;91;22;0;22;1.000;3600000;0
765;823;23;91;43;2;41;.953;3600000;0
765;10274;23;0;0;0;0;.00nan;0;0
765;15464;32;68;33;3;30;.909;3544000;0
765;16006;32;0;0;0;0;.00nan;0;0
766;262;35;0;0;0;0;.00nan;0;0
766;1430;35;64;38;4;34;.895;3600000;0
766;18104;10;69;31;2;29;.935;3600000;0
766;27488;10;0;0;0;0;.00nan;0;0
767;323;9;0;0;0;0;.00nan;0;0
767;2423;15;0;0;0;0;.00nan;0;0
767;4106;15;57;22;3;19;.864;3600000;0
767;20853;9;43;39;6;33;.846;3600000;0
768;1614;25;84;38;3;35;.921;3569000;0
768;5182;25;0;0;0;0;.00nan;0;0
768;15505;8;62;16;1;15;.938;3600000;0
768;25076;8;0;0;0;0;.00nan;0;0
769;445;12;35;32;6;26;.813;2154000;0
769;27739;22;63;21;3;18;.857;3600000;0
769;28026;22;0;0;0;0;.00nan;0;0
769;34786;12;54;16;2;14;.875;1446000;0
770;4450;5;67;30;4;26;.867;3900000;0
770;19823;5;0;0;0;0;.00nan;0;0
770;22601;26;73;41;4;37;.902;3846000;0
770;32754;26;0;0;0;0;.00nan;0;0
771;823;23;49;39;6;33;.846;3135000;0
771;1074;0;41;20;4;16;.800;3600000;0
771;10274;23;37;8;2;6;.750;465000;0
771;31035;0;0;0;0;0;.00nan;0;0
772;1913;30;100;42;2;40;.952;3900000;0
772;2058;28;0;0;0;0;.00nan;0;0
772;4826;30;0;0;0;0;.00nan;0;0
772;14061;28;62;22;2;20;.909;3900000;0
773;323;9;83;35;2;33;.943;3544000;0
773;1821;3;0;0;0;0;.00nan;0;0
773;2054;3;77;28;1;27;.964;3600000;0
773;20853;9;0;0;0;0;.00nan;0;0
774;233;29;82;26;1;25;.962;3600000;0
774;500;4182;49;28;4;24;.857;3600000;0
774;18351;29;0;0;0;0;.00nan;0;0
774;25521;4182;0;0;0;0;.00nan;0;0
775;61;31;0;0;0;0;.00nan;0;0
775;738;27;0;0;0;0;.00nan;0;0
775;26623;27;69;36;4;32;.889;3900000;0
775;34797;31;87;45;4;41;.911;3900000;0
776;928;20;0;0;0;0;.00nan;0;0
776;1572;4838;0;0;0;0;.00nan;0;0
776;2328;4838;85;49;4;45;.918;3866000;0
776;18078;20;68;35;3;32;.914;3866000;0
777;724;11;0;0;0;0;.00nan;0;0
777;1251;14;0;0;0;0;.00nan;0;0
777;21522;11;73;30;2;28;.933;3517000;0
777;25584;14;99;20;0;20;1.000;3600000;0
778;51;21;61;24;2;22;.917;3558000;0
778;5298;21;0;0;0;0;.00nan;0;0
778;10103;24;96;27;1;26;.963;3600000;0
778;13979;24;0;0;0;0;.00nan;0;0
779;1796;16;57;16;2;14;.875;3600000;0
779;4506;33;0;0;0;0;.00nan;0;0
779;15437;16;0;0;0;0;.00nan;0;0
779;34740;33;50;33;5;28;.848;3600000;0
780;335;18;0;0;0;0;.00nan;0;0
780;544;19;71;27;2;25;.926;3600000;0
780;5001;18;63;51;6;45;.882;3600000;0
780;31124;19;0;0;0;0;.00nan;0;0
781;5385;17;44;11;2;9;.818;1482000;0
781;22601;26;0;0;0;0;.00nan;0;0
781;32754;26;100;36;1;35;.972;3600000;0
781;34006;17;22;20;5;15;.750;2118000;0
782;1074;0;0;0;0;0;.00nan;0;0
782;13842;34;92;44;3;41;.932;3513000;0
782;15502;34;0;0;0;0;.00nan;0;0
782;31035;0;88;26;1;25;.962;3600000;0
783;262;35;0;0;0;0;.00nan;0;0
783;928;20;51;21;3;18;.857;3552000;0
783;1430;35;89;28;1;27;.964;3600000;0
783;18078;20;0;0;0;0;.00nan;0;0
784;1572;4838;98;52;3;49;.942;3512000;0
784;2328;4838;0;0;0;0;.00nan;0;0
784;18104;10;0;0;0;0;.00nan;0;0
784;27488;10;64;11;1;10;.909;3600000;0
785;724;11;67;28;3;25;.893;3551000;0
785;2423;15;81;19;1;18;.947;3600000;0
785;4106;15;0;0;0;0;.00nan;0;0
785;21522;11;0;0;0;0;.00nan;0;0
786;738;27;0;0;0;0;.00nan;0;0
786;10103;24;0;0;0;0;.00nan;0;0
786;13979;24;39;18;3;15;.833;3900000;0
786;26623;27;82;39;3;36;.923;3900000;0
787;1796;16;0;0;0;0;.00nan;0;0
787;15437;16;73;36;3;33;.917;3600000;0
787;15505;8;56;34;5;29;.853;3516000;0
787;25076;8;0;0;0;0;.00nan;0;0
788;445;12;80;38;3;35;.921;3571000;0
788;4450;5;80;29;2;27;.931;3600000;0
788;19823;5;0;0;0;0;.00nan;0;0
788;34786;12;0;0;0;0;.00nan;0;0
789;1614;25;0;0;0;0;.00nan;0;0
789;5182;25;77;29;2;27;.931;3600000;0
789;5385;17;0;0;0;0;.00nan;0;0
789;34006;17;63;29;4;25;.862;3547000;0
790;823;23;0;0;0;0;.00nan;0;0
790;2058;28;73;27;2;25;.926;3600000;0
790;10274;23;60;39;5;34;.872;3600000;0
790;14061;28;0;0;0;0;.00nan;0;0
791;323;9;75;22;1;21;.955;3600000;0
791;1913;30;0;0;0;0;.00nan;0;0
791;4826;30;33;38;7;31;.816;3600000;0
791;20853;9;0;0;0;0;.00nan;0;0
792;61;31;0;0;0;0;.00nan;0;0
792;13842;34;98;51;1;50;.980;3900000;0
792;15502;34;0;0;0;0;.00nan;0;0
792;34797;31;92;29;1;28;.966;3900000;0
793;335;18;0;0;0;0;.00nan;0;0
793;5001;18;99;40;1;39;.975;3600000;0
793;15505;8;0;0;0;0;.00nan;0;0
793;25076;8;59;20;2;18;.900;3582000;0
794;1572;4838;0;0;0;0;.00nan;0;0
794;2328;4838;86;39;2;37;.949;3807000;0
794;4450;5;96;35;1;34;.971;3807000;0
794;19823;5;0;0;0;0;.00nan;0;0
795;1074;0;63;36;4;32;.889;3600000;0
795;1796;16;46;12;2;10;.833;2608000;0
795;15437;16;25;9;4;5;.556;906000;0
795;31035;0;0;0;0;0;.00nan;0;0
796;233;29;51;25;4;21;.840;3617000;0
796;738;27;0;0;0;0;.00nan;0;0
796;18351;29;0;0;0;0;.00nan;0;0
796;26623;27;70;32;3;29;.906;3606000;0
797;51;21;0;0;0;0;.00nan;0;0
797;1821;3;0;0;0;0;.00nan;0;0
797;2054;3;62;30;3;27;.900;3745000;0
797;5298;21;58;29;4;25;.862;3745000;0
798;928;20;0;0;0;0;.00nan;0;0
798;2058;28;0;0;0;0;.00nan;0;0
798;14061;28;83;31;1;30;.968;3577000;0
798;18078;20;100;33;0;33;1.000;3600000;0
799;61;31;0;0;0;0;.00nan;0;0
799;18104;10;0;0;0;0;.00nan;0;0
799;27488;10;60;27;3;24;.889;3580000;0
799;34797;31;83;32;2;30;.938;3600000;0
800;1251;14;0;0;0;0;.00nan;0;0
800;4506;33;65;23;2;21;.913;3600000;0
800;25584;14;57;27;3;24;.889;3560000;0
800;34740;33;0;0;0;0;.00nan;0;0
801;2423;15;50;14;3;11;.786;3600000;0
801;4106;15;0;0;0;0;.00nan;0;0
801;27739;22;59;44;6;38;.864;2427000;0
801;28026;22;74;17;1;16;.941;1173000;0
802;335;18;0;0;0;0;.00nan;0;0
802;5001;18;49;31;5;26;.839;3592000;0
802;15464;32;61;31;3;28;.903;3600000;0
802;16006;32;0;0;0;0;.00nan;0;0
803;445;12;0;0;0;0;.00nan;0;0
803;544;19;49;23;3;20;.870;3600000;0
803;31124;19;0;0;0;0;.00nan;0;0
803;34786;12;93;38;2;36;.947;3600000;0
804;1614;25;66;41;4;37;.902;3600000;0
804;5182;25;0;0;0;0;.00nan;0;0
804;22601;26;53;37;5;32;.865;2580000;0
804;32754;26;25;15;4;11;.733;1020000;0
805;500;4182;0;0;0;0;.00nan;0;0
805;5385;17;0;0;0;0;.00nan;0;0
805;25521;4182;62;32;4;28;.875;3561000;0
805;34006;17;85;38;2;36;.947;3600000;0
806;323;9;79;30;2;28;.933;3600000;0
806;724;11;64;25;3;22;.880;3545000;0
806;20853;9;0;0;0;0;.00nan;0;0
806;21522;11;0;0;0;0;.00nan;0;0
807;823;23;0;0;0;0;.00nan;0;0
807;10274;23;93;34;2;32;.941;3582000;0
807;27739;22;0;0;0;0;.00nan;0;0
807;28026;22;94;30;1;29;.967;3600000;0
808;262;35;0;0;0;0;.00nan;0;0
808;1430;35;66;22;2;20;.909;3600000;0
808;15505;8;39;32;6;26;.813;3600000;0
808;25076;8;0;0;0;0;.00nan;0;0
809;544;19;33;24;5;19;.792;3556000;0
809;22601;26;0;0;0;0;.00nan;0;0
809;31124;19;0;0;0;0;.00nan;0;0
809;32754;26;100;54;3;51;.944;3600000;0
810;323;9;60;32;4;28;.875;3600000;0
810;1251;14;0;0;0;0;.00nan;0;0
810;20853;9;0;0;0;0;.00nan;0;0
810;25584;14;77;27;1;26;.963;3600000;0
811;233;29;57;24;3;21;.875;3600000;0
811;823;23;57;17;2;15;.882;2414000;0
811;10274;23;26;16;4;12;.750;1186000;0
811;18351;29;0;0;0;0;.00nan;0;0
812;445;12;58;28;4;24;.857;3600000;0
812;4506;33;95;26;1;25;.962;3600000;0
812;34740;33;0;0;0;0;.00nan;0;0
812;34786;12;0;0;0;0;.00nan;0;0
813;724;11;36;21;4;17;.810;3588000;0
813;21522;11;0;0;0;0;.00nan;0;0
813;22601;26;0;0;0;0;.00nan;0;0
813;32754;26;76;28;3;25;.893;3600000;0
814;262;35;0;0;0;0;.00nan;0;0
814;1430;35;44;31;6;25;.806;3577000;0
814;1821;3;0;0;0;0;.00nan;0;0
814;2054;3;54;29;4;25;.862;3600000;0
815;61;31;0;0;0;0;.00nan;0;0
815;13842;34;0;0;0;0;.00nan;0;0
815;15502;34;100;50;2;48;.960;3600000;0
815;34797;31;73;29;3;26;.897;3549000;0
816;51;21;82;29;2;27;.931;3600000;0
816;2423;15;26;13;4;9;.692;885000;0
816;4106;15;73;24;2;22;.917;2715000;0
816;25843;21;0;0;0;0;.00nan;0;0
817;18104;10;0;0;0;0;.00nan;0;0
817;27488;10;80;32;2;30;.938;3600000;0
817;27739;22;0;0;0;0;.00nan;0;0
817;28026;22;57;42;5;37;.881;3600000;0
818;445;12;78;34;3;31;.912;3900000;0
818;15464;32;55;23;3;20;.870;3900000;0
818;16006;32;0;0;0;0;.00nan;0;0
818;34786;12;0;0;0;0;.00nan;0;0
819;335;18;59;40;5;35;.875;3600000;0
819;544;19;0;0;0;0;.00nan;0;0
819;5001;18;0;0;0;0;.00nan;0;0
819;31124;19;68;34;4;30;.882;3600000;0
820;738;27;84;37;3;34;.919;3569000;0
820;928;20;60;24;2;22;.917;3600000;0
820;18078;20;0;0;0;0;.00nan;0;0
820;26623;27;0;0;0;0;.00nan;0;0
821;1572;4838;0;0;0;0;.00nan;0;0
821;2328;4838;88;44;2;42;.955;3600000;0
821;4450;5;43;24;5;19;.792;3600000;0
821;19823;5;0;0;0;0;.00nan;0;0
822;10103;24;48;32;5;27;.844;3600000;0
822;13842;34;91;40;2;38;.950;3600000;0
822;13979;24;0;0;0;0;.00nan;0;0
822;15502;34;0;0;0;0;.00nan;0;0
823;51;21;0;0;0;0;.00nan;0;0
823;15505;8;53;22;3;19;.864;3600000;0
823;25076;8;0;0;0;0;.00nan;0;0
823;25843;21;80;30;1;29;.967;3600000;0
824;907;17;55;28;3;25;.893;3900000;0
824;1796;16;77;35;3;32;.914;3900000;0
824;5385;17;0;0;0;0;.00nan;0;0
824;15437;16;0;0;0;0;.00nan;0;0
825;1614;25;98;29;1;28;.966;3571000;0
825;4506;33;100;30;0;30;1.000;3600000;0
825;34006;25;0;0;0;0;.00nan;0;0
825;34740;33;0;0;0;0;.00nan;0;0
826;500;4182;60;11;1;10;.909;3600000;0
826;22601;26;69;13;0;13;1.000;251000;0
826;25521;4182;0;0;0;0;.00nan;0;0
826;32754;26;57;47;6;41;.872;3349000;0
827;724;11;87;16;0;16;1.000;3600000;0
827;1913;30;0;0;0;0;.00nan;0;0
827;4826;30;69;30;3;27;.900;3600000;0
827;21522;11;0;0;0;0;.00nan;0;0
828;323;9;75;51;4;47;.922;3600000;0
828;1821;3;93;18;0;18;1.000;3600000;0
828;2054;3;0;0;0;0;.00nan;0;0
828;20853;9;0;0;0;0;.00nan;0;0
829;1074;0;77;28;2;26;.929;3600000;0
829;2058;28;55;32;4;28;.875;3556000;0
829;26824;28;0;0;0;0;.00nan;0;0
829;31035;0;0;0;0;0;.00nan;0;0
830;61;31;0;0;0;0;.00nan;0;0
830;823;23;0;0;0;0;.00nan;0;0
830;10274;23;81;46;3;43;.935;3563000;0
830;34797;31;86;22;1;21;.955;3600000;0
831;1251;14;0;0;0;0;.00nan;0;0
831;25584;14;68;23;2;21;.913;3600000;0
831;27739;22;74;38;3;35;.921;3569000;0
831;28026;22;0;0;0;0;.00nan;0;0
832;2423;15;100;29;0;29;1.000;3600000;0
832;4106;15;0;0;0;0;.00nan;0;0
832;18104;10;0;0;0;0;.00nan;0;0
832;27488;10;57;37;5;32;.865;3600000;0
833;233;29;42;32;5;27;.844;3600000;0
833;15464;32;51;26;4;22;.846;3600000;0
833;16006;32;0;0;0;0;.00nan;0;0
833;18351;29;0;0;0;0;.00nan;0;0
834;262;35;0;0;0;0;.00nan;0;0
834;544;19;0;0;0;0;.00nan;0;0
834;1430;35;61;29;3;26;.897;3550000;0
834;31124;19;93;38;2;36;.947;3600000;0
835;500;4182;0;0;0;0;.00nan;0;0
835;1614;25;0;0;0;0;.00nan;0;0
835;25521;4182;35;33;6;27;.818;3900000;0
835;34006;25;51;41;6;35;.854;3900000;0
836;724;11;91;36;2;34;.944;3600000;0
836;928;20;0;0;0;0;.00nan;0;0
836;18078;20;59;29;3;26;.897;3579000;0
836;21522;11;0;0;0;0;.00nan;0;0
837;738;27;0;0;0;0;.00nan;0;0
837;4450;5;79;25;1;24;.960;3600000;0
837;19823;5;0;0;0;0;.00nan;0;0
837;26623;27;72;38;4;34;.895;3600000;0
838;335;18;0;0;0;0;.00nan;0;0
838;5001;18;85;37;2;35;.946;3595000;0
838;18104;10;92;34;1;33;.971;3600000;0
838;27488;10;0;0;0;0;.00nan;0;0
839;823;23;57;35;4;31;.886;3600000;0
839;10103;24;0;0;0;0;.00nan;0;0
839;10274;23;0;0;0;0;.00nan;0;0
839;13979;24;91;28;1;27;.964;3600000;0
840;2423;15;79;40;3;37;.925;3600000;0
840;4106;15;0;0;0;0;.00nan;0;0
840;13842;34;58;35;4;31;.886;3555000;0
840;15502;34;0;0;0;0;.00nan;0;0
841;1796;16;0;0;0;0;.00nan;0;0
841;15437;16;69;4;0;4;1.000;3600000;0
841;15505;8;0;0;0;0;.00nan;0;0
841;25076;8;90;57;4;53;.930;3600000;0
842;445;12;86;42;4;38;.905;3600000;0
842;907;17;0;0;0;0;.00nan;0;0
842;5385;17;88;33;1;32;.970;3600000;0
842;34786;12;0;0;0;0;.00nan;0;0
843;4506;33;74;24;3;21;.875;3600000;0
843;22601;26;55;19;2;17;.895;2522000;0
843;32754;26;26;12;4;8;.667;1078000;0
843;34740;33;0;0;0;0;.00nan;0;0
844;928;20;80;33;3;30;.909;3576000;0
844;1913;30;76;28;2;26;.929;3600000;0
844;4826;30;0;0;0;0;.00nan;0;0
844;18078;20;0;0;0;0;.00nan;0;0
845;738;27;0;0;0;0;.00nan;0;0
845;1572;4838;0;0;0;0;.00nan;0;0
845;2328;4838;65;21;2;19;.905;3596000;0
845;26623;27;100;24;0;24;1.000;3600000;0
846;51;21;97;26;0;26;1.000;3600000;0
846;335;18;59;37;5;32;.865;3600000;0
846;5001;18;0;0;0;0;.00nan;0;0
846;25843;21;0;0;0;0;.00nan;0;0
847;1251;14;0;0;0;0;.00nan;0;0
847;1796;16;0;0;0;0;.00nan;0;0
847;15437;16;55;29;4;25;.862;3600000;0
847;25584;14;60;32;5;27;.844;3587000;0
848;1821;3;99;31;1;30;.968;3600000;0
848;2054;3;0;0;0;0;.00nan;0;0
848;27739;22;0;0;0;0;.00nan;0;0
848;28026;22;86;40;2;38;.950;3573000;0
849;724;11;78;41;4;37;.902;3600000;0
849;4450;5;75;19;1;18;.947;3600000;0
849;19823;5;0;0;0;0;.00nan;0;0
849;21522;11;0;0;0;0;.00nan;0;0
850;323;9;89;35;2;33;.943;3600000;0
850;10103;24;64;28;3;25;.893;3545000;0
850;13979;24;0;0;0;0;.00nan;0;0
850;20853;9;0;0;0;0;.00nan;0;0
851;233;29;0;0;0;0;.00nan;0;0
851;2058;28;36;17;4;13;.765;2317000;0
851;18351;29;64;28;3;25;.893;3600000;0
851;26824;28;62;9;0;9;1.000;1270000;0
852;823;23;0;0;0;0;.00nan;0;0
852;1251;14;69;22;2;20;.909;3600000;0
852;10274;23;83;49;5;44;.898;3600000;0
852;25584;14;0;0;0;0;.00nan;0;0
853;51;21;64;26;3;23;.885;3600000;0
853;13842;34;65;9;0;9;1.000;589000;0
853;15502;34;52;38;6;32;.842;3011000;0
853;25843;21;0;0;0;0;.00nan;0;0
854;262;35;64;39;4;35;.897;3600000;0
854;544;19;77;23;1;22;.957;3600000;0
854;1430;35;0;0;0;0;.00nan;0;0
854;31124;19;0;0;0;0;.00nan;0;0
855;1074;0;60;47;7;40;.851;2935000;0
855;4506;33;0;0;0;0;.00nan;0;0
855;31035;0;54;4;0;4;1.000;665000;0
855;34740;33;66;21;2;19;.905;3600000;0
856;928;20;0;0;0;0;.00nan;0;0
856;1614;25;85;15;0;15;1.000;3600000;0
856;18078;20;60;41;5;36;.878;3600000;0
856;34006;25;0;0;0;0;.00nan;0;0
857;500;4182;68;31;3;28;.903;3600000;0
857;738;27;0;0;0;0;.00nan;0;0
857;25521;4182;0;0;0;0;.00nan;0;0
857;26623;27;73;40;4;36;.900;3548000;0
858;1913;30;0;0;0;0;.00nan;0;0
858;4450;5;0;0;0;0;.00nan;0;0
858;4826;30;88;40;2;38;.950;3591000;0
858;19823;5;72;20;1;19;.950;3600000;0
859;907;17;86;52;4;48;.923;3546000;0
859;1821;3;0;0;0;0;.00nan;0;0
859;2054;3;68;23;2;21;.913;3600000;0
859;5385;17;0;0;0;0;.00nan;0;0
860;1796;16;55;36;4;32;.889;3600000;0
860;15437;16;0;0;0;0;.00nan;0;0
860;18104;10;0;0;0;0;.00nan;0;0
860;27488;10;73;31;3;28;.903;3600000;0
861;445;12;100;24;0;24;1.000;3600000;0
861;724;11;0;0;0;0;.00nan;0;0
861;21522;11;72;42;4;38;.905;3600000;0
861;34786;12;0;0;0;0;.00nan;0;0
862;1572;4838;0;0;0;0;.00nan;0;0
862;2328;4838;77;49;6;43;.878;3600000;0
862;15464;32;60;26;3;23;.885;3600000;0
862;16006;32;0;0;0;0;.00nan;0;0
863;233;29;0;0;0;0;.00nan;0;0
863;2423;15;94;34;1;33;.971;3900000;0
863;4106;15;0;0;0;0;.00nan;0;0
863;18351;29;79;29;1;28;.966;3900000;0
864;61;31;0;0;0;0;.00nan;0;0
864;2058;28;0;0;0;0;.00nan;0;0
864;26824;28;97;20;0;20;1.000;3600000;0
864;34797;31;89;35;1;34;.971;3547000;0
865;335;18;0;0;0;0;.00nan;0;0
865;928;20;0;0;0;0;.00nan;0;0
865;5001;18;94;35;2;33;.943;3590000;0
865;18078;20;99;38;1;37;.974;3600000;0
866;262;35;45;37;6;31;.838;3600000;0
866;1251;14;0;0;0;0;.00nan;0;0
866;1430;35;0;0;0;0;.00nan;0;0
866;25584;14;76;29;2;27;.931;3600000;0
867;10103;24;0;0;0;0;.00nan;0;0
867;13979;24;72;28;2;26;.929;3570000;0
867;27739;22;99;38;1;37;.974;3600000;0
867;28026;22;0;0;0;0;.00nan;0;0
868;823;23;88;41;3;38;.927;3600000;0
868;10274;23;0;0;0;0;.00nan;0;0
868;15505;8;0;0;0;0;.00nan;0;0
868;25076;8;91;26;1;25;.962;3600000;0
869;544;19;0;0;0;0;.00nan;0;0
869;1074;0;0;0;0;0;.00nan;0;0
869;31035;0;74;40;4;36;.900;3600000;0
869;31124;19;79;24;1;23;.958;3600000;0
870;1614;25;70;27;2;25;.926;3600000;0
870;22601;26;99;34;1;33;.971;3600000;0
870;32754;26;0;0;0;0;.00nan;0;0
870;34006;25;0;0;0;0;.00nan;0;0
871;500;4182;63;25;3;22;.880;3600000;0
871;4450;5;57;31;4;27;.871;3549000;0
871;19823;5;0;0;0;0;.00nan;0;0
871;25521;4182;0;0;0;0;.00nan;0;0
872;262;35;0;0;0;0;.00nan;0;0
872;907;17;0;0;0;0;.00nan;0;0
872;1430;35;81;48;4;44;.917;3900000;0
872;5385;17;51;26;4;22;.846;3900000;0
873;233;29;79;29;2;27;.931;3600000;0
873;323;9;0;0;0;0;.00nan;0;0
873;18351;29;0;0;0;0;.00nan;0;0
873;20853;9;73;51;6;45;.882;3600000;0
874;51;21;79;38;3;35;.921;3736000;0
874;18104;10;0;0;0;0;.00nan;0;0
874;25843;21;0;0;0;0;.00nan;0;0
874;27488;10;52;32;4;28;.875;3736000;0
875;2423;15;0;0;0;0;.00nan;0;0
875;4106;15;65;38;4;34;.895;3600000;0
875;10103;24;86;30;1;29;.967;3600000;0
875;13979;24;0;0;0;0;.00nan;0;0
876;724;11;49;1;0;1;1.000;524000;0
876;13842;34;0;0;0;0;.00nan;0;0
876;15502;34;58;28;4;24;.857;3600000;0
876;21522;11;50;41;6;35;.854;3039000;0
877;445;12;36;39;7;32;.821;2698000;0
877;4506;33;63;22;3;19;.864;3600000;0
877;34740;33;0;0;0;0;.00nan;0;0
877;34786;12;77;16;0;16;1.000;902000;0
878;500;4182;0;0;0;0;.00nan;0;0
878;1913;30;0;0;0;0;.00nan;0;0
878;4826;30;91;37;2;35;.946;3600000;0
878;25521;4182;55;26;3;23;.885;3600000;0
879;335;18;70;45;5;40;.889;3600000;0
879;1821;3;71;23;2;21;.913;3600000;0
879;2054;3;0;0;0;0;.00nan;0;0
879;5001;18;0;0;0;0;.00nan;0;0
880;61;31;0;0;0;0;.00nan;0;0
880;323;9;90;50;4;46;.920;3600000;0
880;20853;9;0;0;0;0;.00nan;0;0
880;34797;31;84;15;0;15;1.000;3600000;0
881;928;20;0;0;0;0;.00nan;0;0
881;1796;16;0;0;0;0;.00nan;0;0
881;15437;16;59;24;3;21;.875;3585000;0
881;18078;20;88;38;2;36;.947;3600000;0
882;1251;14;0;0;0;0;.00nan;0;0
882;15505;8;0;0;0;0;.00nan;0;0
882;25076;8;73;40;4;36;.900;3600000;0
882;25584;14;62;39;5;34;.872;3575000;0
883;1572;4838;0;0;0;0;.00nan;0;0
883;2328;4838;98;50;2;48;.960;3564000;0
883;27739;22;70;20;1;19;.950;3600000;0
883;28026;22;0;0;0;0;.00nan;0;0
884;4450;5;89;34;2;32;.941;3600000;0
884;13842;34;89;56;3;53;.946;3550000;0
884;15502;34;0;0;0;0;.00nan;0;0
884;19823;5;0;0;0;0;.00nan;0;0
885;544;19;69;33;3;30;.909;3706000;0
885;1614;25;75;44;4;40;.909;3706000;0
885;31124;19;0;0;0;0;.00nan;0;0
885;34006;25;0;0;0;0;.00nan;0;0
886;823;23;66;44;6;38;.864;3246000;0
886;1074;0;0;0;0;0;.00nan;0;0
886;10274;23;46;5;1;4;.800;354000;0
886;31035;0;65;22;2;20;.909;3600000;0
887;2058;28;0;0;0;0;.00nan;0;0
887;22601;26;0;0;0;0;.00nan;0;0
887;26824;28;62;33;4;29;.879;3600000;0
887;32754;26;43;30;5;25;.833;3580000;0
888;738;27;0;0;0;0;.00nan;0;0
888;15464;32;0;0;0;0;.00nan;0;0
888;16006;32;78;28;2;26;.929;3600000;0
888;26623;27;63;34;4;30;.882;3579000;0
889;724;11;90;32;2;30;.938;3839000;0
889;907;17;0;0;0;0;.00nan;0;0
889;5385;17;88;42;3;39;.929;3839000;0
889;21522;11;0;0;0;0;.00nan;0;0
890;51;21;86;45;4;41;.911;3600000;0
890;1796;16;33;27;6;21;.778;3540000;0
890;15437;16;0;0;0;0;.00nan;0;0
890;25843;21;0;0;0;0;.00nan;0;0
891;1572;4838;0;0;0;0;.00nan;0;0
891;2328;4838;84;42;3;39;.929;3600000;0
891;10103;24;0;0;0;0;.00nan;0;0
891;13979;24;86;13;0;13;1.000;3600000;0
892;233;29;90;30;1;29;.967;3600000;0
892;15505;8;66;33;4;29;.879;3600000;0
892;18351;29;0;0;0;0;.00nan;0;0
892;25076;8;0;0;0;0;.00nan;0;0
893;262;35;0;0;0;0;.00nan;0;0
893;445;12;87;29;1;28;.966;3600000;0
893;1430;35;55;36;5;31;.861;3600000;0
893;34786;12;0;0;0;0;.00nan;0;0
894;4506;33;100;36;2;34;.944;3600000;0
894;18104;10;0;0;0;0;.00nan;0;0
894;27488;10;46;37;6;31;.838;3600000;0
894;34740;33;0;0;0;0;.00nan;0;0
895;500;4182;85;29;1;28;.966;3600000;0
895;2058;28;94;56;3;53;.946;3541000;0
895;25521;4182;0;0;0;0;.00nan;0;0
895;26824;28;0;0;0;0;.00nan;0;0
896;738;27;0;0;0;0;.00nan;0;0
896;1913;30;0;0;0;0;.00nan;0;0
896;4826;30;75;39;4;35;.897;3600000;0
896;26623;27;89;29;1;28;.966;3600000;0
897;724;11;0;0;0;0;.00nan;0;0
897;4450;5;0;0;0;0;.00nan;0;0
897;19823;5;56;32;4;28;.875;3600000;0
897;21522;11;97;43;2;41;.953;3600000;0
898;61;31;0;0;0;0;.00nan;0;0
898;907;17;47;32;5;27;.844;3600000;0
898;5385;17;0;0;0;0;.00nan;0;0
898;34797;31;78;28;2;26;.929;3600000;0
899;928;20;0;0;0;0;.00nan;0;0
899;1614;25;78;37;3;34;.919;3600000;0
899;18078;20;54;38;5;33;.868;3582000;0
899;34006;25;0;0;0;0;.00nan;0;0
900;1821;3;82;22;1;21;.955;3600000;0
900;2054;3;0;0;0;0;.00nan;0;0
900;13842;34;70;43;5;38;.884;3600000;0
900;15502;34;0;0;0;0;.00nan;0;0
901;1572;4838;0;0;0;0;.00nan;0;0
901;1821;3;0;0;0;0;.00nan;0;0
901;2054;3;46;15;3;12;.800;3600000;0
901;2328;4838;68;40;5;35;.875;3546000;0
902;323;9;50;36;5;31;.861;3600000;0
902;20853;9;0;0;0;0;.00nan;0;0
902;22601;26;82;33;2;31;.939;3600000;0
902;32754;26;0;0;0;0;.00nan;0;0
903;51;21;78;38;3;35;.921;3900000;0
903;1614;25;0;0;0;0;.00nan;0;0
903;25843;21;0;0;0;0;.00nan;0;0
903;34006;25;61;27;3;24;.889;3900000;0
904;500;4182;51;34;5;29;.853;3600000;0
904;1251;14;0;0;0;0;.00nan;0;0
904;25521;4182;0;0;0;0;.00nan;0;0
904;25584;14;88;37;2;35;.946;3600000;0
905;61;31;82;37;4;33;.892;3600000;0
905;2423;15;100;35;0;35;1.000;3600000;0
905;4106;15;0;0;0;0;.00nan;0;0
905;34797;31;0;0;0;0;.00nan;0;0
906;1913;30;0;0;0;0;.00nan;0;0
906;4826;30;73;40;3;37;.925;3572000;0
906;15505;8;0;0;0;0;.00nan;0;0
906;25076;8;61;21;2;19;.905;3600000;0
907;1796;16;63;30;4;26;.867;3685000;0
907;2058;28;0;0;0;0;.00nan;0;0
907;15437;16;0;0;0;0;.00nan;0;0
907;26824;28;78;28;3;25;.893;3685000;0
908;445;12;54;44;6;38;.864;3330000;0
908;15464;32;100;28;0;28;1.000;3600000;0
908;16006;32;0;0;0;0;.00nan;0;0
908;34786;12;53;2;0;2;1.000;270000;0
909;262;35;0;0;0;0;.00nan;0;0
909;1430;35;80;29;2;27;.931;3600000;0
909;18104;10;0;0;0;0;.00nan;0;0
909;27488;10;40;26;5;21;.808;3600000;0
910;233;29;79;26;1;25;.962;3600000;0
910;4506;33;81;38;2;36;.947;3600000;0
910;18351;29;0;0;0;0;.00nan;0;0
910;34740;33;0;0;0;0;.00nan;0;0
911;544;19;29;23;5;18;.783;3600000;0
911;27739;22;0;0;0;0;.00nan;0;0
911;28026;22;22;30;7;23;.767;3541000;0
911;31124;19;0;0;0;0;.00nan;0;0
912;823;23;0;0;0;0;.00nan;0;0
912;10274;23;91;43;3;40;.930;3600000;0
912;27739;22;47;26;5;21;.808;3600000;0
912;28026;22;0;0;0;0;.00nan;0;0
913;335;18;0;0;0;0;.00nan;0;0
913;1074;0;70;33;4;29;.879;3600000;0
913;5001;18;72;20;1;19;.950;3600000;0
913;31035;0;0;0;0;0;.00nan;0;0
914;4450;5;59;19;2;17;.895;3600000;0
914;15505;8;0;0;0;0;.00nan;0;0
914;19823;5;0;0;0;0;.00nan;0;0
914;25076;8;77;45;4;41;.911;3549000;0
915;500;4182;67;27;3;24;.889;3600000;0
915;907;17;0;0;0;0;.00nan;0;0
915;5385;17;56;34;4;30;.882;3580000;0
915;25521;4182;0;0;0;0;.00nan;0;0
916;1821;3;49;24;4;20;.833;3600000;0
916;2054;3;0;0;0;0;.00nan;0;0
916;22601;26;0;0;0;0;.00nan;0;0
916;32754;26;66;47;6;41;.872;3519000;0
917;1572;4838;0;0;0;0;.00nan;0;0
917;2058;28;0;0;0;0;.00nan;0;0
917;2328;4838;77;22;1;21;.955;3600000;0
917;26824;28;63;36;4;32;.889;3600000;0
918;262;35;0;0;0;0;.00nan;0;0
918;323;9;91;42;3;39;.929;3521000;0
918;1430;35;78;25;1;24;.960;3600000;0
918;20853;9;0;0;0;0;.00nan;0;0
919;61;31;0;0;0;0;.00nan;0;0
919;1251;14;0;0;0;0;.00nan;0;0
919;25584;14;88;28;1;27;.964;3600000;0
919;34797;31;78;27;2;25;.926;3600000;0
920;51;21;75;24;1;23;.958;3600000;0
920;4506;33;60;29;4;25;.862;3600000;0
920;25843;21;0;0;0;0;.00nan;0;0
920;34740;33;0;0;0;0;.00nan;0;0
921;928;20;0;0;0;0;.00nan;0;0
921;2423;15;73;39;3;36;.923;3853000;0
921;4106;15;0;0;0;0;.00nan;0;0
921;18078;20;98;41;2;39;.951;3853000;0
922;1614;25;91;21;0;21;1.000;3600000;0
922;10103;24;0;0;0;0;.00nan;0;0
922;13979;24;75;37;3;34;.919;3600000;0
922;34006;25;0;0;0;0;.00nan;0;0
923;1796;16;0;0;0;0;.00nan;0;0
923;15437;16;81;42;4;38;.905;3677000;0
923;18104;10;43;32;5;27;.844;3677000;0
923;27488;10;0;0;0;0;.00nan;0;0
924;1913;30;0;0;0;0;.00nan;0;0
924;4826;30;85;32;2;30;.938;3817000;0
924;15464;32;67;27;3;24;.889;3817000;0
924;16006;32;0;0;0;0;.00nan;0;0
925;233;29;56;31;4;27;.871;3600000;0
925;544;19;0;0;0;0;.00nan;0;0
925;18351;29;0;0;0;0;.00nan;0;0
925;31124;19;55;39;5;34;.872;3543000;0
926;724;11;59;18;3;15;.833;3900000;0
926;738;27;0;0;0;0;.00nan;0;0
926;21522;11;0;0;0;0;.00nan;0;0
926;26623;27;82;34;3;31;.912;3900000;0
927;928;20;0;0;0;0;.00nan;0;0
927;4506;33;64;36;4;32;.889;3600000;0
927;18078;20;67;21;2;19;.905;3600000;0
927;34740;33;0;0;0;0;.00nan;0;0
928;500;4182;0;0;0;0;.00nan;0;0
928;2423;15;0;0;0;0;.00nan;0;0
928;4106;15;83;44;4;40;.909;3600000;0
928;25521;4182;29;30;7;23;.767;3600000;0
929;262;35;94;39;2;37;.949;3600000;0
929;1430;35;0;0;0;0;.00nan;0;0
929;13842;34;77;39;3;36;.923;3600000;0
929;15502;34;0;0;0;0;.00nan;0;0
930;335;18;0;0;0;0;.00nan;0;0
930;5001;18;80;43;4;39;.907;3600000;0
930;27739;22;34;19;4;15;.789;1184000;0
930;28026;22;71;27;2;25;.926;2413000;0
931;4450;5;0;0;0;0;.00nan;0;0
931;19823;5;51;19;3;16;.842;3600000;0
931;22601;26;39;12;3;9;.750;495000;0
931;32754;26;98;47;1;46;.979;3094000;0
932;1074;0;0;0;0;0;.00nan;0;0
932;1572;4838;0;0;0;0;.00nan;0;0
932;2328;4838;18;36;9;27;.750;3600000;0
932;31035;0;87;34;2;32;.941;3600000;0
933;2058;28;0;0;0;0;.00nan;0;0
933;15505;8;52;33;5;28;.848;3549000;0
933;25076;8;0;0;0;0;.00nan;0;0
933;26824;28;56;32;4;28;.875;3600000;0
934;51;21;62;14;1;13;.929;3600000;0
934;1913;30;0;0;0;0;.00nan;0;0
934;4826;30;52;32;5;27;.844;3600000;0
934;25843;21;0;0;0;0;.00nan;0;0
935;1251;14;0;0;0;0;.00nan;0;0
935;10103;24;0;0;0;0;.00nan;0;0
935;13979;24;67;31;3;28;.903;3600000;0
935;25584;14;51;40;6;34;.850;3600000;0
936;1796;16;68;27;3;24;.889;3628000;0
936;15437;16;0;0;0;0;.00nan;0;0
936;15464;32;0;0;0;0;.00nan;0;0
936;16006;32;94;36;2;34;.944;3628000;0
937;445;12;0;0;0;0;.00nan;0;0
937;18104;10;0;0;0;0;.00nan;0;0
937;27488;10;55;32;5;27;.844;3849000;0
937;34786;12;58;38;4;34;.895;3849000;0
938;323;9;68;42;5;37;.881;3600000;0
938;544;19;100;26;0;26;1.000;3600000;0
938;20853;9;0;0;0;0;.00nan;0;0
938;31124;19;0;0;0;0;.00nan;0;0
939;233;29;42;23;4;19;.826;3600000;0
939;823;23;0;0;0;0;.00nan;0;0
939;10274;23;65;45;6;39;.867;3524000;0
939;18351;29;0;0;0;0;.00nan;0;0
940;724;11;0;0;0;0;.00nan;0;0
940;738;27;0;0;0;0;.00nan;0;0
940;21522;11;87;37;2;35;.946;3600000;0
940;26623;27;71;40;4;36;.900;3545000;0
941;907;17;0;0;0;0;.00nan;0;0
941;1821;3;62;23;2;21;.913;3600000;0
941;2054;3;0;0;0;0;.00nan;0;0
941;5385;17;69;34;3;31;.912;3558000;0
942;928;20;0;0;0;0;.00nan;0;0
942;1913;30;99;51;2;49;.961;3600000;0
942;4826;30;0;0;0;0;.00nan;0;0
942;18078;20;51;21;3;18;.857;3589000;0
943;1074;0;46;26;4;22;.846;3600000;0
943;1251;14;0;0;0;0;.00nan;0;0
943;25584;14;77;28;1;27;.964;3600000;0
943;31035;0;0;0;0;0;.00nan;0;0
944;2423;15;39;27;5;22;.815;3531000;0
944;4106;15;0;0;0;0;.00nan;0;0
944;10103;24;77;36;3;33;.917;3600000;0
944;13979;24;0;0;0;0;.00nan;0;0
945;500;4182;0;0;0;0;.00nan;0;0
945;13842;34;0;0;0;0;.00nan;0;0
945;15502;34;70;41;4;37;.902;3600000;0
945;25521;4182;61;31;5;26;.839;3594000;0
946;1796;16;0;0;0;0;.00nan;0;0
946;4506;33;85;23;1;22;.957;3658000;0
946;15437;16;68;22;2;20;.909;3658000;0
946;34740;33;0;0;0;0;.00nan;0;0
947;262;35;0;0;0;0;.00nan;0;0
947;1430;35;72;30;3;27;.900;3577000;0
947;15464;32;61;19;2;17;.895;3600000;0
947;16006;32;0;0;0;0;.00nan;0;0
948;544;19;76;30;2;28;.933;3562000;0
948;1614;25;90;33;1;32;.970;3600000;0
948;31124;19;0;0;0;0;.00nan;0;0
948;34006;25;0;0;0;0;.00nan;0;0
949;233;29;0;0;0;0;.00nan;0;0
949;335;18;74;39;4;35;.897;3600000;0
949;5001;18;0;0;0;0;.00nan;0;0
949;18351;29;59;40;5;35;.875;3554000;0
950;61;31;0;0;0;0;.00nan;0;0
950;724;11;44;36;6;30;.833;3600000;0
950;21522;11;0;0;0;0;.00nan;0;0
950;34797;31;82;29;2;27;.931;3600000;0
951;2058;28;0;0;0;0;.00nan;0;0
951;22601;26;0;0;0;0;.00nan;0;0
951;26824;28;65;20;2;18;.900;3600000;0
951;32754;26;69;40;4;36;.900;3517000;0
952;445;12;38;38;7;31;.816;2305000;0
952;1821;3;83;23;1;22;.957;3600000;0
952;2054;3;0;0;0;0;.00nan;0;0
952;34786;12;61;9;0;9;1.000;1295000;0
953;1074;0;0;0;0;0;.00nan;0;0
953;22601;26;81;31;2;29;.935;3600000;0
953;31035;0;77;37;3;34;.919;3564000;0
953;32754;26;0;0;0;0;.00nan;0;0
954;1913;30;52;3;0;3;1.000;297000;0
954;4826;30;77;47;5;42;.894;3237000;0
954;18104;10;0;0;0;0;.00nan;0;0
954;27488;10;57;20;3;17;.850;3600000;0
955;928;20;0;0;0;0;.00nan;0;0
955;18078;20;48;24;5;19;.792;3599000;0
955;27739;22;68;30;4;26;.867;3600000;0
955;28026;22;0;0;0;0;.00nan;0;0
956;4450;5;0;0;0;0;.00nan;0;0
956;15505;8;0;0;0;0;.00nan;0;0
956;19823;5;45;21;3;18;.857;3599000;0
956;25076;8;92;40;2;38;.950;3600000;0
957;2423;15;91;36;2;34;.944;3600000;0
957;4106;15;0;0;0;0;.00nan;0;0
957;15464;32;73;38;3;35;.921;3566000;0
957;16006;32;0;0;0;0;.00nan;0;0
958;500;4182;82;17;0;17;1.000;3600000;0
958;4506;33;73;46;4;42;.913;3600000;0
958;25521;4182;0;0;0;0;.00nan;0;0
958;34740;33;0;0;0;0;.00nan;0;0
959;323;9;86;28;1;27;.964;3837000;0
959;823;23;0;0;0;0;.00nan;0;0
959;10274;23;62;17;2;15;.882;3837000;0
959;20853;9;0;0;0;0;.00nan;0;0
960;51;21;61;36;4;32;.889;3900000;0
960;335;18;0;0;0;0;.00nan;0;0
960;5001;18;52;29;4;25;.862;3900000;0
960;25843;21;0;0;0;0;.00nan;0;0
961;724;11;40;42;7;35;.833;3347000;0
961;1614;25;71;25;2;23;.920;3600000;0
961;21522;11;51;2;0;2;1.000;253000;0
961;34006;25;0;0;0;0;.00nan;0;0
962;61;31;0;0;0;0;.00nan;0;0
962;738;27;0;0;0;0;.00nan;0;0
962;26623;27;60;27;4;23;.852;3600000;0
962;34797;31;46;32;5;27;.844;3543000;0
963;2058;28;0;0;0;0;.00nan;0;0
963;13842;34;83;47;5;42;.894;3600000;0
963;15502;34;0;0;0;0;.00nan;0;0
963;26824;28;85;29;1;28;.966;3600000;0
964;262;35;0;0;0;0;.00nan;0;0
964;1430;35;98;48;2;46;.958;3558000;0
964;4450;5;81;24;1;23;.958;3600000;0
964;19823;5;0;0;0;0;.00nan;0;0
965;51;21;0;0;0;0;.00nan;0;0
965;544;19;0;0;0;0;.00nan;0;0
965;25843;21;68;26;2;24;.923;3558000;0
965;31124;19;86;28;1;27;.964;3600000;0
966;233;29;0;0;0;0;.00nan;0;0
966;1572;4838;0;0;0;0;.00nan;0;0
966;2328;4838;64;38;4;34;.895;3600000;0
966;18351;29;60;39;5;34;.872;3563000;0
967;1821;3;76;26;2;24;.923;3600000;0
967;2054;3;0;0;0;0;.00nan;0;0
967;10103;24;0;0;0;0;.00nan;0;0
967;13979;24;89;40;3;37;.925;3600000;0
968;445;12;63;29;3;26;.897;3600000;0
968;1074;0;23;35;7;28;.800;3600000;0
968;31035;0;0;0;0;0;.00nan;0;0
968;34786;12;0;0;0;0;.00nan;0;0
969;1251;14;0;0;0;0;.00nan;0;0
969;15464;32;0;0;0;0;.00nan;0;0
969;16006;32;32;19;5;14;.737;3600000;0
969;25584;14;99;42;2;40;.952;3600000;0
970;13842;34;8;17;6;11;.647;1406000;0
970;15502;34;49;26;4;22;.846;2194000;0
970;27739;22;0;0;0;0;.00nan;0;0
970;28026;22;81;37;3;34;.919;3600000;0
971;1796;16;45;27;4;23;.852;3600000;0
971;2423;15;92;37;3;34;.919;3600000;0
971;4106;15;0;0;0;0;.00nan;0;0
971;15437;16;0;0;0;0;.00nan;0;0
972;823;23;93;34;1;33;.971;3600000;0
972;5385;17;0;0;0;0;.00nan;0;0
972;10274;23;0;0;0;0;.00nan;0;0
972;23255;17;73;28;2;26;.929;3600000;0
973;323;9;0;0;0;0;.00nan;0;0
973;335;18;51;25;4;21;.840;3516000;0
973;5001;18;0;0;0;0;.00nan;0;0
973;20853;9;95;49;2;47;.959;3600000;0
974;61;31;55;15;1;14;.933;1429000;0
974;500;4182;63;27;3;24;.889;3600000;0
974;25521;4182;0;0;0;0;.00nan;0;0
974;34797;31;27;31;6;25;.806;2171000;0
975;724;11;0;0;0;0;.00nan;0;0
975;738;27;0;0;0;0;.00nan;0;0
975;21522;11;91;36;2;34;.944;3599000;0
975;26623;27;65;14;1;13;.929;3600000;0
976;1251;14;0;0;0;0;.00nan;0;0
976;2058;28;0;0;0;0;.00nan;0;0
976;25584;14;99;23;0;23;1.000;3600000;0
976;26824;28;50;24;3;21;.875;3600000;0
977;10103;24;48;33;5;28;.848;3600000;0
977;13979;24;0;0;0;0;.00nan;0;0
977;27739;22;71;21;1;20;.952;3600000;0
977;28026;22;0;0;0;0;.00nan;0;0
978;4450;5;73;19;1;18;.947;3600000;0
978;4506;33;0;0;0;0;.00nan;0;0
978;19823;5;0;0;0;0;.00nan;0;0
978;34740;33;26;27;6;21;.778;3600000;0
979;544;19;0;0;0;0;.00nan;0;0
979;5385;17;64;40;4;36;.900;3600000;0
979;23255;17;0;0;0;0;.00nan;0;0
979;31124;19;70;20;1;19;.950;3600000;0
980;61;31;0;0;0;0;.00nan;0;0
980;1913;30;0;0;0;0;.00nan;0;0
980;4826;30;79;44;4;40;.909;3600000;0
980;34797;31;75;22;1;21;.955;3600000;0
981;738;27;0;0;0;0;.00nan;0;0
981;1614;25;100;44;3;41;.932;3600000;0
981;26623;27;37;26;5;21;.808;3550000;0
981;34006;25;0;0;0;0;.00nan;0;0
982;717;0;0;0;0;0;.00nan;0;0
982;1074;0;47;28;5;23;.821;3600000;0
982;2058;28;29;15;4;11;.733;1360000;0
982;26824;28;50;34;5;29;.853;2240000;0
983;233;29;100;24;0;24;1.000;3600000;0
983;18104;10;79;34;3;31;.912;3600000;0
983;18351;29;0;0;0;0;.00nan;0;0
983;27488;10;0;0;0;0;.00nan;0;0
984;445;12;63;26;3;23;.885;3600000;0
984;928;20;54;3;0;3;1.000;618000;0
984;18078;20;31;29;6;23;.793;2982000;0
984;34786;12;0;0;0;0;.00nan;0;0
985;1796;16;0;0;0;0;.00nan;0;0
985;13842;34;9;22;7;15;.682;1583000;0
985;15437;16;79;24;2;22;.917;3600000;0
985;15502;34;61;22;2;20;.909;2017000;0
986;1821;3;63;26;3;23;.885;3900000;0
986;2054;3;0;0;0;0;.00nan;0;0
986;15464;32;92;43;3;40;.930;3900000;0
986;16006;32;0;0;0;0;.00nan;0;0
987;262;35;0;0;0;0;.00nan;0;0
987;1430;35;53;39;5;34;.872;3600000;0
987;15505;8;0;0;0;0;.00nan;0;0
987;25076;8;74;29;2;27;.931;3600000;0
988;51;21;43;18;4;14;.778;3547000;0
988;823;23;0;0;0;0;.00nan;0;0
988;10274;23;68;32;3;29;.906;3600000;0
988;25843;21;0;0;0;0;.00nan;0;0
989;335;18;0;0;0;0;.00nan;0;0
989;544;19;63;27;2;25;.926;3600000;0
989;5001;18;87;31;1;30;.968;3600000;0
989;31124;19;0;0;0;0;.00nan;0;0
990;2423;15;90;38;2;36;.947;3600000;0
990;4106;15;0;0;0;0;.00nan;0;0
990;22601;26;0;0;0;0;.00nan;0;0
990;32754;26;73;36;3;33;.917;3600000;0
991;500;4182;61;30;4;26;.867;3900000;0
991;724;11;33;11;3;8;.727;425000;0
991;21522;11;93;31;1;30;.968;3458000;0
991;25521;4182;0;0;0;0;.00nan;0;0
992;323;9;71;14;0;14;1.000;614000;0
992;1572;4838;0;0;0;0;.00nan;0;0
992;2328;4838;100;33;1;32;.970;3600000;0
992;20853;9;40;33;6;27;.818;2986000;0
993;928;20;92;39;2;37;.949;3900000;0
993;1251;14;0;0;0;0;.00nan;0;0
993;18078;20;0;0;0;0;.00nan;0;0
993;25584;14;88;33;2;31;.939;3900000;0
994;445;12;0;0;0;0;.00nan;0;0
994;27739;22;25;22;5;17;.773;3600000;0
994;28026;22;0;0;0;0;.00nan;0;0
994;34786;12;88;29;1;28;.966;3600000;0
995;10103;24;0;0;0;0;.00nan;0;0
995;13979;24;91;39;2;37;.949;3600000;0
995;18104;10;0;0;0;0;.00nan;0;0
995;27488;10;93;42;4;38;.905;3600000;0
996;4506;33;77;22;1;21;.955;3600000;0
996;15505;8;61;27;3;24;.889;3558000;0
996;25076;8;0;0;0;0;.00nan;0;0
996;34740;33;0;0;0;0;.00nan;0;0
997;335;18;55;20;2;18;.900;3600000;0
997;5001;18;0;0;0;0;.00nan;0;0
997;5385;17;100;28;0;28;1.000;3600000;0
997;23255;17;0;0;0;0;.00nan;0;0
998;738;27;0;0;0;0;.00nan;0;0
998;22601;26;88;35;2;33;.943;3900000;0
998;26623;27;76;25;2;23;.920;3900000;0
998;32754;26;0;0;0;0;.00nan;0;0
999;717;0;68;28;3;25;.893;2729000;0
999;1074;0;24;11;4;7;.636;788000;0
999;4450;5;0;0;0;0;.00nan;0;0
999;19823;5;51;28;5;23;.821;3600000;0
1000;262;35;0;0;0;0;.00nan;0;0
1000;500;4182;0;0;0;0;.00nan;0;0
1000;1430;35;79;44;5;39;.886;3600000;0
1000;25521;4182;57;14;2;12;.857;3600000;0
1001;823;23;98;56;3;53;.946;3572000;0
1001;1614;25;79;23;1;22;.957;3600000;0
1001;10274;23;0;0;0;0;.00nan;0;0
1001;34006;25;0;0;0;0;.00nan;0;0
1002;1913;30;0;0;0;0;.00nan;0;0
1002;4826;30;95;42;1;41;.976;3600000;0
1002;15464;32;30;16;4;12;.750;2192000;0
1002;16006;32;42;7;2;5;.714;1408000;0
1003;323;9;54;38;6;32;.842;3600000;0
1003;1251;14;0;0;0;0;.00nan;0;0
1003;20853;9;0;0;0;0;.00nan;0;0
1003;25584;14;91;27;1;26;.963;3600000;0
1004;51;21;100;19;0;19;1.000;3600000;0
1004;18104;10;0;0;0;0;.00nan;0;0
1004;25843;21;0;0;0;0;.00nan;0;0
1004;27488;10;85;29;2;27;.931;3550000;0
1005;928;20;0;0;0;0;.00nan;0;0
1005;4450;5;100;28;0;28;1.000;3600000;0
1005;18078;20;58;40;5;35;.875;3600000;0
1005;19823;5;0;0;0;0;.00nan;0;0
1006;2423;15;100;25;0;25;1.000;3600000;0
1006;4106;15;0;0;0;0;.00nan;0;0
1006;13842;34;65;47;5;42;.894;3600000;0
1006;15502;34;0;0;0;0;.00nan;0;0
1007;1796;16;0;0;0;0;.00nan;0;0
1007;15437;16;77;31;1;30;.968;3900000;0
1007;27739;22;94;34;1;33;.971;3900000;0
1007;28026;22;0;0;0;0;.00nan;0;0
1008;233;29;73;28;2;26;.929;3900000;0
1008;10103;24;0;0;0;0;.00nan;0;0
1008;13979;24;100;40;2;38;.950;3900000;0
1008;18351;29;0;0;0;0;.00nan;0;0
1009;445;12;0;0;0;0;.00nan;0;0
1009;823;23;0;0;0;0;.00nan;0;0
1009;10274;23;71;33;3;30;.909;3546000;0
1009;34786;12;93;35;1;34;.971;3600000;0
1010;500;4182;76;22;1;21;.955;3600000;0
1010;4506;33;30;29;6;23;.793;2845000;0
1010;25521;4182;0;0;0;0;.00nan;0;0
1010;34740;33;47;12;2;10;.833;755000;0
1011;544;19;0;0;0;0;.00nan;0;0
1011;738;27;50;1;0;1;1.000;242000;0
1011;26623;27;47;36;6;30;.833;3358000;0
1011;31124;19;39;31;5;26;.839;3600000;0
1012;724;11;78;30;2;28;.933;3600000;0
1012;15464;32;67;28;3;25;.893;3572000;0
1012;16006;32;0;0;0;0;.00nan;0;0
1012;21522;11;0;0;0;0;.00nan;0;0
1013;2423;15;100;39;1;38;.974;3600000;0
1013;4106;15;0;0;0;0;.00nan;0;0
1013;5385;17;73;37;4;33;.892;3600000;0
1013;23255;17;0;0;0;0;.00nan;0;0
1014;51;21;77;28;2;26;.929;3600000;0
1014;1821;3;0;0;0;0;.00nan;0;0
1014;2054;3;100;32;0;32;1.000;3600000;0
1014;25843;21;0;0;0;0;.00nan;0;0
1015;335;18;0;0;0;0;.00nan;0;0
1015;1614;25;91;29;2;27;.931;3600000;0
1015;5001;18;73;32;3;29;.906;3564000;0
1015;34006;25;0;0;0;0;.00nan;0;0
1016;1572;4838;0;0;0;0;.00nan;0;0
1016;2328;4838;94;35;1;34;.971;3600000;0
1016;22601;26;0;0;0;0;.00nan;0;0
1016;32754;26;84;31;2;29;.935;3566000;0
1017;1913;30;0;0;0;0;.00nan;0;0
1017;4826;30;98;40;1;39;.975;3900000;0
1017;15505;8;73;23;2;21;.913;3900000;0
1017;25076;8;0;0;0;0;.00nan;0;0
1018;233;29;55;30;3;27;.900;3544000;0
1018;4450;5;69;22;2;20;.909;3600000;0
1018;18351;29;0;0;0;0;.00nan;0;0
1018;19823;5;0;0;0;0;.00nan;0;0
1019;61;31;0;0;0;0;.00nan;0;0
1019;717;0;50;34;6;28;.824;2261000;0
1019;1074;0;59;21;2;19;.905;1281000;0
1019;34797;31;28;27;6;21;.778;3600000;0
1020;928;20;0;0;0;0;.00nan;0;0
1020;2058;28;0;0;0;0;.00nan;0;0
1020;18078;20;78;33;2;31;.939;3588000;0
1020;26824;28;82;28;1;27;.964;3600000;0
1021;445;12;31;33;6;27;.818;3143000;0
1021;10103;24;70;21;1;20;.952;3600000;0
1021;13979;24;0;0;0;0;.00nan;0;0
1021;34786;12;52;12;1;11;.917;457000;0
1022;1251;14;0;0;0;0;.00nan;0;0
1022;1796;16;63;25;3;22;.880;3581000;0
1022;15437;16;0;0;0;0;.00nan;0;0
1022;25584;14;86;27;1;26;.963;3600000;0
1023;262;35;0;0;0;0;.00nan;0;0
1023;335;18;85;41;3;38;.927;3600000;0
1023;1430;35;75;42;4;38;.905;3582000;0
1023;5001;18;0;0;0;0;.00nan;0;0
1024;738;27;0;0;0;0;.00nan;0;0
1024;823;23;0;0;0;0;.00nan;0;0
1024;10274;23;56;36;5;31;.861;3600000;0
1024;26623;27;100;31;0;31;1.000;3600000;0
1025;500;4182;83;26;1;25;.962;3600000;0
1025;15464;32;80;35;2;33;.943;3600000;0
1025;16006;32;0;0;0;0;.00nan;0;0
1025;25521;4182;0;0;0;0;.00nan;0;0
1026;724;11;0;0;0;0;.00nan;0;0
1026;15505;8;0;0;0;0;.00nan;0;0
1026;21522;11;100;27;0;27;1.000;3600000;0
1026;25076;8;81;37;3;34;.919;3600000;0
1027;5385;17;79;41;3;38;.927;3564000;0
1027;23255;17;0;0;0;0;.00nan;0;0
1027;27739;22;73;28;2;26;.929;3600000;0
1027;28026;22;0;0;0;0;.00nan;0;0
1028;2423;15;91;38;2;36;.947;3600000;0
1028;4106;15;0;0;0;0;.00nan;0;0
1028;18104;10;0;0;0;0;.00nan;0;0
1028;27488;10;60;29;4;25;.862;3546000;0
1029;4506;33;61;27;3;24;.889;3600000;0
1029;13842;34;0;0;0;0;.00nan;0;0
1029;15502;34;44;30;5;25;.833;3569000;0
1029;34740;33;0;0;0;0;.00nan;0;0
1030;1251;14;0;0;0;0;.00nan;0;0
1030;1614;25;36;14;3;11;.786;3600000;0
1030;25584;14;90;57;4;53;.930;3600000;0
1030;34006;25;0;0;0;0;.00nan;0;0
1031;544;19;0;0;0;0;.00nan;0;0
1031;22601;26;82;37;3;34;.919;3900000;0
1031;31124;19;53;20;3;17;.850;3900000;0
1031;32754;26;0;0;0;0;.00nan;0;0
1032;1572;4838;0;0;0;0;.00nan;0;0
1032;1913;30;0;0;0;0;.00nan;0;0
1032;2328;4838;71;34;3;31;.912;3600000;0
1032;4826;30;88;38;2;36;.947;3600000;0
1033;928;20;51;35;5;30;.857;3600000;0
1033;4450;5;60;17;2;15;.882;3600000;0
1033;18078;20;0;0;0;0;.00nan;0;0
1033;19823;5;0;0;0;0;.00nan;0;0
1034;717;0;0;0;0;0;.00nan;0;0
1034;1074;0;70;34;3;31;.912;3600000;0
1034;1821;3;0;0;0;0;.00nan;0;0
1034;2054;3;75;27;2;25;.926;3600000;0
1035;61;31;0;0;0;0;.00nan;0;0
1035;2058;28;0;0;0;0;.00nan;0;0
1035;26824;28;70;33;3;30;.909;3600000;0
1035;34797;31;36;32;5;27;.844;3600000;0
1036;233;29;45;19;4;15;.789;3600000;0
1036;323;9;100;43;1;42;.977;3600000;0
1036;18351;29;0;0;0;0;.00nan;0;0
1036;20853;9;0;0;0;0;.00nan;0;0
1037;51;21;76;45;4;41;.911;3600000;0
1037;25843;21;0;0;0;0;.00nan;0;0
1037;27739;22;0;0;0;0;.00nan;0;0
1037;28026;22;50;36;5;31;.861;3555000;0
1038;1796;16;0;0;0;0;.00nan;0;0
1038;10103;24;0;0;0;0;.00nan;0;0
1038;13979;24;72;27;3;24;.889;3600000;0
1038;15437;16;37;21;4;17;.810;3595000;0
1039;335;18;52;32;4;28;.875;3900000;0
1039;445;12;0;0;0;0;.00nan;0;0
1039;5001;18;0;0;0;0;.00nan;0;0
1039;34786;12;60;32;4;28;.875;3900000;0
1040;262;35;0;0;0;0;.00nan;0;0
1040;1430;35;66;25;2;23;.920;3698000;0
1040;13842;34;64;33;3;30;.909;3698000;0
1040;15502;34;0;0;0;0;.00nan;0;0
1041;544;19;97;36;2;34;.944;3600000;0
1041;823;23;85;22;0;22;1.000;1613000;0
1041;10274;23;48;23;4;19;.826;1958000;0
1041;31124;19;0;0;0;0;.00nan;0;0
1042;500;4182;93;22;0;22;1.000;3600000;0
1042;15505;8;98;49;2;47;.959;3600000;0
1042;25076;8;0;0;0;0;.00nan;0;0
1042;25521;4182;0;0;0;0;.00nan;0;0
1043;724;11;0;0;0;0;.00nan;0;0
1043;1572;4838;0;0;0;0;.00nan;0;0
1043;2328;4838;82;39;3;36;.923;3666000;0
1043;21522;11;56;27;4;23;.852;3666000;0
1044;738;27;0;0;0;0;.00nan;0;0
1044;1913;30;71;36;4;32;.889;3522000;0
1044;4826;30;0;0;0;0;.00nan;0;0
1044;26623;27;57;20;2;18;.900;3600000;0
1045;61;31;46;29;5;24;.828;3600000;0
1045;1821;3;94;33;1;32;.970;3600000;0
1045;2054;3;0;0;0;0;.00nan;0;0
1045;34797;31;0;0;0;0;.00nan;0;0
1046;51;21;0;0;0;0;.00nan;0;0
1046;717;0;90;32;2;30;.938;3590000;0
1046;1074;0;0;0;0;0;.00nan;0;0
1046;25843;21;87;27;1;26;.963;3600000;0
1047;233;29;0;0;0;0;.00nan;0;0
1047;928;20;0;0;0;0;.00nan;0;0
1047;18078;20;76;35;3;32;.914;3600000;0
1047;18351;29;62;36;5;31;.861;3600000;0
1048;5385;17;0;0;0;0;.00nan;0;0
1048;18104;10;0;0;0;0;.00nan;0;0
1048;23255;17;87;39;2;37;.949;3586000;0
1048;27488;10;85;29;1;28;.966;3600000;0
1049;323;9;0;0;0;0;.00nan;0;0
1049;2423;15;100;32;0;32;1.000;3600000;0
1049;4106;15;0;0;0;0;.00nan;0;0
1049;20853;9;98;51;2;49;.961;3554000;0
1050;1251;14;0;0;0;0;.00nan;0;0
1050;15464;32;0;0;0;0;.00nan;0;0
1050;16006;32;100;20;0;20;1.000;3600000;0
1050;25584;14;72;32;3;29;.906;3600000;0
1051;262;35;98;46;3;43;.935;3600000;0
1051;1430;35;0;0;0;0;.00nan;0;0
1051;1614;25;52;33;5;28;.848;3600000;0
1051;34006;25;0;0;0;0;.00nan;0;0
1052;4506;33;86;31;2;29;.935;3600000;0
1052;22601;26;0;0;0;0;.00nan;0;0
1052;32754;26;76;48;5;43;.896;3568000;0
1052;34740;33;0;0;0;0;.00nan;0;0
1053;10103;24;0;0;0;0;.00nan;0;0
1053;13979;24;37;37;7;30;.811;3599000;0
1053;27739;22;27;24;5;19;.792;3600000;0
1053;28026;22;0;0;0;0;.00nan;0;0
1054;5385;17;98;21;0;21;1.000;3600000;0
1054;15505;8;0;0;0;0;.00nan;0;0
1054;23255;17;0;0;0;0;.00nan;0;0
1054;25076;8;58;32;4;28;.875;3600000;0
1055;335;18;0;0;0;0;.00nan;0;0
1055;1796;16;78;36;3;33;.917;3600000;0
1055;5001;18;52;30;4;26;.867;3600000;0
1055;15437;16;0;0;0;0;.00nan;0;0
1056;823;23;0;0;0;0;.00nan;0;0
1056;10274;23;67;41;4;37;.902;3656000;0
1056;22601;26;60;35;5;30;.857;3656000;0
1056;32754;26;0;0;0;0;.00nan;0;0
1057;724;11;90;44;3;41;.932;3555000;0
1057;1572;4838;0;0;0;0;.00nan;0;0
1057;2328;4838;94;32;1;31;.969;3600000;0
1057;21522;11;0;0;0;0;.00nan;0;0
1058;1821;3;95;39;2;37;.949;3749000;0
1058;2054;3;0;0;0;0;.00nan;0;0
1058;4450;5;0;0;0;0;.00nan;0;0
1058;19823;5;70;32;3;29;.906;3749000;0
1059;233;29;64;32;3;29;.906;3900000;0
1059;10103;24;83;44;3;41;.932;3900000;0
1059;13979;24;0;0;0;0;.00nan;0;0
1059;18351;29;0;0;0;0;.00nan;0;0
1060;61;31;0;0;0;0;.00nan;0;0
1060;717;0;0;0;0;0;.00nan;0;0
1060;1074;0;86;40;3;37;.925;3600000;0
1060;34797;31;41;34;6;28;.824;3600000;0
1061;2423;15;87;33;2;31;.939;3600000;0
1061;4106;15;0;0;0;0;.00nan;0;0
1061;18104;10;84;48;4;44;.917;3578000;0
1061;27488;10;0;0;0;0;.00nan;0;0
1062;928;20;69;49;5;44;.898;3600000;0
1062;13842;34;0;0;0;0;.00nan;0;0
1062;15502;34;86;41;3;38;.927;3600000;0
1062;18078;20;0;0;0;0;.00nan;0;0
1063;2058;28;0;0;0;0;.00nan;0;0
1063;15464;32;0;0;0;0;.00nan;0;0
1063;16006;32;78;29;2;27;.931;3600000;0
1063;26824;28;92;40;3;37;.925;3600000;0
1064;262;35;0;0;0;0;.00nan;0;0
1064;1251;14;0;0;0;0;.00nan;0;0
1064;1430;35;49;37;5;32;.865;3565000;0
1064;25584;14;61;26;3;23;.885;3600000;0
1065;544;19;93;31;1;30;.968;3753000;0
1065;1614;25;100;28;0;28;1.000;3753000;0
1065;31124;19;0;0;0;0;.00nan;0;0
1065;34006;25;0;0;0;0;.00nan;0;0
1066;445;12;100;32;0;32;1.000;3600000;0
1066;1913;30;0;0;0;0;.00nan;0;0
1066;4826;30;92;46;3;43;.935;3600000;0
1066;34786;12;0;0;0;0;.00nan;0;0
1067;4506;33;51;26;4;22;.846;3543000;0
1067;5385;17;84;37;3;34;.919;3600000;0
1067;23255;17;0;0;0;0;.00nan;0;0
1067;34740;33;0;0;0;0;.00nan;0;0
1068;323;9;97;44;2;42;.955;3600000;0
1068;18104;10;0;0;0;0;.00nan;0;0
1068;20853;9;0;0;0;0;.00nan;0;0
1068;27488;10;39;24;5;19;.792;3600000;0
1069;724;11;94;38;2;36;.947;3900000;0
1069;823;23;0;0;0;0;.00nan;0;0
1069;10274;23;98;39;2;37;.949;3900000;0
1069;21522;11;0;0;0;0;.00nan;0;0
1070;335;18;64;36;4;32;.889;3600000;0
1070;1796;16;86;25;1;24;.960;3600000;0
1070;5001;18;0;0;0;0;.00nan;0;0
1070;15437;16;0;0;0;0;.00nan;0;0
1071;738;27;0;0;0;0;.00nan;0;0
1071;22601;26;95;34;2;32;.941;3600000;0
1071;26623;27;52;30;4;26;.867;3583000;0
1071;32754;26;0;0;0;0;.00nan;0;0
1072;500;4182;83;28;1;27;.964;3600000;0
1072;1572;4838;0;0;0;0;.00nan;0;0
1072;2328;4838;60;40;5;35;.875;3600000;0
1072;25521;4182;0;0;0;0;.00nan;0;0
1073;51;21;94;48;4;44;.917;3900000;0
1073;4450;5;40;24;4;20;.833;3900000;0
1073;19823;5;0;0;0;0;.00nan;0;0
1073;25843;21;0;0;0;0;.00nan;0;0
1074;1821;3;0;0;0;0;.00nan;0;0
1074;2054;3;59;36;4;32;.889;3599000;0
1074;4506;33;70;30;3;27;.900;3600000;0
1074;34740;33;0;0;0;0;.00nan;0;0
1075;61;31;74;25;1;24;.960;3600000;0
1075;15505;8;82;41;3;38;.927;3595000;0
1075;25076;8;0;0;0;0;.00nan;0;0
1075;34797;31;0;0;0;0;.00nan;0;0
1076;928;20;0;0;0;0;.00nan;0;0
1076;13842;34;73;55;7;48;.873;3600000;0
1076;15502;34;0;0;0;0;.00nan;0;0
1076;18078;20;83;32;3;29;.906;3600000;0
1077;717;0;85;34;2;32;.941;3600000;0
1077;1074;0;0;0;0;0;.00nan;0;0
1077;10103;24;0;0;0;0;.00nan;0;0
1077;13979;24;76;39;5;34;.872;3600000;0
1078;262;35;0;0;0;0;.00nan;0;0
1078;1430;35;71;38;4;34;.895;3600000;0
1078;2423;15;99;34;1;33;.971;3600000;0
1078;4106;15;0;0;0;0;.00nan;0;0
1079;738;27;0;0;0;0;.00nan;0;0
1079;1614;25;78;38;3;35;.921;3616000;0
1079;26623;27;74;42;4;38;.905;3616000;0
1079;34006;25;0;0;0;0;.00nan;0;0
1080;544;19;40;24;4;20;.833;3568000;0
1080;724;11;0;0;0;0;.00nan;0;0
1080;21522;11;82;34;2;32;.941;3600000;0
1080;31124;19;0;0;0;0;.00nan;0;0
1081;445;12;27;20;5;15;.750;3600000;0
1081;1913;30;72;39;4;35;.897;2575000;0
1081;4826;30;29;14;4;10;.714;1025000;0
1081;34786;12;0;0;0;0;.00nan;0;0
1082;5385;17;0;0;0;0;.00nan;0;0
1082;15464;32;70;27;2;25;.926;3900000;0
1082;16006;32;0;0;0;0;.00nan;0;0
1082;23255;17;100;45;2;43;.956;3900000;0
1083;323;9;0;0;0;0;.00nan;0;0
1083;2058;28;0;0;0;0;.00nan;0;0
1083;20853;9;54;26;4;22;.846;3600000;0
1083;26824;28;35;24;5;19;.792;3557000;0
1084;233;29;68;17;1;16;.941;3600000;0
1084;15505;8;0;0;0;0;.00nan;0;0
1084;18351;29;0;0;0;0;.00nan;0;0
1084;25076;8;81;54;5;49;.907;3600000;0
1085;928;20;23;26;6;20;.769;2147000;0
1085;18078;20;49;17;2;15;.882;1453000;0
1085;18104;10;0;0;0;0;.00nan;0;0
1085;27488;10;60;35;4;31;.886;3600000;0
1086;823;23;80;32;2;30;.938;3600000;0
1086;1796;16;0;0;0;0;.00nan;0;0
1086;10274;23;0;0;0;0;.00nan;0;0
1086;15437;16;98;36;1;35;.972;3600000;0
1087;1913;30;0;0;0;0;.00nan;0;0
1087;4826;30;69;26;2;24;.923;3900000;0
1087;22601;26;0;0;0;0;.00nan;0;0
1087;32754;26;87;40;2;38;.950;3900000;0
1088;500;4182;84;32;3;29;.906;3863000;0
1088;1572;4838;0;0;0;0;.00nan;0;0
1088;2328;4838;65;31;3;28;.903;3900000;0
1088;25521;4182;0;0;0;0;.00nan;0;0
1089;4450;5;20;22;6;16;.727;2282000;0
1089;13842;34;61;27;3;24;.889;3600000;0
1089;15502;34;0;0;0;0;.00nan;0;0
1089;19823;5;48;8;1;7;.875;1318000;0
1090;233;29;0;0;0;0;.00nan;0;0
1090;717;0;0;0;0;0;.00nan;0;0
1090;1074;0;60;32;4;28;.875;3600000;0
1090;18351;29;66;17;1;16;.941;3600000;0
1091;51;21;88;33;2;31;.939;3600000;0
1091;61;31;0;0;0;0;.00nan;0;0
1091;25843;21;0;0;0;0;.00nan;0;0
1091;34797;31;62;35;4;31;.886;3600000;0
1092;1251;14;0;0;0;0;.00nan;0;0
1092;1821;3;75;27;2;25;.926;3590000;0
1092;2054;3;0;0;0;0;.00nan;0;0
1092;25584;14;100;41;0;41;1.000;3600000;0
1093;262;35;0;0;0;0;.00nan;0;0
1093;1430;35;71;44;5;39;.886;3600000;0
1093;10103;24;0;0;0;0;.00nan;0;0
1093;13979;24;70;27;2;25;.926;3600000;0
1094;15464;32;0;0;0;0;.00nan;0;0
1094;16006;32;66;26;2;24;.923;3600000;0
1094;27739;22;56;46;5;41;.891;3600000;0
1094;28026;22;0;0;0;0;.00nan;0;0
1095;724;11;90;36;2;34;.944;3600000;0
1095;4506;33;43;18;4;14;.778;3574000;0
1095;21522;11;0;0;0;0;.00nan;0;0
1095;34740;33;0;0;0;0;.00nan;0;0
1096;1614;25;0;0;0;0;.00nan;0;0
1096;2423;15;100;27;0;27;1.000;3600000;0
1096;4106;15;0;0;0;0;.00nan;0;0
1096;34006;25;80;41;3;38;.927;3600000;0
1097;544;19;34;35;7;28;.800;3600000;0
1097;1796;16;82;28;2;26;.929;3600000;0
1097;15437;16;0;0;0;0;.00nan;0;0
1097;31124;19;0;0;0;0;.00nan;0;0
1098;445;12;78;33;2;31;.939;3600000;0
1098;738;27;61;39;5;34;.872;3600000;0
1098;26623;27;0;0;0;0;.00nan;0;0
1098;34786;12;0;0;0;0;.00nan;0;0
1099;61;31;85;31;1;30;.968;3600000;0
1099;5385;17;37;27;6;21;.778;3600000;0
1099;23255;17;0;0;0;0;.00nan;0;0
1099;34797;31;0;0;0;0;.00nan;0;0
1100;323;9;38;36;6;30;.833;3600000;0
1100;2058;28;0;0;0;0;.00nan;0;0
1100;20853;9;0;0;0;0;.00nan;0;0
1100;26824;28;87;15;0;15;1.000;3600000;0
1101;51;21;0;0;0;0;.00nan;0;0
1101;928;20;0;0;0;0;.00nan;0;0
1101;18078;20;75;36;3;33;.917;3600000;0
1101;25843;21;55;31;4;27;.871;3555000;0
1102;1251;14;42;11;2;9;.818;802000;0
1102;18104;10;0;0;0;0;.00nan;0;0
1102;25584;14;62;41;6;35;.854;2798000;0
1102;27488;10;70;29;2;27;.931;3600000;0
1103;262;35;0;0;0;0;.00nan;0;0
1103;1430;35;70;27;2;25;.926;3600000;0
1103;27739;22;0;0;0;0;.00nan;0;0
1103;28026;22;74;35;3;32;.914;3543000;0
1104;15505;8;67;26;2;24;.923;3600000;0
1104;22601;26;0;0;0;0;.00nan;0;0
1104;25076;8;0;0;0;0;.00nan;0;0
1104;32754;26;73;39;4;35;.897;3587000;0
1105;335;18;52;32;5;27;.844;3600000;0
1105;500;4182;100;31;0;31;1.000;3600000;0
1105;5001;18;0;0;0;0;.00nan;0;0
1105;25521;4182;0;0;0;0;.00nan;0;0
1106;823;23;0;0;0;0;.00nan;0;0
1106;1913;30;0;0;0;0;.00nan;0;0
1106;4826;30;72;32;3;29;.906;3600000;0
1106;10274;23;76;27;2;25;.926;3600000;0
1107;445;12;0;0;0;0;.00nan;0;0
1107;1572;4838;0;0;0;0;.00nan;0;0
1107;2328;4838;95;35;1;34;.971;3600000;0
1107;34786;12;50;22;3;19;.864;3517000;0
1108;233;29;62;36;4;32;.889;3537000;0
1108;1821;3;90;35;2;33;.943;3600000;0
1108;2054;3;0;0;0;0;.00nan;0;0
1108;18351;29;0;0;0;0;.00nan;0;0
1109;4450;5;0;0;0;0;.00nan;0;0
1109;13842;34;56;25;4;21;.840;3600000;0
1109;15502;34;0;0;0;0;.00nan;0;0
1109;19823;5;66;15;1;14;.933;3600000;0
1110;1796;16;0;0;0;0;.00nan;0;0
1110;14321;16;79;20;1;19;.950;3600000;0
1110;22601;26;60;39;6;33;.846;3269000;0
1110;32754;26;48;0;0;0;.00nan;331000;0
1111;544;19;38;36;6;30;.833;3600000;0
1111;724;11;0;0;0;0;.00nan;0;0
1111;21522;11;80;32;2;30;.938;3600000;0
1111;31124;19;0;0;0;0;.00nan;0;0
1112;5385;17;0;0;0;0;.00nan;0;0
1112;10103;24;0;0;0;0;.00nan;0;0
1112;13979;24;100;33;1;32;.970;3600000;0
1112;23255;17;38;28;5;23;.821;3600000;0
1113;717;0;42;35;6;29;.829;3569000;0
1113;1074;0;0;0;0;0;.00nan;0;0
1113;2058;28;0;0;0;0;.00nan;0;0
1113;26824;28;88;45;4;41;.911;3600000;0
1114;323;9;74;51;4;47;.922;3600000;0
1114;4450;5;79;24;1;23;.958;3600000;0
1114;19823;5;0;0;0;0;.00nan;0;0
1114;20853;9;0;0;0;0;.00nan;0;0
1115;61;31;0;0;0;0;.00nan;0;0
1115;1821;3;0;0;0;0;.00nan;0;0
1115;2054;3;75;38;4;34;.895;3600000;0
1115;34797;31;54;37;6;31;.838;3516000;0
1116;51;21;99;39;1;38;.974;3600000;0
1116;18104;10;0;0;0;0;.00nan;0;0
1116;25843;21;0;0;0;0;.00nan;0;0
1116;27488;10;79;40;3;37;.925;3539000;0
1117;1251;14;0;0;0;0;.00nan;0;0
1117;13842;34;0;0;0;0;.00nan;0;0
1117;15502;34;55;35;5;30;.857;3600000;0
1117;25584;14;79;33;2;31;.939;3600000;0
1118;1614;25;60;35;5;30;.857;3846000;0
1118;2423;15;75;46;6;40;.870;3846000;0
1118;4106;15;0;0;0;0;.00nan;0;0
1118;34006;25;0;0;0;0;.00nan;0;0
1119;262;35;0;0;0;0;.00nan;0;0
1119;1430;35;85;38;2;36;.947;3600000;0
1119;15464;32;44;37;5;32;.865;3600000;0
1119;16006;32;0;0;0;0;.00nan;0;0
1120;445;12;0;0;0;0;.00nan;0;0
1120;928;20;0;0;0;0;.00nan;0;0
1120;18078;20;88;42;3;39;.929;3846000;0
1120;34786;12;69;37;4;33;.892;3846000;0
1121;738;27;0;0;0;0;.00nan;0;0
1121;823;23;0;0;0;0;.00nan;0;0
1121;10274;23;80;33;2;31;.939;3543000;0
1121;26623;27;79;27;1;26;.963;3600000;0
1122;233;29;38;40;7;33;.825;3600000;0
1122;18351;29;0;0;0;0;.00nan;0;0
1122;27739;22;72;41;4;37;.902;3600000;0
1122;28026;22;0;0;0;0;.00nan;0;0
1123;1572;4838;57;16;2;14;.875;1353000;0
1123;1796;16;0;0;0;0;.00nan;0;0
1123;2328;4838;36;33;6;27;.818;2247000;0
1123;14321;16;45;17;3;14;.824;3600000;0
1124;323;9;0;0;0;0;.00nan;0;0
1124;4506;33;81;24;1;23;.958;3600000;0
1124;20853;9;63;35;4;31;.886;3600000;0
1124;34740;33;0;0;0;0;.00nan;0;0
1125;544;19;56;23;3;20;.870;3600000;0
1125;1913;30;0;0;0;0;.00nan;0;0
1125;4826;30;97;34;1;33;.971;3600000;0
1125;31124;19;0;0;0;0;.00nan;0;0
1126;335;18;95;39;2;37;.949;3600000;0
1126;500;4182;52;32;4;28;.875;3576000;0
1126;5001;18;0;0;0;0;.00nan;0;0
1126;25521;4182;0;0;0;0;.00nan;0;0
1127;51;21;91;31;1;30;.968;3600000;0
1127;2058;28;0;0;0;0;.00nan;0;0
1127;25843;21;0;0;0;0;.00nan;0;0
1127;26824;28;95;51;3;48;.941;3600000;0
1128;2423;15;71;31;3;28;.903;3600000;0
1128;4106;15;0;0;0;0;.00nan;0;0
1128;18104;10;0;0;0;0;.00nan;0;0
1128;27488;10;65;40;4;36;.900;3543000;0
1129;5385;17;0;0;0;0;.00nan;0;0
1129;10103;24;42;27;5;22;.815;3569000;0
1129;13979;24;0;0;0;0;.00nan;0;0
1129;23255;17;78;41;4;37;.902;3600000;0
1130;1251;14;0;0;0;0;.00nan;0;0
1130;13842;34;67;35;2;33;.943;3900000;0
1130;15502;34;0;0;0;0;.00nan;0;0
1130;25584;14;95;42;2;40;.952;3900000;0
1131;1572;4838;71;34;2;32;.941;3708000;0
1131;2328;4838;0;0;0;0;.00nan;0;0
1131;15505;8;79;33;3;30;.909;3708000;0
1131;25076;8;0;0;0;0;.00nan;0;0
1132;445;12;0;0;0;0;.00nan;0;0
1132;1821;3;58;35;5;30;.857;3543000;0
1132;2054;3;0;0;0;0;.00nan;0;0
1132;34786;12;71;38;4;34;.895;3600000;0
1133;335;18;0;0;0;0;.00nan;0;0
1133;5001;18;44;46;7;39;.848;3520000;0
1133;22601;26;0;0;0;0;.00nan;0;0
1133;32754;26;44;24;5;19;.792;3600000;0
1134;724;11;50;27;4;23;.852;3600000;0
1134;823;23;0;0;0;0;.00nan;0;0
1134;10274;23;100;44;1;43;.977;3600000;0
1134;21522;11;0;0;0;0;.00nan;0;0
1135;544;19;0;0;0;0;.00nan;0;0
1135;738;27;0;0;0;0;.00nan;0;0
1135;26623;27;49;37;5;32;.865;3600000;0
1135;31124;19;92;31;1;30;.968;3600000;0
1136;233;29;70;33;2;31;.939;3600000;0
1136;4450;5;80;34;3;31;.912;3569000;0
1136;18351;29;0;0;0;0;.00nan;0;0
1136;19823;5;0;0;0;0;.00nan;0;0
1137;61;31;0;0;0;0;.00nan;0;0
1137;5385;17;58;49;6;43;.878;3600000;0
1137;23255;17;0;0;0;0;.00nan;0;0
1137;34797;31;81;32;2;30;.938;3600000;0
1138;928;20;0;0;0;0;.00nan;0;0
1138;10103;24;0;0;0;0;.00nan;0;0
1138;13979;24;91;32;1;31;.969;3600000;0
1138;18078;20;43;42;7;35;.833;3600000;0
1139;262;35;0;0;0;0;.00nan;0;0
1139;1430;35;100;39;0;39;1.000;3600000;0
1139;1796;16;0;0;0;0;.00nan;0;0
1139;14321;16;46;24;4;20;.833;3600000;0
1140;1614;25;80;32;2;30;.938;3600000;0
1140;4506;33;67;46;4;42;.913;3568000;0
1140;34006;25;0;0;0;0;.00nan;0;0
1140;34740;33;0;0;0;0;.00nan;0;0
1141;717;0;0;0;0;0;.00nan;0;0
1141;1074;0;100;45;1;44;.978;3600000;0
1141;1821;3;71;38;4;34;.895;3600000;0
1141;2054;3;0;0;0;0;.00nan;0;0
1142;323;9;79;27;1;26;.963;3600000;0
1142;13842;34;81;40;2;38;.950;3600000;0
1142;15502;34;0;0;0;0;.00nan;0;0
1142;20853;9;0;0;0;0;.00nan;0;0
1143;2058;28;0;0;0;0;.00nan;0;0
1143;18104;10;0;0;0;0;.00nan;0;0
1143;26824;28;31;21;5;16;.762;3518000;0
1143;27488;10;97;37;3;34;.919;3600000;0
1144;1251;14;0;0;0;0;.00nan;0;0
1144;1913;30;0;0;0;0;.00nan;0;0
1144;4826;30;66;41;5;36;.878;3600000;0
1144;25584;14;100;29;0;29;1.000;3600000;0
1145;2423;15;89;18;0;18;1.000;3600000;0
1145;4106;15;0;0;0;0;.00nan;0;0
1145;27739;22;93;49;3;46;.939;3600000;0
1145;28026;22;0;0;0;0;.00nan;0;0
1146;928;20;0;0;0;0;.00nan;0;0
1146;1796;16;50;20;3;17;.850;3513000;0
1146;14321;16;0;0;0;0;.00nan;0;0
1146;18078;20;90;27;1;26;.963;3600000;0
1147;61;31;74;26;2;24;.923;3887000;0
1147;15464;32;0;0;0;0;.00nan;0;0
1147;16006;32;61;25;3;22;.880;3887000;0
1147;34797;31;0;0;0;0;.00nan;0;0
1148;51;21;75;32;2;30;.938;3600000;0
1148;445;12;0;0;0;0;.00nan;0;0
1148;25843;21;0;0;0;0;.00nan;0;0
1148;34786;12;84;51;4;47;.922;3514000;0
1149;262;35;0;0;0;0;.00nan;0;0
1149;724;11;71;31;3;28;.903;3550000;0
1149;1430;35;95;38;2;36;.947;3600000;0
1149;21522;11;0;0;0;0;.00nan;0;0
1150;823;23;0;0;0;0;.00nan;0;0
1150;1614;25;0;0;0;0;.00nan;0;0
1150;10274;23;68;32;3;29;.906;3600000;0
1150;34006;25;100;45;0;45;1.000;3600000;0
1151;335;18;78;29;2;27;.931;3600000;0
1151;738;27;0;0;0;0;.00nan;0;0
1151;5001;18;0;0;0;0;.00nan;0;0
1151;26623;27;71;34;3;31;.912;3555000;0
1152;500;4182;46;19;3;16;.842;3552000;0
1152;22601;26;0;0;0;0;.00nan;0;0
1152;25521;4182;0;0;0;0;.00nan;0;0
1152;32754;26;99;48;2;46;.958;3600000;0
1153;544;19;58;15;1;14;.933;3600000;0
1153;1572;4838;0;0;0;0;.00nan;0;0
1153;2328;4838;100;31;0;31;1.000;3600000;0
1153;31124;19;0;0;0;0;.00nan;0;0
1154;2058;28;60;34;4;30;.882;3900000;0
1154;4506;33;65;36;4;32;.889;3900000;0
1154;26824;28;0;0;0;0;.00nan;0;0
1154;34740;33;0;0;0;0;.00nan;0;0
1155;233;29;88;15;0;15;1.000;3600000;0
1155;5385;17;76;49;4;45;.918;3600000;0
1155;18351;29;0;0;0;0;.00nan;0;0
1155;23255;17;0;0;0;0;.00nan;0;0
1156;2423;15;97;44;2;42;.955;3573000;0
1156;4106;15;0;0;0;0;.00nan;0;0
1156;15464;32;91;19;0;19;1.000;3600000;0
1156;16006;32;0;0;0;0;.00nan;0;0
1157;4450;5;0;0;0;0;.00nan;0;0
1157;19823;5;64;18;1;17;.944;3600000;0
1157;27739;22;0;0;0;0;.00nan;0;0
1157;28026;22;69;25;2;23;.920;3541000;0
1158;1913;30;61;45;5;40;.889;3566000;0
1158;4826;30;0;0;0;0;.00nan;0;0
1158;10103;24;0;0;0;0;.00nan;0;0
1158;13979;24;41;22;4;18;.818;3600000;0
1159;445;12;99;48;2;46;.958;3600000;0
1159;15505;8;61;29;3;26;.897;3579000;0
1159;25076;8;0;0;0;0;.00nan;0;0
1159;34786;12;0;0;0;0;.00nan;0;0
1160;500;4182;93;18;0;18;1.000;3600000;0
1160;738;27;0;0;0;0;.00nan;0;0
1160;25521;4182;0;0;0;0;.00nan;0;0
1160;26623;27;62;55;7;48;.873;3600000;0
1161;717;0;90;30;1;29;.967;3900000;0
1161;1074;0;0;0;0;0;.00nan;0;0
1161;4506;33;0;0;0;0;.00nan;0;0
1161;34740;33;85;31;1;30;.968;3900000;0
1162;262;35;0;0;0;0;.00nan;0;0
1162;823;23;0;0;0;0;.00nan;0;0
1162;1430;35;55;26;4;22;.846;3558000;0
1162;10274;23;75;28;3;25;.893;3600000;0
1163;1796;16;0;0;0;0;.00nan;0;0
1163;4450;5;79;35;3;32;.914;3565000;0
1163;14321;16;92;33;1;32;.970;3600000;0
1163;19823;5;0;0;0;0;.00nan;0;0
1164;1821;3;77;31;3;28;.903;3572000;0
1164;2054;3;0;0;0;0;.00nan;0;0
1164;5385;17;0;0;0;0;.00nan;0;0
1164;23255;17;93;32;1;31;.969;3600000;0
1165;323;9;61;37;4;33;.892;3600000;0
1165;2058;28;0;0;0;0;.00nan;0;0
1165;20853;9;0;0;0;0;.00nan;0;0
1165;26824;28;47;43;6;37;.860;3565000;0
1166;61;31;0;0;0;0;.00nan;0;0
1166;1913;30;0;0;0;0;.00nan;0;0
1166;4826;30;59;45;6;39;.867;3600000;0
1166;34797;31;75;33;3;30;.909;3600000;0
1167;10103;24;0;0;0;0;.00nan;0;0
1167;13979;24;60;35;4;31;.886;3600000;0
1167;18104;10;0;0;0;0;.00nan;0;0
1167;27488;10;60;28;3;25;.893;3600000;0
1168;2423;15;0;0;0;0;.00nan;0;0
1168;4106;15;55;27;3;24;.889;3600000;0
1168;13842;34;63;36;4;32;.889;3225000;0
1168;15502;34;50;1;0;1;1.000;375000;0
1169;1251;14;0;0;0;0;.00nan;0;0
1169;25584;14;50;35;5;30;.857;3513000;0
1169;27739;22;83;42;3;39;.929;3600000;0
1169;28026;22;0;0;0;0;.00nan;0;0
1170;738;27;0;0;0;0;.00nan;0;0
1170;15505;8;69;38;4;34;.895;3600000;0
1170;25076;8;0;0;0;0;.00nan;0;0
1170;26623;27;100;31;0;31;1.000;3600000;0
1171;823;23;0;0;0;0;.00nan;0;0
1171;10274;23;44;32;5;27;.844;3600000;0
1171;15464;32;95;18;0;18;1.000;3600000;0
1171;16006;32;0;0;0;0;.00nan;0;0
1172;233;29;58;18;2;16;.889;3600000;0
1172;445;12;0;0;0;0;.00nan;0;0
1172;18351;29;0;0;0;0;.00nan;0;0
1172;34786;12;83;46;4;42;.913;3555000;0
1173;544;19;65;25;3;22;.880;3600000;0
1173;1572;4838;0;0;0;0;.00nan;0;0
1173;2328;4838;74;48;5;43;.896;3549000;0
1173;31124;19;0;0;0;0;.00nan;0;0
1174;335;18;56;25;3;22;.880;3546000;0
1174;500;4182;100;40;1;39;.975;3600000;0
1174;5001;18;0;0;0;0;.00nan;0;0
1174;25521;4182;0;0;0;0;.00nan;0;0
1175;51;21;78;24;2;22;.917;3600000;0
1175;22601;26;0;0;0;0;.00nan;0;0
1175;25843;21;0;0;0;0;.00nan;0;0
1175;32754;26;94;47;3;44;.936;3600000;0
1176;1251;14;94;31;2;29;.935;3600000;0
1176;18104;10;50;25;4;21;.840;3572000;0
1176;25584;14;0;0;0;0;.00nan;0;0
1176;27488;10;0;0;0;0;.00nan;0;0
1177;717;0;0;0;0;0;.00nan;0;0
1177;1074;0;75;31;3;28;.903;3600000;0
1177;13842;34;0;0;0;0;.00nan;0;0
1177;15502;34;85;28;1;27;.964;3600000;0
1178;1572;4838;99;35;1;34;.971;3600000;0
1178;2328;4838;0;0;0;0;.00nan;0;0
1178;4506;33;43;26;5;21;.808;3600000;0
1178;34740;33;0;0;0;0;.00nan;0;0
1179;724;11;93;36;2;34;.944;3600000;0
1179;1614;25;41;2;1;1;.500;262000;0
1179;21522;11;0;0;0;0;.00nan;0;0
1179;34006;25;55;37;6;31;.838;3338000;0
1180;2058;28;0;0;0;0;.00nan;0;0
1180;4450;5;73;21;1;20;.952;3600000;0
1180;19823;5;0;0;0;0;.00nan;0;0
1180;26824;28;78;36;2;34;.944;3574000;0
1181;1796;16;0;0;0;0;.00nan;0;0
1181;5385;17;68;46;5;41;.891;3600000;0
1181;14321;16;91;22;0;22;1.000;3600000;0
1181;23255;17;0;0;0;0;.00nan;0;0
1182;1821;3;89;56;4;52;.929;3756000;0
1182;2054;3;0;0;0;0;.00nan;0;0
1182;27739;22;66;29;3;26;.897;3756000;0
1182;28026;22;0;0;0;0;.00nan;0;0
1183;233;29;100;30;0;30;1.000;3600000;0
1183;1913;30;0;0;0;0;.00nan;0;0
1183;4826;30;77;45;5;40;.889;3600000;0
1183;18351;29;0;0;0;0;.00nan;0;0
1184;928;20;0;0;0;0;.00nan;0;0
1184;2423;15;67;24;2;22;.917;3543000;0
1184;4106;15;0;0;0;0;.00nan;0;0
1184;18078;20;99;40;1;39;.975;3600000;0
1185;323;9;49;36;5;31;.861;3600000;0
1185;10103;24;0;0;0;0;.00nan;0;0
1185;13979;24;84;30;1;29;.967;3600000;0
1185;20853;9;0;0;0;0;.00nan;0;0
1186;724;11;0;0;0;0;.00nan;0;0
1186;15505;8;43;40;7;33;.825;3600000;0
1186;21522;11;59;29;3;26;.897;3600000;0
1186;25076;8;0;0;0;0;.00nan;0;0
1187;738;27;0;0;0;0;.00nan;0;0
1187;15464;32;32;12;4;8;.667;977000;0
1187;16006;32;49;19;3;16;.842;2623000;0
1187;26623;27;99;54;2;52;.963;3600000;0
1188;262;35;0;0;0;0;.00nan;0;0
1188;445;12;0;0;0;0;.00nan;0;0
1188;1430;35;92;24;1;23;.958;3900000;0
1188;34786;12;97;59;1;58;.983;3900000;0
1189;51;21;0;0;0;0;.00nan;0;0
1189;1614;25;69;44;5;39;.886;3749000;0
1189;25843;21;46;30;6;24;.800;3749000;0
1189;34006;25;0;0;0;0;.00nan;0;0
1190;500;4182;73;37;3;34;.919;3900000;0
1190;544;19;59;28;3;25;.893;3900000;0
1190;25521;4182;0;0;0;0;.00nan;0;0
1190;31124;19;0;0;0;0;.00nan;0;0
1191;335;18;56;27;3;24;.889;3600000;0
1191;5001;18;0;0;0;0;.00nan;0;0
1191;22601;26;0;0;0;0;.00nan;0;0
1191;32754;26;100;30;0;30;1.000;3600000;0
1192;717;0;0;0;0;0;.00nan;0;0
1192;928;20;0;0;0;0;.00nan;0;0
1192;1074;0;66;41;5;36;.878;3600000;0
1192;18078;20;91;32;1;31;.969;3600000;0
1193;61;31;0;0;0;0;.00nan;0;0
1193;4506;33;98;49;3;46;.939;3600000;0
1193;34740;33;0;0;0;0;.00nan;0;0
1193;34797;31;86;38;2;36;.947;3600000;0
1194;500;4182;0;0;0;0;.00nan;0;0
1194;823;23;0;0;0;0;.00nan;0;0
1194;10274;23;100;37;1;36;.973;3600000;0
1194;25521;4182;56;30;4;26;.867;3600000;0
1195;2423;15;54;28;4;24;.857;3582000;0
1195;4106;15;0;0;0;0;.00nan;0;0
1195;4450;5;0;0;0;0;.00nan;0;0
1195;19823;5;80;31;2;29;.935;3600000;0
1196;1251;14;0;0;0;0;.00nan;0;0
1196;5385;17;88;42;2;40;.952;3900000;0
1196;23255;17;0;0;0;0;.00nan;0;0
1196;25584;14;73;28;2;26;.929;3900000;0
1197;717;0;58;42;6;36;.857;3600000;0
1197;1074;0;0;0;0;0;.00nan;0;0
1197;27739;22;90;34;2;32;.941;3600000;0
1197;28026;22;0;0;0;0;.00nan;0;0
1198;1821;3;73;40;4;36;.900;3600000;0
1198;2054;3;0;0;0;0;.00nan;0;0
1198;2058;28;54;6;1;5;.833;251000;0
1198;26824;28;26;24;6;18;.750;3349000;0
1199;233;29;100;39;1;38;.974;3600000;0
1199;4506;33;0;0;0;0;.00nan;0;0
1199;18351;29;0;0;0;0;.00nan;0;0
1199;34740;33;87;37;2;35;.946;3579000;0
1200;323;9;64;15;1;14;.933;1325000;0
1200;18104;10;0;0;0;0;.00nan;0;0
1200;20853;9;27;30;6;24;.800;2275000;0
1200;27488;10;83;32;3;29;.906;3600000;0
1201;262;35;0;0;0;0;.00nan;0;0
1201;1430;35;72;33;3;30;.909;3600000;0
1201;1796;16;0;0;0;0;.00nan;0;0
1201;14321;16;100;47;0;47;1.000;3600000;0
1202;15464;32;0;0;0;0;.00nan;0;0
1202;15505;8;71;34;3;31;.912;3558000;0
1202;16006;32;71;20;1;19;.950;3600000;0
1202;25076;8;0;0;0;0;.00nan;0;0
1203;445;12;0;0;0;0;.00nan;0;0
1203;738;27;0;0;0;0;.00nan;0;0
1203;26623;27;93;21;0;21;1.000;3600000;0
1203;34786;12;61;27;3;24;.889;3600000;0
1204;1614;25;77;39;4;35;.897;3600000;0
1204;10103;24;0;0;0;0;.00nan;0;0
1204;13979;24;100;30;0;30;1.000;3600000;0
1204;34006;25;0;0;0;0;.00nan;0;0
1205;544;19;51;41;6;35;.854;3600000;0
1205;22601;26;54;11;1;10;.909;546000;0
1205;31124;19;0;0;0;0;.00nan;0;0
1205;32754;26;26;20;6;14;.700;3032000;0
1206;335;18;0;0;0;0;.00nan;0;0
1206;823;23;84;29;2;27;.931;3900000;0
1206;5001;18;77;32;2;30;.938;3900000;0
1206;10274;23;0;0;0;0;.00nan;0;0
1207;724;11;67;31;3;28;.903;3600000;0
1207;13842;34;65;24;2;22;.917;3600000;0
1207;15502;34;0;0;0;0;.00nan;0;0
1207;21522;11;0;0;0;0;.00nan;0;0
1208;51;21;100;30;1;29;.967;3600000;0
1208;1572;4838;0;0;0;0;.00nan;0;0
1208;2328;4838;72;31;2;29;.935;3579000;0
1208;25843;21;0;0;0;0;.00nan;0;0
1209;61;31;0;0;0;0;.00nan;0;0
1209;323;9;61;34;4;30;.882;3585000;0
1209;20853;9;0;0;0;0;.00nan;0;0
1209;34797;31;64;23;3;20;.870;3600000;0
1210;928;20;0;0;0;0;.00nan;0;0
1210;1821;3;0;0;0;0;.00nan;0;0
1210;2054;3;71;38;3;35;.921;3542000;0
1210;18078;20;49;15;2;13;.867;3600000;0
1211;1251;14;0;0;0;0;.00nan;0;0
1211;5385;17;0;0;0;0;.00nan;0;0
1211;23255;17;93;42;3;39;.929;3600000;0
1211;25584;14;45;27;4;23;.852;3563000;0
1212;1796;16;0;0;0;0;.00nan;0;0
1212;14321;16;56;24;3;21;.875;3568000;0
1212;15464;32;67;26;2;24;.923;3600000;0
1212;16006;32;0;0;0;0;.00nan;0;0
1213;262;35;0;0;0;0;.00nan;0;0
1213;738;27;0;0;0;0;.00nan;0;0
1213;1430;35;100;27;0;27;1.000;3600000;0
1213;26623;27;63;27;3;24;.889;3600000;0
1214;1913;30;0;0;0;0;.00nan;0;0
1214;4826;30;100;44;1;43;.977;3600000;0
1214;13842;34;0;0;0;0;.00nan;0;0
1214;15502;34;48;17;3;14;.824;3549000;0
1215;1614;25;80;38;3;35;.921;3570000;0
1215;27739;22;87;34;2;32;.941;3600000;0
1215;28026;22;0;0;0;0;.00nan;0;0
1215;34006;25;0;0;0;0;.00nan;0;0
1216;335;18;34;31;6;25;.806;3297000;0
1216;445;12;0;0;0;0;.00nan;0;0
1216;5001;18;48;0;0;0;.00nan;218000;0
1216;34786;12;89;49;4;45;.918;3600000;0
1217;10103;24;0;0;0;0;.00nan;0;0
1217;13979;24;48;23;4;19;.826;3900000;0
1217;22601;26;0;0;0;0;.00nan;0;0
1217;32754;26;97;54;4;50;.926;3900000;0
1218;51;21;42;45;7;38;.844;3600000;0
1218;500;4182;70;24;2;22;.917;3600000;0
1218;25521;4182;0;0;0;0;.00nan;0;0
1218;25843;21;0;0;0;0;.00nan;0;0
1219;1251;14;0;0;0;0;.00nan;0;0
1219;1821;3;57;27;4;23;.852;3530000;0
1219;2054;3;0;0;0;0;.00nan;0;0
1219;25584;14;92;42;2;40;.952;3600000;0
1220;262;35;0;0;0;0;.00nan;0;0
1220;717;0;0;0;0;0;.00nan;0;0
1220;1074;0;69;38;4;34;.895;3900000;0
1220;1430;35;57;28;4;24;.857;3900000;0
1221;233;29;68;28;2;26;.929;3546000;0
1221;323;9;0;0;0;0;.00nan;0;0
1221;18351;29;0;0;0;0;.00nan;0;0
1221;20853;9;87;33;1;32;.970;3600000;0
1222;61;31;0;0;0;0;.00nan;0;0
1222;928;20;0;0;0;0;.00nan;0;0
1222;18078;20;51;18;3;15;.833;3600000;0
1222;34797;31;58;32;4;28;.875;3543000;0
1223;4506;33;74;45;5;40;.889;3600000;0
1223;18104;10;0;0;0;0;.00nan;0;0
1223;27488;10;83;35;2;33;.943;3600000;0
1223;34740;33;0;0;0;0;.00nan;0;0
1224;1796;16;0;0;0;0;.00nan;0;0
1224;4450;5;48;24;4;20;.833;3600000;0
1224;14321;16;32;29;6;23;.793;3600000;0
1224;19823;5;0;0;0;0;.00nan;0;0
1225;724;11;88;26;1;25;.962;3600000;0
1225;1913;30;0;0;0;0;.00nan;0;0
1225;4826;30;92;39;2;37;.949;3600000;0
1225;21522;11;0;0;0;0;.00nan;0;0
1226;738;27;0;0;0;0;.00nan;0;0
1226;13842;34;97;32;1;31;.969;3600000;0
1226;15502;34;0;0;0;0;.00nan;0;0
1226;26623;27;48;20;3;17;.850;3562000;0
1227;2058;28;0;0;0;0;.00nan;0;0
1227;5385;17;0;0;0;0;.00nan;0;0
1227;23255;17;90;51;3;48;.941;3600000;0
1227;26824;28;61;34;4;30;.882;3600000;0
1228;445;12;0;0;0;0;.00nan;0;0
1228;823;23;0;0;0;0;.00nan;0;0
1228;10274;23;75;40;4;36;.900;3592000;0
1228;34786;12;89;33;3;30;.909;3600000;0
1229;15505;8;25;13;4;9;.692;993000;0
1229;22601;26;76;33;2;31;.939;3600000;0
1229;25076;8;70;19;1;18;.947;2607000;0
1229;32754;26;0;0;0;0;.00nan;0;0
1230;500;4182;95;41;2;39;.951;3600000;0
1230;25521;4182;0;0;0;0;.00nan;0;0
1230;27739;22;57;28;4;24;.857;3576000;0
1230;28026;22;0;0;0;0;.00nan;0;0
1231;1572;4838;0;0;0;0;.00nan;0;0
1231;1614;25;69;31;3;28;.903;3580000;0
1231;2328;4838;78;23;1;22;.957;3600000;0
1231;34006;25;0;0;0;0;.00nan;0;0
1232;717;0;53;37;5;32;.865;3600000;0
1232;1074;0;0;0;0;0;.00nan;0;0
1232;1251;14;0;0;0;0;.00nan;0;0
1232;25584;14;71;18;1;17;.944;3600000;0
1233;233;29;86;30;2;28;.933;3600000;0
1233;1821;3;60;38;5;33;.868;3600000;0
1233;2054;3;0;0;0;0;.00nan;0;0
1233;18351;29;0;0;0;0;.00nan;0;0
1234;61;31;0;0;0;0;.00nan;0;0
1234;323;9;78;51;5;46;.902;3530000;0
1234;20853;9;0;0;0;0;.00nan;0;0
1234;34797;31;50;24;3;21;.875;3600000;0
1235;51;21;70;18;1;17;.944;3600000;0
1235;5385;17;72;48;5;43;.896;3600000;0
1235;23255;17;0;0;0;0;.00nan;0;0
1235;25843;21;0;0;0;0;.00nan;0;0
1236;928;20;0;0;0;0;.00nan;0;0
1236;18078;20;68;23;2;21;.913;3600000;0
1236;18104;10;0;0;0;0;.00nan;0;0
1236;27488;10;72;29;3;26;.897;3566000;0
1237;2423;15;88;46;3;43;.935;3900000;0
1237;4106;15;0;0;0;0;.00nan;0;0
1237;4450;5;0;0;0;0;.00nan;0;0
1237;19823;5;61;31;3;28;.903;3900000;0
1238;4506;33;72;37;4;33;.892;3600000;0
1238;10103;24;73;21;1;20;.952;3600000;0
1238;13979;24;0;0;0;0;.00nan;0;0
1238;34740;33;0;0;0;0;.00nan;0;0
1239;262;35;0;0;0;0;.00nan;0;0
1239;335;18;61;23;3;20;.870;3555000;0
1239;1430;35;70;32;2;30;.938;3600000;0
1239;5001;18;0;0;0;0;.00nan;0;0
1240;445;12;0;0;0;0;.00nan;0;0
1240;544;19;62;29;3;26;.897;3558000;0
1240;31124;19;0;0;0;0;.00nan;0;0
1240;34786;12;92;39;2;37;.949;3600000;0
1241;724;11;0;0;0;0;.00nan;0;0
1241;15505;8;73;22;1;21;.955;3600000;0
1241;21522;11;65;33;3;30;.909;3574000;0
1241;25076;8;0;0;0;0;.00nan;0;0
1242;738;27;0;0;0;0;.00nan;0;0
1242;1796;16;0;0;0;0;.00nan;0;0
1242;14321;16;71;18;1;17;.944;3560000;0
1242;26623;27;100;23;0;23;1.000;3600000;0
1243;2058;28;0;0;0;0;.00nan;0;0
1243;13842;34;100;41;1;40;.976;3600000;0
1243;15502;34;0;0;0;0;.00nan;0;0
1243;26824;28;72;31;2;29;.935;3566000;0
1244;262;35;0;0;0;0;.00nan;0;0
1244;1430;35;53;16;2;14;.875;3600000;0
1244;1572;4838;72;21;1;20;.952;3184000;0
1244;2328;4838;32;8;3;5;.625;352000;0
1245;823;23;0;0;0;0;.00nan;0;0
1245;1614;25;75;28;2;26;.929;3600000;0
1245;10274;23;74;44;4;40;.909;3526000;0
1245;34006;25;0;0;0;0;.00nan;0;0
1246;22601;26;0;0;0;0;.00nan;0;0
1246;27739;22;81;23;1;22;.957;3600000;0
1246;28026;22;0;0;0;0;.00nan;0;0
1246;32754;26;62;28;3;25;.893;3600000;0
1247;4450;5;58;18;2;16;.889;3600000;0
1247;18104;10;0;0;0;0;.00nan;0;0
1247;19823;5;0;0;0;0;.00nan;0;0
1247;27488;10;77;45;4;41;.911;3600000;0
1248;928;20;0;0;0;0;.00nan;0;0
1248;5385;17;0;0;0;0;.00nan;0;0
1248;18078;20;41;26;6;20;.769;3589000;0
1248;23255;17;67;33;4;29;.879;3600000;0
1249;717;0;0;0;0;0;.00nan;0;0
1249;1074;0;66;42;5;37;.881;3600000;0
1249;2058;28;93;37;2;35;.946;3600000;0
1249;26824;28;0;0;0;0;.00nan;0;0
1250;323;9;78;39;3;36;.923;3600000;0
1250;2423;15;40;21;4;17;.810;3572000;0
1250;4106;15;0;0;0;0;.00nan;0;0
1250;20853;9;0;0;0;0;.00nan;0;0
1251;233;29;62;17;1;16;.941;3600000;0
1251;15464;32;63;39;4;35;.897;3600000;0
1251;16006;32;0;0;0;0;.00nan;0;0
1251;18351;29;0;0;0;0;.00nan;0;0
1252;61;31;0;0;0;0;.00nan;0;0
1252;1821;3;100;38;1;37;.974;3900000;0
1252;2054;3;0;0;0;0;.00nan;0;0
1252;34797;31;77;26;1;25;.962;3900000;0
1253;51;21;81;41;3;38;.927;3600000;0
1253;10103;24;0;0;0;0;.00nan;0;0
1253;13979;24;100;32;0;32;1.000;3600000;0
1253;25843;21;0;0;0;0;.00nan;0;0
1254;445;12;79;28;2;26;.929;3600000;0
1254;1572;4838;0;0;0;0;.00nan;0;0
1254;2328;4838;81;40;3;37;.925;3565000;0
1254;34786;12;0;0;0;0;.00nan;0;0
1255;335;18;75;25;1;24;.960;3600000;0
1255;544;19;52;31;5;26;.839;3600000;0
1255;5001;18;0;0;0;0;.00nan;0;0
1255;31124;19;0;0;0;0;.00nan;0;0
1256;1796;16;0;0;0;0;.00nan;0;0
1256;14321;16;46;21;3;18;.857;3600000;0
1256;22601;26;98;59;4;55;.932;3600000;0
1256;32754;26;0;0;0;0;.00nan;0;0
1257;724;11;95;33;1;32;.970;3600000;0
1257;1913;30;0;0;0;0;.00nan;0;0
1257;4826;30;76;40;3;37;.925;3600000;0
1257;21522;11;0;0;0;0;.00nan;0;0
1258;738;27;0;0;0;0;.00nan;0;0
1258;15505;8;62;23;3;20;.870;3600000;0
1258;25076;8;0;0;0;0;.00nan;0;0
1258;26623;27;31;28;6;22;.786;3600000;0
1259;61;31;0;0;0;0;.00nan;0;0
1259;233;29;0;0;0;0;.00nan;0;0
1259;18351;29;99;55;5;50;.909;3862000;0
1259;34797;31;53;38;6;32;.842;3833000;0
1260;51;21;0;0;0;0;.00nan;0;0
1260;323;9;0;0;0;0;.00nan;0;0
1260;20853;9;90;32;1;31;.969;3543000;0
1260;25843;21;100;28;0;28;1.000;3600000;0
1261;928;20;0;0;0;0;.00nan;0;0
1261;10103;24;0;0;0;0;.00nan;0;0
1261;13979;24;51;38;6;32;.842;3600000;0
1261;18078;20;99;35;1;34;.971;3600000;0
1262;4450;5;52;8;1;7;.875;608000;0
1262;18104;10;91;36;1;35;.972;3600000;0
1262;19823;5;48;34;6;28;.824;2992000;0
1262;27488;10;0;0;0;0;.00nan;0;0
1263;1251;14;94;34;1;33;.971;2440000;0
1263;2423;15;0;0;0;0;.00nan;0;0
1263;4106;15;66;38;4;34;.895;3600000;0
1263;25584;14;23;11;4;7;.636;1111000;0
1264;1821;3;99;38;2;36;.947;3600000;0
1264;2054;3;0;0;0;0;.00nan;0;0
1264;27739;22;15;26;7;19;.731;3015000;0
1264;28026;22;51;3;0;3;1.000;585000;0
1265;823;23;0;0;0;0;.00nan;0;0
1265;10274;23;58;40;5;35;.875;3600000;0
1265;13842;34;76;26;2;24;.923;3600000;0
1265;15502;34;0;0;0;0;.00nan;0;0
1266;262;35;0;0;0;0;.00nan;0;0
1266;1430;35;56;30;4;26;.867;3557000;0
1266;15464;32;0;0;0;0;.00nan;0;0
1266;16006;32;66;34;3;31;.912;3600000;0
1267;1614;25;0;0;0;0;.00nan;0;0
1267;4506;33;70;29;2;27;.931;3543000;0
1267;34006;25;67;21;1;20;.952;3600000;0
1267;34740;33;0;0;0;0;.00nan;0;0
1268;500;4182;94;28;1;27;.964;3600000;0
1268;738;27;0;0;0;0;.00nan;0;0
1268;25521;4182;0;0;0;0;.00nan;0;0
1268;26623;27;48;37;6;31;.838;3600000;0
1269;1796;16;63;24;2;22;.917;3600000;0
1269;1913;30;66;45;5;40;.889;3600000;0
1269;4826;30;0;0;0;0;.00nan;0;0
1269;14321;16;0;0;0;0;.00nan;0;0
1270;1251;14;0;0;0;0;.00nan;0;0
1270;15505;8;0;0;0;0;.00nan;0;0
1270;25076;8;100;26;0;26;1.000;3600000;0
1270;25584;14;66;36;4;32;.889;3600000;0
1271;61;31;0;0;0;0;.00nan;0;0
1271;4450;5;60;27;3;24;.889;3600000;0
1271;19823;5;0;0;0;0;.00nan;0;0
1271;34797;31;100;25;0;25;1.000;3600000;0
1272;717;0;27;38;8;30;.789;3600000;0
1272;1074;0;0;0;0;0;.00nan;0;0
1272;5385;17;60;13;1;12;.923;3600000;0
1272;23255;17;0;0;0;0;.00nan;0;0
1273;51;21;80;23;1;22;.957;3600000;0
1273;2058;28;96;38;2;36;.947;3082000;0
1273;25843;21;0;0;0;0;.00nan;0;0
1273;26824;28;28;8;3;5;.625;518000;0
1274;323;9;91;33;2;31;.939;3600000;0
1274;1821;3;58;33;5;28;.848;3600000;0
1274;2054;3;0;0;0;0;.00nan;0;0
1274;20853;9;0;0;0;0;.00nan;0;0
1275;233;29;60;19;2;17;.895;3600000;0
1275;13842;34;53;36;5;31;.861;3600000;0
1275;15502;34;0;0;0;0;.00nan;0;0
1275;18351;29;0;0;0;0;.00nan;0;0
1276;10103;24;0;0;0;0;.00nan;0;0
1276;13979;24;84;38;2;36;.947;3551000;0
1276;18104;10;0;0;0;0;.00nan;0;0
1276;27488;10;81;25;1;24;.960;3600000;0
1277;823;23;0;0;0;0;.00nan;0;0
1277;2423;15;68;34;4;30;.882;3600000;0
1277;4106;15;0;0;0;0;.00nan;0;0
1277;10274;23;49;32;5;27;.844;3595000;0
1278;928;20;0;0;0;0;.00nan;0;0
1278;18078;20;67;25;2;23;.920;3600000;0
1278;27739;22;0;0;0;0;.00nan;0;0
1278;28026;22;28;24;5;19;.792;3600000;0
1279;544;19;43;22;4;18;.818;3600000;0
1279;15464;32;89;28;1;27;.964;3600000;0
1279;16006;32;0;0;0;0;.00nan;0;0
1279;31124;19;0;0;0;0;.00nan;0;0
1280;445;12;0;0;0;0;.00nan;0;0
1280;500;4182;0;0;0;0;.00nan;0;0
1280;25521;4182;57;27;3;24;.889;3600000;0
1280;34786;12;69;56;6;50;.893;3600000;0
1281;262;35;0;0;0;0;.00nan;0;0
1281;1430;35;92;47;4;43;.915;3900000;0
1281;22601;26;0;0;0;0;.00nan;0;0
1281;32754;26;63;37;4;33;.892;3900000;0
1282;1614;25;83;35;2;33;.943;3579000;0
1282;1796;16;0;0;0;0;.00nan;0;0
1282;14321;16;78;26;1;25;.962;3600000;0
1282;34006;25;0;0;0;0;.00nan;0;0
1283;335;18;95;29;1;28;.966;3600000;0
1283;1572;4838;0;0;0;0;.00nan;0;0
1283;2328;4838;55;42;6;36;.857;3600000;0
1283;5001;18;0;0;0;0;.00nan;0;0
1284;738;27;0;0;0;0;.00nan;0;0
1284;1913;30;0;0;0;0;.00nan;0;0
1284;4826;30;45;35;5;30;.857;3600000;0
1284;26623;27;81;30;2;28;.933;3600000;0
1285;500;4182;69;19;2;17;.895;3600000;0
1285;15505;8;0;0;0;0;.00nan;0;0
1285;25076;8;79;40;3;37;.925;3600000;0
1285;25521;4182;0;0;0;0;.00nan;0;0
1286;445;12;0;0;0;0;.00nan;0;0
1286;22601;26;85;30;2;28;.933;3600000;0
1286;32754;26;0;0;0;0;.00nan;0;0
1286;34786;12;61;40;5;35;.875;3600000;0
1287;1251;14;0;0;0;0;.00nan;0;0
1287;4506;33;91;28;1;27;.964;3600000;0
1287;25584;14;72;35;3;32;.914;3566000;0
1287;34740;33;0;0;0;0;.00nan;0;0
1288;724;11;72;25;2;23;.920;3600000;0
1288;1572;4838;69;31;3;28;.903;3600000;0
1288;2328;4838;0;0;0;0;.00nan;0;0
1288;21522;11;0;0;0;0;.00nan;0;0
1289;4450;5;99;29;1;28;.966;3600000;0
1289;5385;17;30;29;6;23;.793;3032000;0
1289;19823;5;0;0;0;0;.00nan;0;0
1289;23255;17;57;9;0;9;1.000;568000;0
1290;61;31;0;0;0;0;.00nan;0;0
1290;2058;28;0;0;0;0;.00nan;0;0
1290;26824;28;87;29;1;28;.966;3600000;0
1290;34797;31;60;36;4;32;.889;3600000;0
1291;233;29;51;39;5;34;.872;3515000;0
1291;928;20;0;0;0;0;.00nan;0;0
1291;18078;20;56;24;3;21;.875;3600000;0
1291;18351;29;0;0;0;0;.00nan;0;0
1292;13842;34;95;46;3;43;.935;3900000;0
1292;15502;34;0;0;0;0;.00nan;0;0
1292;27739;22;62;27;3;24;.889;3900000;0
1292;28026;22;0;0;0;0;.00nan;0;0
1293;51;21;26;26;6;20;.769;3600000;0
1293;10103;24;100;42;1;41;.976;3600000;0
1293;13979;24;0;0;0;0;.00nan;0;0
1293;25843;21;0;0;0;0;.00nan;0;0
1294;262;35;0;0;0;0;.00nan;0;0
1294;544;19;0;0;0;0;.00nan;0;0
1294;1430;35;81;45;4;41;.911;3711000;0
1294;31124;19;63;37;5;32;.865;3711000;0
1295;1614;25;64;32;4;28;.875;3847000;0
1295;15464;32;42;24;4;20;.833;3900000;0
1295;16006;32;0;0;0;0;.00nan;0;0
1295;34006;25;0;0;0;0;.00nan;0;0
1296;738;27;0;0;0;0;.00nan;0;0
1296;823;23;55;4;0;4;1.000;364000;0
1296;10274;23;22;35;8;27;.771;3236000;0
1296;26623;27;80;27;2;25;.926;3600000;0
1297;5385;17;0;0;0;0;.00nan;0;0
1297;15505;8;0;0;0;0;.00nan;0;0
1297;23255;17;49;32;5;27;.844;3595000;0
1297;25076;8;55;33;4;29;.879;3600000;0
1298;1821;3;62;28;4;24;.857;3576000;0
1298;2054;3;0;0;0;0;.00nan;0;0
1298;4450;5;0;0;0;0;.00nan;0;0
1298;19823;5;100;36;2;34;.944;3600000;0
1299;61;31;48;23;4;19;.826;3614000;0
1299;717;0;0;0;0;0;.00nan;0;0
1299;1074;0;85;43;3;40;.930;3614000;0
1299;34797;31;0;0;0;0;.00nan;0;0
1300;51;21;0;0;0;0;.00nan;0;0
1300;323;9;57;24;3;21;.875;3557000;0
1300;20853;9;0;0;0;0;.00nan;0;0
1300;25843;21;69;25;2;23;.920;3600000;0
1301;18104;10;0;0;0;0;.00nan;0;0
1301;27488;10;45;19;3;16;.842;3576000;0
1301;27739;22;0;0;0;0;.00nan;0;0
1301;28026;22;92;45;2;43;.956;3600000;0
1302;1251;14;0;0;0;0;.00nan;0;0
1302;2058;28;81;26;2;24;.923;3600000;0
1302;25584;14;60;34;5;29;.853;3600000;0
1302;26824;28;0;0;0;0;.00nan;0;0
1303;2423;15;73;33;3;30;.909;3577000;0
1303;4106;15;0;0;0;0;.00nan;0;0
1303;10103;24;0;0;0;0;.00nan;0;0
1303;13979;24;76;35;2;33;.943;3600000;0
1304;233;29;53;10;1;9;.900;1445000;0
1304;13842;34;0;0;0;0;.00nan;0;0
1304;15502;34;99;49;3;46;.939;3600000;0
1304;18351;29;11;16;6;10;.625;2155000;0
1305;500;4182;87;21;1;20;.952;3900000;0
1305;1796;16;0;0;0;0;.00nan;0;0
1305;14321;16;93;27;1;26;.963;3900000;0
1305;25521;4182;0;0;0;0;.00nan;0;0
1306;445;12;0;0;0;0;.00nan;0;0
1306;1913;30;0;0;0;0;.00nan;0;0
1306;4826;30;89;37;2;35;.946;3600000;0
1306;34786;12;81;37;3;34;.919;3552000;0
1307;262;35;0;0;0;0;.00nan;0;0
1307;1430;35;61;30;3;27;.900;3600000;0
1307;1614;25;0;0;0;0;.00nan;0;0
1307;34006;25;97;23;0;23;1.000;3600000;0
1308;544;19;69;35;4;31;.886;3730000;0
1308;4506;33;72;34;3;31;.912;3730000;0
1308;31124;19;0;0;0;0;.00nan;0;0
1308;34740;33;0;0;0;0;.00nan;0;0
1309;335;18;45;22;4;18;.818;3600000;0
1309;724;11;0;0;0;0;.00nan;0;0
1309;5001;18;0;0;0;0;.00nan;0;0
1309;21522;11;99;37;1;36;.973;3600000;0
1310;15464;32;0;0;0;0;.00nan;0;0
1310;16006;32;77;28;2;26;.929;3600000;0
1310;22601;26;0;0;0;0;.00nan;0;0
1310;32754;26;95;35;1;34;.971;3600000;0
1311;738;27;0;0;0;0;.00nan;0;0
1311;1572;4838;0;0;0;0;.00nan;0;0
1311;2328;4838;43;39;6;33;.846;3536000;0
1311;26623;27;41;22;4;18;.818;3600000;0
2701;233;29;0;0;0;0;.00nan;0;0
2701;738;27;0;0;0;0;.00nan;0;0
2701;18351;29;59;21;2;19;.905;3600000;0
2701;26623;27;73;39;4;35;.897;3581000;0
2703;262;35;0;0;0;0;.00nan;0;0
2703;1430;35;97;64;3;61;.953;3900000;0
2703;1796;16;46;14;3;11;.786;3900000;0
2703;15437;16;0;0;0;0;.00nan;0;0
2705;544;19;45;37;6;31;.838;3600000;0
2705;15505;8;100;42;0;42;1.000;3600000;0
2705;25076;8;0;0;0;0;.00nan;0;0
2705;31124;19;0;0;0;0;.00nan;0;0
2707;724;11;0;0;0;0;.00nan;0;0
2707;2423;15;76;38;2;36;.947;3900000;0
2707;4106;15;0;0;0;0;.00nan;0;0
2707;21522;11;74;24;2;22;.917;3900000;0
2709;823;23;0;0;0;0;.00nan;0;0
2709;1251;14;66;23;2;21;.913;3600000;0
2709;10274;23;34;33;6;27;.818;3600000;0
2709;25584;14;0;0;0;0;.00nan;0;0
2711;323;9;51;37;5;32;.865;3600000;0
2711;5385;17;0;0;0;0;.00nan;0;0
2711;20853;9;0;0;0;0;.00nan;0;0
2711;34006;17;93;30;1;29;.967;3600000;0
2713;1913;30;0;0;0;0;.00nan;0;0
2713;4826;30;98;41;1;40;.976;3600000;0
2713;10103;24;0;0;0;0;.00nan;0;0
2713;13979;24;62;37;5;32;.865;3600000;0
2715;335;18;83;32;2;30;.938;3572000;0
2715;5001;18;0;0;0;0;.00nan;0;0
2715;27739;22;89;35;1;34;.971;3600000;0
2715;28026;22;0;0;0;0;.00nan;0;0
2717;1614;25;94;35;1;34;.971;3600000;0
2717;5182;25;0;0;0;0;.00nan;0;0
2717;13842;34;87;41;3;38;.927;3539000;0
2717;15502;34;0;0;0;0;.00nan;0;0
2719;4450;5;0;0;0;0;.00nan;0;0
2719;4506;33;88;30;1;29;.967;3900000;0
2719;19823;5;74;18;1;17;.944;3900000;0
2719;34740;33;0;0;0;0;.00nan;0;0
2721;15464;32;93;20;0;20;1.000;3600000;0
2721;16006;32;0;0;0;0;.00nan;0;0
2721;22601;26;90;39;3;36;.923;3600000;0
2721;32754;26;0;0;0;0;.00nan;0;0
2723;1074;0;100;51;2;49;.961;3900000;0
2723;18078;20;0;0;0;0;.00nan;0;0
2723;31035;0;0;0;0;0;.00nan;0;0
2723;32146;20;76;31;2;29;.935;3900000;0
2725;1572;4838;0;0;0;0;.00nan;0;0
2725;2058;28;58;46;7;39;.848;3217000;0
2725;2328;4838;83;29;1;28;.966;3600000;0
2725;14061;28;56;6;0;6;1.000;383000;0
2727;51;21;0;0;0;0;.00nan;0;0
2727;1821;3;100;20;0;20;1.000;3600000;0
2727;2054;3;0;0;0;0;.00nan;0;0
2727;25843;21;81;36;2;34;.944;3545000;0
2729;61;31;86;38;3;35;.921;3588000;0
2729;500;4182;63;26;2;24;.923;3600000;0
2729;25521;4182;0;0;0;0;.00nan;0;0
2729;34797;31;0;0;0;0;.00nan;0;0
2731;445;12;0;0;0;0;.00nan;0;0
2731;18104;10;77;26;1;25;.962;3600000;0
2731;27488;10;0;0;0;0;.00nan;0;0
2731;34786;12;79;35;2;33;.943;3572000;0
2733;51;21;0;0;0;0;.00nan;0;0
2733;4450;5;0;0;0;0;.00nan;0;0
2733;19823;5;52;24;3;21;.875;3659000;0
2733;25843;21;81;41;4;37;.902;3659000;0
2735;544;19;0;0;0;0;.00nan;0;0
2735;2423;15;50;37;6;31;.838;3600000;0
2735;4106;15;0;0;0;0;.00nan;0;0
2735;31124;19;97;50;2;48;.960;3600000;0
2737;233;29;89;24;1;23;.958;3900000;0
2737;1074;0;97;37;1;36;.973;3900000;0
2737;18351;29;0;0;0;0;.00nan;0;0
2737;31035;0;0;0;0;0;.00nan;0;0
2739;335;18;72;28;2;26;.929;3600000;0
2739;2058;28;72;31;3;28;.903;3543000;0
2739;5001;18;0;0;0;0;.00nan;0;0
2739;14061;28;0;0;0;0;.00nan;0;0
2741;61;31;25;28;6;22;.786;2233000;0
2741;1796;16;61;34;4;30;.882;3600000;0
2741;15437;16;0;0;0;0;.00nan;0;0
2741;34797;31;45;4;1;3;.750;1367000;0
2743;5385;17;0;0;0;0;.00nan;0;0
2743;22601;26;64;16;2;14;.875;3600000;0
2743;32754;26;0;0;0;0;.00nan;0;0
2743;34006;17;44;31;6;25;.806;3600000;0
2745;18104;10;47;41;6;35;.854;3745000;0
2745;27488;10;0;0;0;0;.00nan;0;0
2745;27739;22;0;0;0;0;.00nan;0;0
2745;28026;22;31;24;5;19;.792;3745000;0
2747;445;12;83;41;3;38;.927;3600000;0
2747;1913;30;0;0;0;0;.00nan;0;0
2747;4826;30;82;35;2;33;.943;3600000;0
2747;34786;12;0;0;0;0;.00nan;0;0
2749;500;4182;58;29;3;26;.897;3600000;0
2749;1251;14;76;39;4;35;.897;3584000;0
2749;25521;4182;0;0;0;0;.00nan;0;0
2749;25584;14;0;0;0;0;.00nan;0;0
2751;4506;33;100;20;0;20;1.000;3600000;0
2751;13842;34;70;40;4;36;.900;3600000;0
2751;15502;34;0;0;0;0;.00nan;0;0
2751;34740;33;0;0;0;0;.00nan;0;0
2753;738;27;84;27;1;26;.963;3600000;0
2753;15464;32;82;45;4;41;.911;3600000;0
2753;16006;32;0;0;0;0;.00nan;0;0
2753;26623;27;0;0;0;0;.00nan;0;0
2755;323;9;0;0;0;0;.00nan;0;0
2755;10103;24;0;0;0;0;.00nan;0;0
2755;13979;24;78;20;1;19;.950;3600000;0
2755;20853;9;91;53;2;51;.962;3600000;0
2757;262;35;0;0;0;0;.00nan;0;0
2757;724;11;0;0;0;0;.00nan;0;0
2757;1430;35;53;29;3;26;.897;3600000;0
2757;21522;11;25;27;6;21;.778;3600000;0
2759;15505;8;57;29;4;25;.862;3600000;0
2759;18078;20;78;29;1;28;.966;3600000;0
2759;25076;8;0;0;0;0;.00nan;0;0
2759;32146;20;0;0;0;0;.00nan;0;0
2761;1572;4838;0;0;0;0;.00nan;0;0
2761;1821;3;100;27;0;27;1.000;3600000;0
2761;2054;3;0;0;0;0;.00nan;0;0
2761;2328;4838;75;45;5;40;.889;3600000;0
2763;823;23;0;0;0;0;.00nan;0;0
2763;1614;25;33;27;5;22;.815;3600000;0
2763;5182;25;0;0;0;0;.00nan;0;0
2763;10274;23;49;53;7;46;.868;3595000;0
2765;10103;24;74;27;2;25;.926;3559000;0
2765;13979;24;0;0;0;0;.00nan;0;0
2765;15505;8;0;0;0;0;.00nan;0;0
2765;25076;8;90;38;1;37;.974;3600000;0
2767;335;18;0;0;0;0;.00nan;0;0
2767;1614;25;0;0;0;0;.00nan;0;0
2767;5001;18;54;31;5;26;.839;3596000;0
2767;5182;25;64;34;4;30;.882;3600000;0
2769;1913;30;85;33;1;32;.970;3600000;0
2769;2423;15;0;0;0;0;.00nan;0;0
2769;4106;15;35;23;5;18;.783;3600000;0
2769;4826;30;0;0;0;0;.00nan;0;0
2771;51;21;90;43;3;40;.930;3900000;0
2771;15464;32;0;0;0;0;.00nan;0;0
2771;16006;32;80;35;3;32;.914;3900000;0
2771;25843;21;0;0;0;0;.00nan;0;0
2773;724;11;34;40;7;33;.825;3600000;0
2773;1796;16;0;0;0;0;.00nan;0;0
2773;15437;16;81;13;0;13;1.000;3600000;0
2773;21522;11;0;0;0;0;.00nan;0;0
2775;323;9;77;51;5;46;.902;3900000;0
2775;1251;14;0;0;0;0;.00nan;0;0
2775;20853;9;0;0;0;0;.00nan;0;0
2775;25584;14;48;30;5;25;.833;3900000;0
2777;61;31;0;0;0;0;.00nan;0;0
2777;233;29;0;0;0;0;.00nan;0;0
2777;18351;29;41;22;4;18;.818;3600000;0
2777;34797;31;64;42;5;37;.881;3592000;0
2779;500;4182;0;0;0;0;.00nan;0;0
2779;4506;33;95;39;2;37;.949;3900000;0
2779;25521;4182;69;28;2;26;.929;3900000;0
2779;34740;33;0;0;0;0;.00nan;0;0
2781;262;35;93;34;1;33;.971;3600000;0
2781;1430;35;0;0;0;0;.00nan;0;0
2781;18078;20;0;0;0;0;.00nan;0;0
2781;32146;20;33;24;5;19;.792;3600000;0
2783;2058;28;0;0;0;0;.00nan;0;0
2783;5385;17;71;34;3;31;.912;3600000;0
2783;14061;28;60;31;4;27;.871;3567000;0
2783;34006;17;0;0;0;0;.00nan;0;0
2785;1074;0;0;0;0;0;.00nan;0;0
2785;22601;26;0;0;0;0;.00nan;0;0
2785;31035;0;100;42;1;41;.976;3600000;0
2785;32754;26;28;22;5;17;.773;3600000;0
2787;1572;4838;68;30;3;27;.900;3559000;0
2787;2328;4838;0;0;0;0;.00nan;0;0
2787;4450;5;78;25;1;24;.960;3600000;0
2787;19823;5;0;0;0;0;.00nan;0;0
2789;544;19;60;24;3;21;.875;3583000;0
2789;738;27;0;0;0;0;.00nan;0;0
2789;26623;27;85;38;2;36;.947;3600000;0
2789;31124;19;0;0;0;0;.00nan;0;0
2791;445;12;0;0;0;0;.00nan;0;0
2791;13842;34;0;0;0;0;.00nan;0;0
2791;15502;34;81;26;2;24;.923;3600000;0
2791;34786;12;78;33;3;30;.909;3550000;0
2793;823;23;78;30;2;28;.933;3600000;0
2793;10274;23;0;0;0;0;.00nan;0;0
2793;18104;10;0;0;0;0;.00nan;0;0
2793;27488;10;38;30;5;25;.833;3600000;0
2795;1821;3;100;31;0;31;1.000;3600000;0
2795;2054;3;0;0;0;0;.00nan;0;0
2795;27739;22;91;40;2;38;.950;3600000;0
2795;28026;22;0;0;0;0;.00nan;0;0
2797;61;31;0;0;0;0;.00nan;0;0
2797;1572;4838;0;0;0;0;.00nan;0;0
2797;2328;4838;74;42;4;38;.905;3572000;0
2797;34797;31;54;27;3;24;.889;3600000;0
2799;335;18;93;38;1;37;.974;3600000;0
2799;1913;30;0;0;0;0;.00nan;0;0
2799;4826;30;74;28;2;26;.929;3573000;0
2799;5001;18;0;0;0;0;.00nan;0;0
2801;15464;32;0;0;0;0;.00nan;0;0
2801;16006;32;56;28;4;24;.857;3562000;0
2801;18104;10;0;0;0;0;.00nan;0;0
2801;27488;10;85;36;3;33;.917;3600000;0
2803;262;35;0;0;0;0;.00nan;0;0
2803;1430;35;100;22;0;22;1.000;3600000;0
2803;13842;34;85;28;1;27;.964;3558000;0
2803;15502;34;0;0;0;0;.00nan;0;0
2805;823;23;44;22;4;18;.818;3600000;0
2805;10274;23;0;0;0;0;.00nan;0;0
2805;18078;20;29;21;5;16;.762;3558000;0
2805;32146;20;0;0;0;0;.00nan;0;0
2807;544;19;0;0;0;0;.00nan;0;0
2807;2423;15;95;36;1;35;.972;3600000;0
2807;4106;15;0;0;0;0;.00nan;0;0
2807;31124;19;48;22;3;19;.864;3591000;0
2809;1821;3;87;42;3;39;.929;3900000;0
2809;2054;3;0;0;0;0;.00nan;0;0
2809;15505;8;56;31;3;28;.903;3856000;0
2809;25076;8;0;0;0;0;.00nan;0;0
2811;51;21;0;0;0;0;.00nan;0;0
2811;323;9;0;0;0;0;.00nan;0;0
2811;20853;9;77;33;3;30;.909;3600000;0
2811;25843;21;95;40;2;38;.950;3600000;0
2813;1796;16;0;0;0;0;.00nan;0;0
2813;5385;17;0;0;0;0;.00nan;0;0
2813;15437;16;67;33;3;30;.909;3571000;0
2813;34006;17;99;35;1;34;.971;3600000;0
2815;738;27;76;20;1;19;.950;3600000;0
2815;1074;0;74;50;5;45;.900;3600000;0
2815;26623;27;0;0;0;0;.00nan;0;0
2815;31035;0;0;0;0;0;.00nan;0;0
2817;233;29;79;37;3;34;.919;3591000;0
2817;1251;14;58;21;2;19;.905;3600000;0
2817;18351;29;0;0;0;0;.00nan;0;0
2817;25584;14;0;0;0;0;.00nan;0;0
2819;445;12;0;0;0;0;.00nan;0;0
2819;4450;5;59;6;0;6;1.000;773000;0
2819;19823;5;27;25;6;19;.760;2827000;0
2819;34786;12;57;29;3;26;.897;3600000;0
2821;4506;33;84;35;2;33;.943;3600000;0
2821;27739;22;0;0;0;0;.00nan;0;0
2821;28026;22;45;27;4;23;.852;3516000;0
2821;34740;33;0;0;0;0;.00nan;0;0
2823;500;4182;80;31;2;29;.935;3600000;0
2823;10103;24;0;0;0;0;.00nan;0;0
2823;13979;24;46;20;3;17;.850;3600000;0
2823;25521;4182;0;0;0;0;.00nan;0;0
2825;1614;25;52;15;2;13;.867;3600000;0
2825;2058;28;71;36;3;33;.917;3560000;0
2825;5182;25;0;0;0;0;.00nan;0;0
2825;14061;28;0;0;0;0;.00nan;0;0
2827;724;11;0;0;0;0;.00nan;0;0
2827;21522;11;100;34;1;33;.971;3600000;0
2827;22601;26;88;45;4;41;.911;3600000;0
2827;32754;26;0;0;0;0;.00nan;0;0
2829;724;11;53;31;4;27;.871;3600000;0
2829;15505;8;0;0;0;0;.00nan;0;0
2829;21522;11;0;0;0;0;.00nan;0;0
2829;25076;8;99;38;1;37;.974;3600000;0
2831;61;31;58;34;5;29;.853;3567000;0
2831;18104;10;72;35;3;32;.914;3600000;0
2831;27488;10;0;0;0;0;.00nan;0;0
2831;34797;31;0;0;0;0;.00nan;0;0
2833;323;9;88;38;2;36;.947;3900000;0
2833;1796;16;61;19;2;17;.895;3900000;0
2833;15437;16;0;0;0;0;.00nan;0;0
2833;20853;9;0;0;0;0;.00nan;0;0
2835;1821;3;0;0;0;0;.00nan;0;0
2835;2054;3;70;30;3;27;.900;3553000;0
2835;4450;5;74;30;2;28;.933;3600000;0
2835;19823;5;0;0;0;0;.00nan;0;0
2837;262;35;0;0;0;0;.00nan;0;0
2837;1430;35;79;29;2;27;.931;3833000;0
2837;2423;15;0;0;0;0;.00nan;0;0
2837;4106;15;90;31;1;30;.968;3833000;0
2839;823;23;0;0;0;0;.00nan;0;0
2839;1572;4838;59;25;3;22;.880;3600000;0
2839;2328;4838;0;0;0;0;.00nan;0;0
2839;10274;23;59;35;4;31;.886;3600000;0
2841;51;21;70;35;4;31;.886;3600000;0
2841;335;18;0;0;0;0;.00nan;0;0
2841;5001;18;61;18;1;17;.944;3600000;0
2841;25843;21;0;0;0;0;.00nan;0;0
2843;544;19;77;41;3;38;.927;3526000;0
2843;10103;24;86;27;1;26;.963;3600000;0
2843;13979;24;0;0;0;0;.00nan;0;0
2843;31124;19;0;0;0;0;.00nan;0;0
2845;1251;14;0;0;0;0;.00nan;0;0
2845;13842;34;58;7;0;7;1.000;734000;0
2845;15502;34;46;42;6;36;.857;2866000;0
2845;25584;14;56;25;3;22;.880;3600000;0
2847;1074;0;0;0;0;0;.00nan;0;0
2847;5385;17;50;25;4;21;.840;3600000;0
2847;31035;0;90;39;2;37;.949;3600000;0
2847;34006;17;0;0;0;0;.00nan;0;0
2849;500;4182;0;0;0;0;.00nan;0;0
2849;4506;33;0;0;0;0;.00nan;0;0
2849;25521;4182;93;18;0;18;1.000;3600000;0
2849;34740;33;98;46;2;44;.957;3539000;0
2851;1614;25;0;0;0;0;.00nan;0;0
2851;5182;25;52;28;4;24;.857;3600000;0
2851;27739;22;71;29;3;26;.897;3600000;0
2851;28026;22;0;0;0;0;.00nan;0;0
2853;18078;20;0;0;0;0;.00nan;0;0
2853;22601;26;0;0;0;0;.00nan;0;0
2853;32146;20;61;35;4;31;.886;3600000;0
2853;32754;26;84;27;1;26;.963;3600000;0
2855;233;29;0;0;0;0;.00nan;0;0
2855;1913;30;93;55;4;51;.927;3515000;0
2855;4826;30;0;0;0;0;.00nan;0;0
2855;18351;29;62;25;3;22;.880;3600000;0
2857;738;27;0;0;0;0;.00nan;0;0
2857;15464;32;83;47;4;43;.915;3900000;0
2857;16006;32;0;0;0;0;.00nan;0;0
2857;26623;27;43;30;4;26;.867;3900000;0
2859;445;12;66;27;3;24;.889;3600000;0
2859;2058;28;0;0;0;0;.00nan;0;0
2859;14061;28;100;42;2;40;.952;3600000;0
2859;34786;12;0;0;0;0;.00nan;0;0
2861;61;31;69;24;2;22;.917;3600000;0
2861;445;12;0;0;0;0;.00nan;0;0
2861;34786;12;70;33;3;30;.909;3600000;0
2861;34797;31;0;0;0;0;.00nan;0;0
2863;1796;16;0;0;0;0;.00nan;0;0
2863;5385;17;67;29;3;26;.897;3900000;0
2863;15437;16;55;29;3;26;.897;3900000;0
2863;34006;17;0;0;0;0;.00nan;0;0
2865;51;21;0;0;0;0;.00nan;0;0
2865;4450;5;0;0;0;0;.00nan;0;0
2865;19823;5;79;21;1;20;.952;3600000;0
2865;25843;21;78;33;2;31;.939;3575000;0
2867;500;4182;0;0;0;0;.00nan;0;0
2867;1821;3;99;22;0;22;1.000;3600000;0
2867;2054;3;0;0;0;0;.00nan;0;0
2867;25521;4182;91;49;3;46;.939;3600000;0
2869;724;11;0;0;0;0;.00nan;0;0
2869;1913;30;0;0;0;0;.00nan;0;0
2869;4826;30;50;30;4;26;.867;3600000;0
2869;21522;11;34;28;6;22;.786;3544000;0
2871;335;18;0;0;0;0;.00nan;0;0
2871;5001;18;53;32;5;27;.844;3600000;0
2871;10103;24;81;36;2;34;.944;3600000;0
2871;13979;24;0;0;0;0;.00nan;0;0
2873;233;29;0;0;0;0;.00nan;0;0
2873;15464;32;93;39;2;37;.949;3900000;0
2873;16006;32;0;0;0;0;.00nan;0;0
2873;18351;29;82;31;2;29;.935;3900000;0
2875;544;19;78;44;4;40;.909;3898000;0
2875;1074;0;0;0;0;0;.00nan;0;0
2875;31035;0;82;46;3;43;.935;3898000;0
2875;31124;19;0;0;0;0;.00nan;0;0
2877;1251;14;71;47;5;42;.894;3600000;0
2877;1614;25;90;16;0;16;1.000;3600000;0
2877;5182;25;0;0;0;0;.00nan;0;0
2877;25584;14;0;0;0;0;.00nan;0;0
2879;738;27;0;0;0;0;.00nan;0;0
2879;18078;20;66;19;1;18;.947;3600000;0
2879;26623;27;66;45;4;41;.911;3600000;0
2879;32146;20;0;0;0;0;.00nan;0;0
2881;323;9;46;26;4;22;.846;3900000;0
2881;2058;28;64;35;4;31;.886;3894000;0
2881;14061;28;0;0;0;0;.00nan;0;0
2881;20853;9;0;0;0;0;.00nan;0;0
2883;4506;33;95;40;2;38;.950;3600000;0
2883;18104;10;56;32;4;28;.875;3570000;0
2883;27488;10;0;0;0;0;.00nan;0;0
2883;34740;33;0;0;0;0;.00nan;0;0
2885;15505;8;0;0;0;0;.00nan;0;0
2885;25076;8;81;31;2;29;.935;3600000;0
2885;27739;22;51;25;4;21;.840;3593000;0
2885;28026;22;0;0;0;0;.00nan;0;0
2887;823;23;0;0;0;0;.00nan;0;0
2887;10274;23;55;20;2;18;.900;3834000;0
2887;13842;34;0;0;0;0;.00nan;0;0
2887;15502;34;88;45;3;42;.933;3834000;0
2889;262;35;62;32;4;28;.875;3542000;0
2889;1430;35;0;0;0;0;.00nan;0;0
2889;2423;15;80;41;3;38;.927;3600000;0
2889;4106;15;0;0;0;0;.00nan;0;0
2891;1572;4838;0;0;0;0;.00nan;0;0
2891;2328;4838;50;33;4;29;.879;3600000;0
2891;22601;26;92;34;1;33;.971;3600000;0
2891;32754;26;0;0;0;0;.00nan;0;0
2893;61;31;0;0;0;0;.00nan;0;0
2893;1913;30;76;42;3;39;.929;3900000;0
2893;4826;30;0;0;0;0;.00nan;0;0
2893;34797;31;47;18;3;15;.833;3900000;0
2895;335;18;49;25;4;21;.840;3707000;0
2895;445;12;70;48;5;43;.896;3707000;0
2895;5001;18;0;0;0;0;.00nan;0;0
2895;34786;12;0;0;0;0;.00nan;0;0
2897;2423;15;91;24;0;24;1.000;1415000;0
2897;4106;15;23;14;4;10;.714;2140000;0
2897;13842;34;83;39;3;36;.923;3600000;0
2897;15502;34;0;0;0;0;.00nan;0;0
2899;738;27;55;36;5;31;.861;3594000;0
2899;1821;3;49;17;3;14;.824;3600000;0
2899;2054;3;0;0;0;0;.00nan;0;0
2899;26623;27;0;0;0;0;.00nan;0;0
2901;15505;8;72;25;2;23;.920;3600000;0
2901;25076;8;0;0;0;0;.00nan;0;0
2901;27739;22;0;0;0;0;.00nan;0;0
2901;28026;22;48;35;5;30;.857;3600000;0
2903;823;23;75;24;1;23;.958;3900000;0
2903;10274;23;0;0;0;0;.00nan;0;0
2903;18078;20;0;0;0;0;.00nan;0;0
2903;32146;20;100;40;1;39;.975;3900000;0
2905;51;21;100;34;0;34;1.000;3600000;0
2905;4450;5;64;26;3;23;.885;3600000;0
2905;19823;5;0;0;0;0;.00nan;0;0
2905;25843;21;0;0;0;0;.00nan;0;0
2907;1251;14;0;0;0;0;.00nan;0;0
2907;15464;32;0;0;0;0;.00nan;0;0
2907;16006;32;74;24;1;23;.958;3600000;0
2907;25584;14;61;22;2;20;.909;3600000;0
2909;544;19;0;0;0;0;.00nan;0;0
2909;22601;26;61;5;0;5;1.000;910000;0
2909;31124;19;70;30;3;27;.900;3600000;0
2909;32754;26;34;30;6;24;.800;2690000;0
2911;1074;0;88;49;3;46;.939;3600000;0
2911;5385;17;0;0;0;0;.00nan;0;0
2911;31035;0;0;0;0;0;.00nan;0;0
2911;34006;17;72;18;1;17;.944;3600000;0
2913;2058;28;0;0;0;0;.00nan;0;0
2913;10103;24;0;0;0;0;.00nan;0;0
2913;13979;24;77;26;1;25;.962;3600000;0
2913;14061;28;91;47;3;44;.936;3546000;0
2915;323;9;0;0;0;0;.00nan;0;0
2915;1796;16;77;30;2;28;.933;3542000;0
2915;15437;16;0;0;0;0;.00nan;0;0
2915;20853;9;100;40;1;39;.975;3600000;0
2917;233;29;98;26;0;26;1.000;3600000;0
2917;4506;33;0;0;0;0;.00nan;0;0
2917;18351;29;0;0;0;0;.00nan;0;0
2917;34740;33;67;32;3;29;.906;3600000;0
2919;500;4182;81;34;3;31;.912;3719000;0
2919;1614;25;83;33;2;31;.939;3719000;0
2919;5182;25;0;0;0;0;.00nan;0;0
2919;25521;4182;0;0;0;0;.00nan;0;0
2921;724;11;59;27;3;24;.889;3590000;0
2921;1572;4838;92;31;1;30;.968;3600000;0
2921;2328;4838;0;0;0;0;.00nan;0;0
2921;21522;11;0;0;0;0;.00nan;0;0
2923;262;35;0;0;0;0;.00nan;0;0
2923;1430;35;100;33;1;32;.970;3600000;0
2923;18104;10;0;0;0;0;.00nan;0;0
2923;27488;10;61;28;3;25;.893;3552000;0
1312;780;52;69;28;3;25;.893;3900000;0
1312;23255;52;0;0;0;0;.00nan;0;0
1312;28772;53;0;0;0;0;.00nan;0;0
1312;31156;53;84;36;3;33;.917;3900000;0
1313;1486;43;62;27;3;24;.889;3600000;0
1313;2900;36;50;30;4;26;.867;3597000;0
1313;3625;43;0;0;0;0;.00nan;0;0
1313;14874;36;0;0;0;0;.00nan;0;0
1314;6081;56;62;22;2;20;.909;3600000;0
1314;23493;51;84;28;1;27;.964;3600000;0
1314;26824;56;0;0;0;0;.00nan;0;0
1314;31822;51;0;0;0;0;.00nan;0;0
1315;37;46;0;0;0;0;.00nan;0;0
1315;2553;46;39;21;4;17;.810;3551000;0
1315;34788;42;82;31;2;29;.935;3600000;0
1315;37416;42;0;0;0;0;.00nan;0;0
1316;1051;44;0;0;0;0;.00nan;0;0
1316;3281;44;61;25;3;22;.880;3575000;0
1316;14351;40;95;38;2;36;.947;3600000;0
1316;26840;40;0;0;0;0;.00nan;0;0
1317;3626;48;0;0;0;0;.00nan;0;0
1317;4716;4619;0;0;0;0;.00nan;0;0
1317;35210;4619;76;35;3;32;.914;3600000;0
1317;38547;48;100;31;0;31;1.000;3600000;0
1318;1592;63;0;0;0;0;.00nan;0;0
1318;2296;37;0;0;0;0;.00nan;0;0
1318;23043;37;67;19;2;17;.895;3600000;0
1318;26967;63;81;39;3;36;.923;3600000;0
1319;2796;59;0;0;0;0;.00nan;0;0
1319;8046;57;77;41;3;38;.927;3589000;0
1319;27474;57;0;0;0;0;.00nan;0;0
1319;34639;59;76;21;1;20;.952;3600000;0
1320;2824;65;0;0;0;0;.00nan;0;0
1320;4987;65;58;28;3;25;.893;3600000;0
1320;19640;41;94;21;0;21;1.000;3600000;0
1320;23075;41;0;0;0;0;.00nan;0;0
1321;1486;43;0;0;0;0;.00nan;0;0
1321;2900;36;0;0;0;0;.00nan;0;0
1321;3625;43;73;35;3;32;.914;3633000;0
1321;14874;36;67;21;2;19;.905;3633000;0
1322;6081;56;0;0;0;0;.00nan;0;0
1322;23493;51;0;0;0;0;.00nan;0;0
1322;26824;56;82;29;2;27;.931;3555000;0
1322;31822;51;93;42;1;41;.976;3600000;0
1323;37;46;100;22;0;22;1.000;3600000;0
1323;2553;46;0;0;0;0;.00nan;0;0
1323;4447;54;62;36;5;31;.861;3600000;0
1323;31643;54;0;0;0;0;.00nan;0;0
1324;780;52;0;0;0;0;.00nan;0;0
1324;3847;38;0;0;0;0;.00nan;0;0
1324;23255;52;71;29;2;27;.931;3600000;0
1324;31021;38;49;26;4;22;.846;3568000;0
1325;5137;58;0;0;0;0;.00nan;0;0
1325;14321;58;63;39;5;34;.872;3600000;0
1325;28772;53;77;29;2;27;.931;3600000;0
1325;31156;53;0;0;0;0;.00nan;0;0
1326;5146;64;0;0;0;0;.00nan;0;0
1326;28845;64;57;29;3;26;.897;3600000;0
1326;34788;42;73;16;0;16;1.000;1297000;0
1326;37416;42;28;32;6;26;.813;2303000;0
1327;3;50;0;0;0;0;.00nan;0;0
1327;376;45;0;0;0;0;.00nan;0;0
1327;2198;45;61;30;4;26;.867;3643000;0
1327;5048;50;86;41;3;38;.927;3643000;0
1328;2152;49;52;44;7;37;.841;3652000;0
1328;4435;49;0;0;0;0;.00nan;0;0
1328;6572;62;0;0;0;0;.00nan;0;0
1328;26919;62;34;36;6;30;.833;3652000;0
1329;1051;44;32;13;4;9;.692;785000;0
1329;3281;44;61;25;3;22;.880;2815000;0
1329;14351;40;0;0;0;0;.00nan;0;0
1329;26840;40;73;26;2;24;.923;3600000;0
1330;2016;61;61;12;1;11;.917;1029000;0
1330;7049;47;83;41;3;38;.927;3600000;0
1330;30971;61;38;30;6;24;.800;2571000;0
1330;33654;47;0;0;0;0;.00nan;0;0
1331;3847;38;21;30;7;23;.767;3600000;0
1331;28772;53;0;0;0;0;.00nan;0;0
1331;31021;38;0;0;0;0;.00nan;0;0
1331;31156;53;55;24;3;21;.875;3600000;0
1332;2824;65;61;30;3;27;.900;3600000;0
1332;4987;65;0;0;0;0;.00nan;0;0
1332;8046;57;0;0;0;0;.00nan;0;0
1332;27474;57;67;41;5;36;.878;3550000;0
1333;907;39;0;0;0;0;.00nan;0;0
1333;2163;39;81;37;2;35;.946;3548000;0
1333;5298;55;0;0;0;0;.00nan;0;0
1333;34770;55;99;48;1;47;.979;3600000;0
1334;2796;59;87;29;1;28;.966;3600000;0
1334;19640;41;47;30;4;26;.867;3600000;0
1334;23075;41;0;0;0;0;.00nan;0;0
1334;34639;59;0;0;0;0;.00nan;0;0
1335;780;52;72;40;4;36;.900;3600000;0
1335;5137;58;66;31;3;28;.903;3600000;0
1335;14321;58;0;0;0;0;.00nan;0;0
1335;23255;52;0;0;0;0;.00nan;0;0
1336;1592;63;85;42;2;40;.952;3585000;0
1336;2296;37;70;19;1;18;.947;3600000;0
1336;23043;37;0;0;0;0;.00nan;0;0
1336;26967;63;0;0;0;0;.00nan;0;0
1337;3;50;59;25;3;22;.880;3600000;0
1337;376;45;91;27;1;26;.963;3600000;0
1337;2198;45;0;0;0;0;.00nan;0;0
1337;5048;50;0;0;0;0;.00nan;0;0
1338;7049;47;0;0;0;0;.00nan;0;0
1338;20717;60;40;21;4;17;.810;3600000;0
1338;33654;47;40;33;6;27;.818;3600000;0
1338;35536;60;0;0;0;0;.00nan;0;0
1339;2016;61;83;41;3;38;.927;3600000;0
1339;2152;49;0;0;0;0;.00nan;0;0
1339;4435;49;38;30;6;24;.800;3600000;0
1339;30971;61;0;0;0;0;.00nan;0;0
1340;3626;48;0;0;0;0;.00nan;0;0
1340;4716;4619;54;17;2;15;.882;3600000;0
1340;35210;4619;0;0;0;0;.00nan;0;0
1340;38547;48;85;45;4;41;.911;3600000;0
1341;2016;61;0;0;0;0;.00nan;0;0
1341;2152;49;0;0;0;0;.00nan;0;0
1341;4435;49;82;21;1;20;.952;3600000;0
1341;30971;61;97;46;2;44;.957;3600000;0
1342;2296;37;0;0;0;0;.00nan;0;0
1342;5883;37;78;34;3;31;.912;3900000;0
1342;23493;51;66;29;3;26;.897;3900000;0
1342;31822;51;0;0;0;0;.00nan;0;0
1343;2824;65;0;0;0;0;.00nan;0;0
1343;4987;65;76;32;3;29;.906;3545000;0
1343;19640;41;64;26;2;24;.923;3600000;0
1343;23075;41;0;0;0;0;.00nan;0;0
1344;3847;38;57;31;4;27;.871;3600000;0
1344;5298;55;0;0;0;0;.00nan;0;0
1344;31021;38;0;0;0;0;.00nan;0;0
1344;34770;55;59;26;3;23;.885;3600000;0
1345;1486;43;0;0;0;0;.00nan;0;0
1345;3625;43;76;24;1;23;.958;3600000;0
1345;6081;56;56;28;3;25;.893;3542000;0
1345;26824;56;0;0;0;0;.00nan;0;0
1346;2796;59;0;0;0;0;.00nan;0;0
1346;28772;53;0;0;0;0;.00nan;0;0
1346;31156;53;48;37;5;32;.865;3600000;0
1346;34639;59;66;25;2;23;.920;3600000;0
1347;780;52;0;0;0;0;.00nan;0;0
1347;5137;58;0;0;0;0;.00nan;0;0
1347;14321;58;43;29;5;24;.828;3672000;0
1347;23255;52;50;30;4;26;.867;3683000;0
1348;907;39;0;0;0;0;.00nan;0;0
1348;2163;39;77;30;2;28;.933;3900000;0
1348;2900;36;0;0;0;0;.00nan;0;0
1348;14874;36;94;41;2;39;.951;3900000;0
1349;37;46;81;37;3;34;.919;3900000;0
1349;2296;37;0;0;0;0;.00nan;0;0
1349;2553;46;0;0;0;0;.00nan;0;0
1349;5883;37;61;36;3;33;.917;3900000;0
1350;4447;54;0;0;0;0;.00nan;0;0
1350;5146;64;47;31;5;26;.839;3554000;0
1350;28845;64;0;0;0;0;.00nan;0;0
1350;31643;54;59;30;3;27;.900;3600000;0
1351;3;50;0;0;0;0;.00nan;0;0
1351;5048;50;65;30;3;27;.900;3839000;0
1351;34788;42;0;0;0;0;.00nan;0;0
1351;37416;42;61;32;4;28;.875;3824000;0
1352;4716;4619;97;34;1;33;.971;3600000;0
1352;20717;60;65;24;2;22;.917;3574000;0
1352;35210;4619;0;0;0;0;.00nan;0;0
1352;35536;60;0;0;0;0;.00nan;0;0
1353;2152;49;34;20;4;16;.800;3543000;0
1353;4435;49;0;0;0;0;.00nan;0;0
1353;7049;47;0;0;0;0;.00nan;0;0
1353;33654;47;70;31;3;28;.903;3600000;0
1354;6572;62;99;18;0;18;1.000;3600000;0
1354;14351;40;82;37;2;35;.946;3552000;0
1354;26840;40;0;0;0;0;.00nan;0;0
1354;26919;62;0;0;0;0;.00nan;0;0
1355;2016;61;76;22;2;20;.909;3600000;0
1355;3626;48;0;0;0;0;.00nan;0;0
1355;30971;61;0;0;0;0;.00nan;0;0
1355;38547;48;66;34;3;31;.912;3541000;0
1356;907;39;58;21;2;19;.905;3600000;0
1356;1592;63;37;30;5;25;.833;3600000;0
1356;2163;39;0;0;0;0;.00nan;0;0
1356;26967;63;0;0;0;0;.00nan;0;0
1357;2824;65;58;30;3;27;.900;3600000;0
1357;4987;65;0;0;0;0;.00nan;0;0
1357;19640;41;0;0;0;0;.00nan;0;0
1357;23075;41;48;34;5;29;.853;3600000;0
1358;780;52;98;37;1;36;.973;3600000;0
1358;5137;58;54;30;4;26;.867;3600000;0
1358;14321;58;0;0;0;0;.00nan;0;0
1358;23255;52;0;0;0;0;.00nan;0;0
1359;2900;36;49;29;4;25;.862;3580000;0
1359;5298;55;58;23;3;20;.870;3600000;0
1359;14874;36;0;0;0;0;.00nan;0;0
1359;34770;55;0;0;0;0;.00nan;0;0
1360;1486;43;42;18;3;15;.833;3557000;0
1360;3625;43;0;0;0;0;.00nan;0;0
1360;6081;56;0;0;0;0;.00nan;0;0
1360;26824;56;83;29;2;27;.931;3600000;0
1361;3;50;20;36;8;28;.778;3170000;0
1361;5048;50;51;2;0;2;1.000;430000;0
1361;34788;42;56;17;3;14;.824;3600000;0
1361;37416;42;0;0;0;0;.00nan;0;0
1362;3847;38;0;0;0;0;.00nan;0;0
1362;23493;51;0;0;0;0;.00nan;0;0
1362;31021;38;55;36;5;31;.861;3600000;0
1362;31822;51;81;36;3;33;.917;3600000;0
1363;8046;57;62;31;3;28;.903;3513000;0
1363;27474;57;0;0;0;0;.00nan;0;0
1363;28772;53;0;0;0;0;.00nan;0;0
1363;31156;53;77;25;1;24;.960;3600000;0
1364;4447;54;94;39;1;38;.974;3600000;0
1364;5146;64;0;0;0;0;.00nan;0;0
1364;28845;64;97;48;2;46;.958;3562000;0
1364;31643;54;0;0;0;0;.00nan;0;0
1365;2152;49;0;0;0;0;.00nan;0;0
1365;4435;49;85;43;3;40;.930;3561000;0
1365;6572;62;100;36;1;35;.972;3600000;0
1365;26919;62;0;0;0;0;.00nan;0;0
1366;4716;4619;0;0;0;0;.00nan;0;0
1366;20717;60;54;38;5;33;.868;3560000;0
1366;35210;4619;55;24;3;21;.875;3600000;0
1366;35536;60;0;0;0;0;.00nan;0;0
1367;7049;47;94;29;0;29;1.000;3600000;0
1367;14351;40;0;0;0;0;.00nan;0;0
1367;26840;40;62;27;3;24;.889;3600000;0
1367;33654;47;0;0;0;0;.00nan;0;0
1368;376;45;35;28;5;23;.821;3600000;0
1368;1051;44;90;36;2;34;.944;3600000;0
1368;2198;45;0;0;0;0;.00nan;0;0
1368;3281;44;0;0;0;0;.00nan;0;0
1369;780;52;0;0;0;0;.00nan;0;0
1369;23255;52;68;25;2;23;.920;3544000;0
1369;23493;51;100;41;0;41;1.000;3600000;0
1369;31822;51;0;0;0;0;.00nan;0;0
1370;37;46;46;26;4;22;.846;3562000;0
1370;2296;37;0;0;0;0;.00nan;0;0
1370;2553;46;0;0;0;0;.00nan;0;0
1370;5883;37;72;29;3;26;.897;3600000;0
1371;3847;38;68;28;2;26;.929;3900000;0
1371;5137;58;0;0;0;0;.00nan;0;0
1371;14321;58;79;26;2;24;.923;3900000;0
1371;31021;38;0;0;0;0;.00nan;0;0
1372;2796;59;52;26;3;23;.885;3600000;0
1372;8046;57;0;0;0;0;.00nan;0;0
1372;27474;57;89;32;2;30;.938;3600000;0
1372;34639;59;0;0;0;0;.00nan;0;0
1373;1486;43;0;0;0;0;.00nan;0;0
1373;1592;63;62;10;1;9;.900;1924000;0
1373;3625;43;93;38;2;36;.947;3600000;0
1373;26967;63;39;19;4;15;.789;1676000;0
1374;376;45;0;0;0;0;.00nan;0;0
1374;1051;44;0;0;0;0;.00nan;0;0
1374;2198;45;50;27;4;23;.852;3600000;0
1374;3281;44;97;24;0;24;1.000;3600000;0
1375;2016;61;0;0;0;0;.00nan;0;0
1375;3626;48;0;0;0;0;.00nan;0;0
1375;30971;61;69;19;1;18;.947;3600000;0
1375;38547;48;75;29;2;27;.931;3600000;0
1376;2824;65;0;0;0;0;.00nan;0;0
1376;2900;36;0;0;0;0;.00nan;0;0
1376;4987;65;77;22;1;21;.955;3600000;0
1376;14874;36;83;36;2;34;.944;3600000;0
1377;907;39;43;29;4;25;.862;3600000;0
1377;2163;39;0;0;0;0;.00nan;0;0
1377;6081;56;53;39;6;33;.846;3274000;0
1377;26824;56;59;3;0;3;1.000;262000;0
1378;37;46;0;0;0;0;.00nan;0;0
1378;2553;46;55;34;4;30;.882;3555000;0
1378;5146;64;0;0;0;0;.00nan;0;0
1378;28845;64;81;27;2;25;.926;3600000;0
1379;2796;59;0;0;0;0;.00nan;0;0
1379;8046;57;39;26;6;20;.769;3275000;0
1379;27474;57;53;3;0;3;1.000;325000;0
1379;34639;59;100;37;1;36;.973;3600000;0
1380;1592;63;63;32;3;29;.906;3900000;0
1380;23493;51;66;28;3;25;.893;3900000;0
1380;26967;63;0;0;0;0;.00nan;0;0
1380;31822;51;0;0;0;0;.00nan;0;0
1381;4716;4619;95;36;1;35;.972;3600000;0
1381;7049;47;53;29;4;25;.862;3600000;0
1381;33654;47;0;0;0;0;.00nan;0;0
1381;35210;4619;0;0;0;0;.00nan;0;0
1382;376;45;0;0;0;0;.00nan;0;0
1382;2198;45;60;29;3;26;.897;3549000;0
1382;34788;42;99;38;1;37;.974;3600000;0
1382;37416;42;0;0;0;0;.00nan;0;0
1383;3626;48;0;0;0;0;.00nan;0;0
1383;7049;47;69;31;2;29;.935;3900000;0
1383;33654;47;0;0;0;0;.00nan;0;0
1383;38547;48;88;33;2;31;.939;3900000;0
1384;2796;59;0;0;0;0;.00nan;0;0
1384;28772;53;0;0;0;0;.00nan;0;0
1384;31156;53;37;36;6;30;.833;3600000;0
1384;34639;59;64;28;3;25;.893;3600000;0
1385;1486;43;0;0;0;0;.00nan;0;0
1385;2900;36;81;24;1;23;.958;3600000;0
1385;3625;43;79;43;3;40;.930;3600000;0
1385;14874;36;0;0;0;0;.00nan;0;0
1386;5298;55;0;0;0;0;.00nan;0;0
1386;8046;57;84;47;4;43;.915;3515000;0
1386;27474;57;0;0;0;0;.00nan;0;0
1386;34770;55;61;20;2;18;.900;3600000;0
1387;1592;63;65;44;5;39;.886;3600000;0
1387;6081;56;84;14;0;14;1.000;3600000;0
1387;26824;56;0;0;0;0;.00nan;0;0
1387;26967;63;0;0;0;0;.00nan;0;0
1388;907;39;0;0;0;0;.00nan;0;0
1388;2163;39;74;37;3;34;.919;3600000;0
1388;23493;51;84;47;4;43;.915;3543000;0
1388;31822;51;0;0;0;0;.00nan;0;0
1389;3847;38;0;0;0;0;.00nan;0;0
1389;19640;41;68;30;3;27;.900;3600000;0
1389;23075;41;0;0;0;0;.00nan;0;0
1389;31021;38;55;17;2;15;.882;3600000;0
1390;4447;54;57;27;4;23;.852;3707000;0
1390;5146;64;0;0;0;0;.00nan;0;0
1390;28845;64;65;29;3;26;.897;3707000;0
1390;31643;54;0;0;0;0;.00nan;0;0
1391;4716;4619;0;0;0;0;.00nan;0;0
1391;20717;60;0;0;0;0;.00nan;0;0
1391;35210;4619;55;20;3;17;.850;3547000;0
1391;35536;60;93;35;1;34;.971;3600000;0
1392;1051;44;0;0;0;0;.00nan;0;0
1392;3281;44;84;28;1;27;.964;3600000;0
1392;6572;62;31;21;5;16;.762;3600000;0
1392;26919;62;0;0;0;0;.00nan;0;0
1393;2016;61;0;0;0;0;.00nan;0;0
1393;2152;49;67;18;1;17;.944;3600000;0
1393;4435;49;0;0;0;0;.00nan;0;0
1393;30971;61;45;30;5;25;.833;3600000;0
1394;907;39;76;26;2;24;.923;3600000;0
1394;2163;39;0;0;0;0;.00nan;0;0
1394;23493;51;38;8;2;6;.750;863000;0
1394;31822;51;39;33;6;27;.818;2737000;0
1395;3;50;0;0;0;0;.00nan;0;0
1395;2296;37;0;0;0;0;.00nan;0;0
1395;5048;50;38;22;4;18;.818;3571000;0
1395;5883;37;74;34;3;31;.912;3600000;0
1396;1592;63;0;0;0;0;.00nan;0;0
1396;6081;56;93;38;1;37;.974;3600000;0
1396;26824;56;0;0;0;0;.00nan;0;0
1396;26967;63;69;26;2;24;.923;3544000;0
1397;19640;41;0;0;0;0;.00nan;0;0
1397;23075;41;43;17;3;14;.824;3572000;0
1397;28772;53;84;35;2;33;.943;3600000;0
1397;31156;53;0;0;0;0;.00nan;0;0
1398;780;52;0;0;0;0;.00nan;0;0
1398;3847;38;81;39;3;36;.923;3600000;0
1398;23255;52;38;30;5;25;.833;3565000;0
1398;31021;38;0;0;0;0;.00nan;0;0
1399;1486;43;22;12;4;8;.667;680000;0
1399;2824;65;0;0;0;0;.00nan;0;0
1399;3625;43;66;27;2;25;.926;2920000;0
1399;4987;65;62;18;1;17;.944;3600000;0
1400;37;46;0;0;0;0;.00nan;0;0
1400;2553;46;76;26;1;25;.962;3550000;0
1400;4447;54;0;0;0;0;.00nan;0;0
1400;31643;54;95;22;0;22;1.000;3600000;0
1401;2900;36;0;0;0;0;.00nan;0;0
1401;8046;57;0;0;0;0;.00nan;0;0
1401;14874;36;83;31;2;29;.935;3534000;0
1401;27474;57;96;25;0;25;1.000;3600000;0
1402;2796;59;68;20;2;18;.900;3900000;0
1402;5137;58;0;0;0;0;.00nan;0;0
1402;14321;58;80;26;2;24;.923;3900000;0
1402;34639;59;0;0;0;0;.00nan;0;0
1403;376;45;0;0;0;0;.00nan;0;0
1403;2198;45;100;25;0;25;1.000;3600000;0
1403;34788;42;79;32;3;29;.906;3600000;0
1403;37416;42;0;0;0;0;.00nan;0;0
1404;4716;4619;96;40;2;38;.950;3600000;0
1404;14351;40;44;32;5;27;.844;3600000;0
1404;26840;40;0;0;0;0;.00nan;0;0
1404;35210;4619;0;0;0;0;.00nan;0;0
1405;1051;44;91;42;2;40;.952;3900000;0
1405;3281;44;0;0;0;0;.00nan;0;0
1405;6572;62;0;0;0;0;.00nan;0;0
1405;26919;62;80;34;2;32;.941;3900000;0
1406;3626;48;68;33;4;29;.879;3587000;0
1406;7049;47;0;0;0;0;.00nan;0;0
1406;33654;47;52;17;3;14;.824;3600000;0
1406;38547;48;0;0;0;0;.00nan;0;0
1407;2016;61;91;35;1;34;.971;3583000;0
1407;2152;49;0;0;0;0;.00nan;0;0
1407;4435;49;100;27;0;27;1.000;3600000;0
1407;30971;61;0;0;0;0;.00nan;0;0
1408;5137;58;57;25;3;22;.880;3600000;0
1408;14321;58;0;0;0;0;.00nan;0;0
1408;19640;41;62;38;5;33;.868;3600000;0
1408;23075;41;0;0;0;0;.00nan;0;0
1409;780;52;71;26;2;24;.923;3642000;0
1409;28772;53;0;0;0;0;.00nan;0;0
1409;31156;53;92;45;3;42;.933;3642000;0
1409;32146;52;0;0;0;0;.00nan;0;0
1410;3;50;37;39;7;32;.821;3600000;0
1410;2296;37;86;18;0;18;1.000;3600000;0
1410;5048;50;0;0;0;0;.00nan;0;0
1410;5883;37;0;0;0;0;.00nan;0;0
1411;37;46;92;27;1;26;.963;3600000;0
1411;2553;46;0;0;0;0;.00nan;0;0
1411;5146;64;65;35;4;31;.886;3600000;0
1411;28845;64;0;0;0;0;.00nan;0;0
1412;1486;43;86;38;3;35;.921;3895000;0
1412;2824;65;40;20;4;16;.800;3895000;0
1412;3625;43;0;0;0;0;.00nan;0;0
1412;4987;65;0;0;0;0;.00nan;0;0
1413;14351;40;0;0;0;0;.00nan;0;0
1413;20717;60;81;39;2;37;.949;3525000;0
1413;26840;40;90;22;0;22;1.000;3600000;0
1413;35536;60;0;0;0;0;.00nan;0;0
1414;376;45;0;0;0;0;.00nan;0;0
1414;2198;45;79;26;1;25;.962;3600000;0
1414;4716;4619;63;38;4;34;.895;3600000;0
1414;35210;4619;0;0;0;0;.00nan;0;0
1415;2796;59;0;0;0;0;.00nan;0;0
1415;8046;57;71;22;2;20;.909;2410000;0
1415;27474;57;42;18;4;14;.778;1156000;0
1415;34639;59;53;32;4;28;.875;3600000;0
1416;907;39;0;0;0;0;.00nan;0;0
1416;2163;39;30;18;4;14;.778;3600000;0
1416;6081;56;0;0;0;0;.00nan;0;0
1416;26824;56;49;50;7;43;.860;3600000;0
1417;376;45;79;26;2;24;.923;3600000;0
1417;2198;45;0;0;0;0;.00nan;0;0
1417;4716;4619;0;0;0;0;.00nan;0;0
1417;35210;4619;56;32;3;29;.906;3576000;0
1418;14351;40;0;0;0;0;.00nan;0;0
1418;20717;60;0;0;0;0;.00nan;0;0
1418;26840;40;75;34;2;32;.941;3731000;0
1418;35536;60;80;27;3;24;.889;3731000;0
1419;2152;49;0;0;0;0;.00nan;0;0
1419;3626;48;38;15;3;12;.800;1497000;0
1419;4435;49;83;23;1;22;.957;3600000;0
1419;38547;48;29;20;5;15;.750;2103000;0
1420;780;52;0;0;0;0;.00nan;0;0
1420;28772;53;58;38;5;33;.868;3591000;0
1420;31156;53;0;0;0;0;.00nan;0;0
1420;32146;52;62;33;4;29;.879;3600000;0
1421;2900;36;61;28;4;24;.857;3770000;0
1421;5298;55;0;0;0;0;.00nan;0;0
1421;14874;36;0;0;0;0;.00nan;0;0
1421;34770;55;55;25;3;22;.880;3770000;0
1422;1486;43;0;0;0;0;.00nan;0;0
1422;3625;43;82;36;2;34;.944;3829000;0
1422;6081;56;0;0;0;0;.00nan;0;0
1422;26824;56;79;34;3;31;.912;3829000;0
1423;3;50;0;0;0;0;.00nan;0;0
1423;37;46;71;32;4;28;.875;3600000;0
1423;2553;46;0;0;0;0;.00nan;0;0
1423;5048;50;33;21;5;16;.762;3580000;0
1424;2796;59;0;0;0;0;.00nan;0;0
1424;3847;38;77;23;1;22;.957;3573000;0
1424;31021;38;0;0;0;0;.00nan;0;0
1424;34639;59;100;48;0;48;1.000;3600000;0
1425;2824;65;0;0;0;0;.00nan;0;0
1425;4987;65;100;28;0;28;1.000;3600000;0
1425;5137;58;0;0;0;0;.00nan;0;0
1425;14321;58;78;25;2;23;.920;3600000;0
1426;907;39;80;32;2;30;.938;3590000;0
1426;1592;63;100;31;0;31;1.000;3600000;0
1426;2163;39;0;0;0;0;.00nan;0;0
1426;26967;63;0;0;0;0;.00nan;0;0
1427;2296;37;76;34;3;31;.912;3600000;0
1427;4447;54;0;0;0;0;.00nan;0;0
1427;5883;37;0;0;0;0;.00nan;0;0
1427;31643;54;49;26;4;22;.846;3600000;0
1428;6572;62;88;31;1;30;.968;3600000;0
1428;7049;47;72;51;5;46;.902;3600000;0
1428;26919;62;0;0;0;0;.00nan;0;0
1428;33654;47;0;0;0;0;.00nan;0;0
1429;2016;61;64;28;3;25;.893;3600000;0
1429;14351;40;99;37;2;35;.946;3600000;0
1429;26840;40;0;0;0;0;.00nan;0;0
1429;30971;61;0;0;0;0;.00nan;0;0
1430;1051;44;38;40;6;34;.850;2482000;0
1430;3281;44;40;8;2;6;.750;1118000;0
1430;3626;48;0;0;0;0;.00nan;0;0
1430;38547;48;66;24;2;22;.917;3600000;0
1431;376;45;0;0;0;0;.00nan;0;0
1431;2198;45;65;25;2;23;.920;3600000;0
1431;20717;60;0;0;0;0;.00nan;0;0
1431;35536;60;70;31;3;28;.903;3600000;0
1432;8046;57;96;39;1;38;.974;3900000;0
1432;19640;41;95;37;1;36;.973;3900000;0
1432;23075;41;0;0;0;0;.00nan;0;0
1432;27474;57;0;0;0;0;.00nan;0;0
1433;2796;59;0;0;0;0;.00nan;0;0
1433;28772;53;0;0;0;0;.00nan;0;0
1433;31156;53;86;44;3;41;.932;3640000;0
1433;34639;59;94;39;2;37;.949;3640000;0
1434;780;52;71;26;2;24;.923;3825000;0
1434;5137;58;58;26;3;23;.885;3825000;0
1434;14321;58;0;0;0;0;.00nan;0;0
1434;32146;52;0;0;0;0;.00nan;0;0
1435;2824;65;0;0;0;0;.00nan;0;0
1435;3847;38;0;0;0;0;.00nan;0;0
1435;4987;65;92;36;3;33;.917;3600000;0
1435;31021;38;46;36;5;31;.861;3516000;0
1436;2900;36;0;0;0;0;.00nan;0;0
1436;14874;36;47;30;4;26;.867;3593000;0
1436;23493;51;82;35;2;33;.943;3600000;0
1436;31822;51;0;0;0;0;.00nan;0;0
1437;1486;43;61;31;3;28;.903;3600000;0
1437;3625;43;0;0;0;0;.00nan;0;0
1437;6081;56;34;34;6;28;.824;2389000;0
1437;26824;56;45;5;1;4;.800;1211000;0
1438;1592;63;42;35;6;29;.829;3600000;0
1438;5298;55;77;24;2;22;.917;3600000;0
1438;26967;63;0;0;0;0;.00nan;0;0
1438;34770;55;0;0;0;0;.00nan;0;0
1439;3;50;63;39;5;34;.872;3546000;0
1439;4447;54;73;30;3;27;.900;3600000;0
1439;5048;50;0;0;0;0;.00nan;0;0
1439;31643;54;0;0;0;0;.00nan;0;0
1440;37;46;0;0;0;0;.00nan;0;0
1440;2553;46;56;30;5;25;.833;3564000;0
1440;34788;42;0;0;0;0;.00nan;0;0
1440;37416;42;60;32;4;28;.875;3600000;0
1441;2296;37;0;0;0;0;.00nan;0;0
1441;5146;64;60;27;3;24;.889;3900000;0
1441;5883;37;53;20;3;17;.850;3900000;0
1441;28845;64;0;0;0;0;.00nan;0;0
1442;2016;61;0;0;0;0;.00nan;0;0
1442;14351;40;0;0;0;0;.00nan;0;0
1442;26840;40;40;28;5;23;.821;3577000;0
1442;30971;61;73;30;3;27;.900;3600000;0
1443;2152;49;0;0;0;0;.00nan;0;0
1443;4435;49;65;25;3;22;.880;3900000;0
1443;7049;47;0;0;0;0;.00nan;0;0
1443;33654;47;76;36;3;33;.917;3900000;0
1444;4716;4619;65;18;2;16;.889;3600000;0
1444;6572;62;0;0;0;0;.00nan;0;0
1444;26919;62;46;34;6;28;.824;3600000;0
1444;35210;4619;0;0;0;0;.00nan;0;0
1445;1051;44;82;32;1;31;.969;3600000;0
1445;3281;44;0;0;0;0;.00nan;0;0
1445;3626;48;39;35;6;29;.829;3068000;0
1445;38547;48;52;3;0;3;1.000;532000;0
1446;8046;57;54;3;0;3;1.000;832000;0
1446;19640;41;0;0;0;0;.00nan;0;0
1446;23075;41;66;17;1;16;.941;3600000;0
1446;27474;57;28;29;6;23;.793;2768000;0
1447;780;52;0;0;0;0;.00nan;0;0
1447;28772;53;97;44;2;42;.955;3537000;0
1447;31156;53;0;0;0;0;.00nan;0;0
1447;32146;52;100;31;0;31;1.000;3600000;0
1448;2824;65;0;0;0;0;.00nan;0;0
1448;4987;65;55;27;3;24;.889;3600000;0
1448;5137;58;0;0;0;0;.00nan;0;0
1448;14321;58;50;35;5;30;.857;3579000;0
1449;4447;54;0;0;0;0;.00nan;0;0
1449;5146;64;0;0;0;0;.00nan;0;0
1449;28845;64;100;42;0;42;1.000;3618000;0
1449;31643;54;77;19;1;18;.947;3618000;0
1450;5298;55;0;0;0;0;.00nan;0;0
1450;23493;51;0;0;0;0;.00nan;0;0
1450;31822;51;99;44;2;42;.955;3600000;0
1450;34770;55;25;32;7;25;.781;3600000;0
1451;2296;37;47;37;5;32;.865;3600000;0
1451;5883;37;0;0;0;0;.00nan;0;0
1451;34788;42;51;15;2;13;.867;3600000;0
1451;37416;42;0;0;0;0;.00nan;0;0
1452;2152;49;88;23;1;22;.957;3900000;0
1452;4435;49;0;0;0;0;.00nan;0;0
1452;4716;4619;71;21;1;20;.952;3900000;0
1452;35210;4619;0;0;0;0;.00nan;0;0
1453;376;45;80;36;3;33;.917;3900000;0
1453;2198;45;0;0;0;0;.00nan;0;0
1453;20717;60;73;37;3;34;.919;3900000;0
1453;35536;60;0;0;0;0;.00nan;0;0
1454;2824;65;0;0;0;0;.00nan;0;0
1454;4987;65;64;27;2;25;.926;3600000;0
1454;8046;57;39;31;5;26;.839;3600000;0
1454;27474;57;0;0;0;0;.00nan;0;0
1455;780;52;0;0;0;0;.00nan;0;0
1455;2900;36;0;0;0;0;.00nan;0;0
1455;14874;36;39;29;5;24;.828;3513000;0
1455;32146;52;84;39;3;36;.923;3600000;0
1456;3847;38;0;0;0;0;.00nan;0;0
1456;5137;58;0;0;0;0;.00nan;0;0
1456;14321;58;100;32;0;32;1.000;3600000;0
1456;31021;38;73;29;2;27;.931;3516000;0
1457;907;39;0;0;0;0;.00nan;0;0
1457;2163;39;83;33;2;31;.939;3592000;0
1457;2796;59;0;0;0;0;.00nan;0;0
1457;34639;59;100;37;1;36;.973;3600000;0
1458;6081;56;96;41;2;39;.951;3600000;0
1458;23493;51;51;22;3;19;.864;3600000;0
1458;26824;56;0;0;0;0;.00nan;0;0
1458;31822;51;0;0;0;0;.00nan;0;0
1459;2296;37;0;0;0;0;.00nan;0;0
1459;4447;54;0;0;0;0;.00nan;0;0
1459;5883;37;59;29;4;25;.862;3555000;0
1459;31643;54;90;30;2;28;.933;3600000;0
1460;3;50;79;31;2;29;.935;3900000;0
1460;5048;50;0;0;0;0;.00nan;0;0
1460;34788;42;68;22;2;20;.909;3900000;0
1460;37416;42;0;0;0;0;.00nan;0;0
1461;7049;47;61;29;3;26;.897;3600000;0
1461;14351;40;50;35;6;29;.829;3600000;0
1461;26840;40;0;0;0;0;.00nan;0;0
1461;33654;47;0;0;0;0;.00nan;0;0
1462;3626;48;0;0;0;0;.00nan;0;0
1462;6572;62;77;25;1;24;.960;3600000;0
1462;26919;62;0;0;0;0;.00nan;0;0
1462;38547;48;63;39;5;34;.872;3600000;0
1463;2900;36;88;38;2;36;.947;3700000;0
1463;5298;55;62;28;3;25;.893;3700000;0
1463;14874;36;0;0;0;0;.00nan;0;0
1463;34770;55;0;0;0;0;.00nan;0;0
1464;780;52;0;0;0;0;.00nan;0;0
1464;23493;51;57;39;5;34;.872;3600000;0
1464;31822;51;0;0;0;0;.00nan;0;0
1464;32146;52;75;25;2;23;.920;3600000;0
1465;37;46;76;24;1;23;.958;3600000;0
1465;2296;37;53;32;4;28;.875;3600000;0
1465;2553;46;0;0;0;0;.00nan;0;0
1465;5883;37;0;0;0;0;.00nan;0;0
1466;3847;38;0;0;0;0;.00nan;0;0
1466;8046;57;79;27;2;25;.926;3716000;0
1466;27474;57;0;0;0;0;.00nan;0;0
1466;31021;38;93;32;1;31;.969;3716000;0
1467;2796;59;0;0;0;0;.00nan;0;0
1467;19640;41;0;0;0;0;.00nan;0;0
1467;23075;41;71;34;3;31;.912;3600000;0
1467;34639;59;66;49;6;43;.878;3600000;0
1468;5137;58;0;0;0;0;.00nan;0;0
1468;14321;58;72;32;2;30;.938;3600000;0
1468;28772;53;0;0;0;0;.00nan;0;0
1468;31156;53;74;44;4;40;.909;3544000;0
1469;907;39;0;0;0;0;.00nan;0;0
1469;1486;43;0;0;0;0;.00nan;0;0
1469;2163;39;58;24;3;21;.875;3600000;0
1469;3625;43;80;45;4;41;.911;3597000;0
1470;5146;64;0;0;0;0;.00nan;0;0
1470;28845;64;83;31;2;29;.935;3600000;0
1470;34788;42;58;39;5;34;.872;3600000;0
1470;37416;42;0;0;0;0;.00nan;0;0
1471;376;45;0;0;0;0;.00nan;0;0
1471;2198;45;80;38;3;35;.921;3900000;0
1471;4716;4619;69;36;3;33;.917;3900000;0
1471;10698;4619;0;0;0;0;.00nan;0;0
1472;1051;44;0;0;0;0;.00nan;0;0
1472;2152;49;69;31;2;29;.935;3600000;0
1472;3281;44;53;24;3;21;.875;3555000;0
1472;4435;49;0;0;0;0;.00nan;0;0
1473;6572;62;58;12;1;11;.917;3600000;0
1473;7049;47;80;38;3;35;.921;3582000;0
1473;26919;62;0;0;0;0;.00nan;0;0
1473;33654;47;0;0;0;0;.00nan;0;0
1474;3626;48;0;0;0;0;.00nan;0;0
1474;14351;40;77;28;2;26;.929;3600000;0
1474;26840;40;0;0;0;0;.00nan;0;0
1474;38547;48;45;26;4;22;.846;3581000;0
1475;2016;61;76;28;1;27;.964;3550000;0
1475;20717;60;100;47;0;47;1.000;3600000;0
1475;30971;61;0;0;0;0;.00nan;0;0
1475;35536;60;0;0;0;0;.00nan;0;0
1476;5298;55;0;0;0;0;.00nan;0;0
1476;23493;51;49;15;2;13;.867;1304000;0
1476;31822;51;40;34;6;28;.824;2296000;0
1476;34770;55;57;34;5;29;.853;3600000;0
1477;2796;59;48;33;5;28;.848;3600000;0
1477;19640;41;0;0;0;0;.00nan;0;0
1477;23075;41;80;26;1;25;.962;3600000;0
1477;34639;59;0;0;0;0;.00nan;0;0
1478;907;39;76;25;1;24;.960;3600000;0
1478;1486;43;88;37;2;35;.946;3548000;0
1478;2163;39;0;0;0;0;.00nan;0;0
1478;3625;43;0;0;0;0;.00nan;0;0
1479;2824;65;0;0;0;0;.00nan;0;0
1479;2900;36;0;0;0;0;.00nan;0;0
1479;4987;65;78;26;2;24;.923;3600000;0
1479;14874;36;75;35;4;31;.886;3555000;0
1480;780;52;49;25;4;21;.840;3527000;0
1480;6081;56;76;25;2;23;.920;3600000;0
1480;26824;56;0;0;0;0;.00nan;0;0
1480;32146;52;0;0;0;0;.00nan;0;0
1481;37;46;0;0;0;0;.00nan;0;0
1481;2296;37;0;0;0;0;.00nan;0;0
1481;2553;46;74;40;3;37;.925;3557000;0
1481;5883;37;76;25;1;24;.960;3600000;0
1482;3;50;0;0;0;0;.00nan;0;0
1482;4447;54;0;0;0;0;.00nan;0;0
1482;5048;50;92;39;1;38;.974;3600000;0
1482;31643;54;60;20;2;18;.900;3575000;0
1483;3847;38;77;28;3;25;.893;3600000;0
1483;28772;53;63;35;4;31;.886;3570000;0
1483;31021;38;0;0;0;0;.00nan;0;0
1483;31156;53;0;0;0;0;.00nan;0;0
1484;5137;58;0;0;0;0;.00nan;0;0
1484;8046;57;0;0;0;0;.00nan;0;0
1484;14321;58;69;25;2;23;.920;3600000;0
1484;27474;57;51;34;5;29;.853;3600000;0
1485;1592;63;57;36;4;32;.889;3819000;0
1485;5146;64;70;29;3;26;.897;3819000;0
1485;26967;63;0;0;0;0;.00nan;0;0
1485;28845;64;0;0;0;0;.00nan;0;0
1486;376;45;47;22;4;18;.818;3600000;0
1486;2198;45;0;0;0;0;.00nan;0;0
1486;4716;4619;81;38;2;36;.947;3600000;0
1486;10698;4619;0;0;0;0;.00nan;0;0
1487;3626;48;42;19;3;16;.842;3600000;0
1487;14351;40;0;0;0;0;.00nan;0;0
1487;26840;40;96;33;1;32;.970;3600000;0
1487;38547;48;0;0;0;0;.00nan;0;0
1488;1051;44;83;39;2;37;.949;3600000;0
1488;2152;49;40;15;3;12;.800;3200000;0
1488;3281;44;0;0;0;0;.00nan;0;0
1488;4435;49;29;8;3;5;.625;400000;0
1489;6572;62;0;0;0;0;.00nan;0;0
1489;7049;47;0;0;0;0;.00nan;0;0
1489;26919;62;41;32;5;27;.844;3535000;0
1489;33654;47;70;33;3;30;.909;3600000;0
1490;5298;55;62;28;4;24;.857;3556000;0
1490;6081;56;0;0;0;0;.00nan;0;0
1490;26824;56;77;37;3;34;.919;3600000;0
1490;34770;55;0;0;0;0;.00nan;0;0
1491;1592;63;0;0;0;0;.00nan;0;0
1491;5146;64;0;0;0;0;.00nan;0;0
1491;28845;64;52;36;5;31;.861;3900000;0
1491;34814;63;74;43;5;38;.884;3900000;0
1492;3;50;51;26;4;22;.846;3600000;0
1492;4447;54;35;31;6;25;.806;3348000;0
1492;5048;50;0;0;0;0;.00nan;0;0
1492;31643;54;49;2;0;2;1.000;192000;0
1493;2824;65;0;0;0;0;.00nan;0;0
1493;4987;65;90;36;1;35;.972;3600000;0
1493;19640;41;0;0;0;0;.00nan;0;0
1493;23075;41;64;26;3;23;.885;3566000;0
1494;2016;61;0;0;0;0;.00nan;0;0
1494;20717;60;88;37;2;35;.946;3900000;0
1494;30971;61;62;26;2;24;.923;3898000;0
1494;35536;60;0;0;0;0;.00nan;0;0
1495;37;46;96;36;1;35;.972;3600000;0
1495;2553;46;0;0;0;0;.00nan;0;0
1495;5146;64;0;0;0;0;.00nan;0;0
1495;28845;64;48;32;5;27;.844;3600000;0
1496;780;52;0;0;0;0;.00nan;0;0
1496;28772;53;80;35;3;32;.914;3600000;0
1496;31156;53;0;0;0;0;.00nan;0;0
1496;32146;52;36;23;5;18;.783;3523000;0
1497;1592;63;85;41;3;38;.927;3600000;0
1497;23493;51;100;23;0;23;1.000;3600000;0
1497;31822;51;0;0;0;0;.00nan;0;0
1497;34814;63;0;0;0;0;.00nan;0;0
1498;1486;43;0;0;0;0;.00nan;0;0
1498;2900;36;65;24;2;22;.917;3615000;0
1498;3625;43;62;28;3;25;.893;3615000;0
1498;14874;36;0;0;0;0;.00nan;0;0
1499;8046;57;90;35;2;33;.943;3900000;0
1499;19640;41;0;0;0;0;.00nan;0;0
1499;23075;41;83;31;2;29;.935;3900000;0
1499;27474;57;0;0;0;0;.00nan;0;0
1500;907;39;0;0;0;0;.00nan;0;0
1500;2163;39;50;29;4;25;.862;3600000;0
1500;5298;55;79;22;1;21;.955;3600000;0
1500;34770;55;0;0;0;0;.00nan;0;0
1501;7049;47;0;0;0;0;.00nan;0;0
1501;20717;60;0;0;0;0;.00nan;0;0
1501;33654;47;31;38;7;31;.816;3600000;0
1501;35536;60;79;23;1;22;.957;3600000;0
1502;2296;37;0;0;0;0;.00nan;0;0
1502;4447;54;0;0;0;0;.00nan;0;0
1502;5883;37;100;44;1;43;.977;3600000;0
1502;31643;54;62;26;3;23;.885;3552000;0
1503;1486;43;0;0;0;0;.00nan;0;0
1503;3625;43;54;26;4;22;.846;3515000;0
1503;14874;36;57;17;2;15;.882;3600000;0
1503;42825;36;0;0;0;0;.00nan;0;0
1504;5298;55;0;0;0;0;.00nan;0;0
1504;19640;41;0;0;0;0;.00nan;0;0
1504;23075;41;48;28;5;23;.821;3600000;0
1504;34770;55;27;34;7;27;.794;3600000;0
1505;3847;38;0;0;0;0;.00nan;0;0
1505;28772;53;100;32;0;32;1.000;3600000;0
1505;31021;38;62;32;4;28;.875;3600000;0
1505;31156;53;0;0;0;0;.00nan;0;0
1506;2796;59;0;0;0;0;.00nan;0;0
1506;5137;58;0;0;0;0;.00nan;0;0
1506;14321;58;89;45;3;42;.933;3600000;0
1506;34639;59;59;35;4;31;.886;3553000;0
1507;907;39;0;0;0;0;.00nan;0;0
1507;2163;39;72;24;2;22;.917;3600000;0
1507;8046;57;100;39;1;38;.974;3600000;0
1507;27474;57;0;0;0;0;.00nan;0;0
1508;2296;37;51;28;4;24;.857;3554000;0
1508;4447;54;59;29;3;26;.897;3600000;0
1508;5883;37;0;0;0;0;.00nan;0;0
1508;31643;54;0;0;0;0;.00nan;0;0
1509;5146;64;90;41;2;39;.951;3600000;0
1509;28845;64;0;0;0;0;.00nan;0;0
1509;34788;42;65;41;4;37;.902;3560000;0
1509;37416;42;0;0;0;0;.00nan;0;0
1510;37;46;42;29;5;24;.828;2757000;0
1510;376;45;0;0;0;0;.00nan;0;0
1510;2198;45;88;31;1;30;.968;3600000;0
1510;2553;46;28;15;4;11;.733;843000;0
1511;3;50;0;0;0;0;.00nan;0;0
1511;1051;44;90;46;2;44;.957;3600000;0
1511;3281;44;0;0;0;0;.00nan;0;0
1511;5048;50;82;28;1;27;.964;3600000;0
1512;3626;48;0;0;0;0;.00nan;0;0
1512;4716;4619;60;25;3;22;.880;3646000;0
1512;10698;4619;0;0;0;0;.00nan;0;0
1512;38547;48;81;27;2;25;.926;3646000;0
1513;6572;62;60;28;3;25;.893;3600000;0
1513;20717;60;0;0;0;0;.00nan;0;0
1513;26919;62;0;0;0;0;.00nan;0;0
1513;35536;60;94;25;0;25;1.000;3600000;0
1514;2016;61;85;27;1;26;.963;3600000;0
1514;7049;47;57;38;5;33;.868;3600000;0
1514;30971;61;0;0;0;0;.00nan;0;0
1514;33654;47;0;0;0;0;.00nan;0;0
1515;1592;63;55;44;5;39;.886;3521000;0
1515;8046;57;0;0;0;0;.00nan;0;0
1515;27474;57;53;18;3;15;.833;3600000;0
1515;34814;63;0;0;0;0;.00nan;0;0
1516;6572;62;0;0;0;0;.00nan;0;0
1516;20717;60;0;0;0;0;.00nan;0;0
1516;26919;62;40;31;5;26;.839;3600000;0
1516;35536;60;52;25;4;21;.840;3600000;0
1517;2824;65;0;0;0;0;.00nan;0;0
1517;4987;65;44;26;4;22;.846;3554000;0
1517;28772;53;90;43;3;40;.930;3600000;0
1517;31156;53;0;0;0;0;.00nan;0;0
1518;907;39;58;21;2;19;.905;3600000;0
1518;2163;39;0;0;0;0;.00nan;0;0
1518;5298;55;67;32;3;29;.906;3600000;0
1518;34770;55;0;0;0;0;.00nan;0;0
1519;6081;56;81;42;3;39;.929;3900000;0
1519;23493;51;55;23;3;20;.870;3900000;0
1519;26824;56;0;0;0;0;.00nan;0;0
1519;31822;51;0;0;0;0;.00nan;0;0
1520;2796;59;63;25;3;22;.880;3900000;0
1520;3847;38;82;42;3;39;.929;3900000;0
1520;31021;38;0;0;0;0;.00nan;0;0
1520;34639;59;0;0;0;0;.00nan;0;0
1521;780;52;0;0;0;0;.00nan;0;0
1521;5137;58;70;24;3;21;.875;3822000;0
1521;14321;58;0;0;0;0;.00nan;0;0
1521;32146;52;88;32;2;30;.938;3822000;0
1522;1098;42;0;0;0;0;.00nan;0;0
1522;5146;64;0;0;0;0;.00nan;0;0
1522;28845;64;67;36;4;32;.889;3600000;0
1522;37416;42;63;26;3;23;.885;3600000;0
1523;37;46;0;0;0;0;.00nan;0;0
1523;376;45;30;9;3;6;.667;551000;0
1523;2198;45;74;24;2;22;.917;3017000;0
1523;2553;46;35;17;4;13;.765;3600000;0
1524;3626;48;92;22;0;22;1.000;3600000;0
1524;4716;4619;0;0;0;0;.00nan;0;0
1524;10698;4619;79;36;3;33;.917;3600000;0
1524;38547;48;0;0;0;0;.00nan;0;0
1525;3;50;0;0;0;0;.00nan;0;0
1525;1051;44;0;0;0;0;.00nan;0;0
1525;3281;44;44;36;6;30;.833;3600000;0
1525;5048;50;59;18;2;16;.889;3600000;0
1526;780;52;88;30;1;29;.967;3600000;0
1526;5137;58;0;0;0;0;.00nan;0;0
1526;14321;58;53;35;5;30;.857;3600000;0
1526;32146;52;0;0;0;0;.00nan;0;0
1527;2296;37;0;0;0;0;.00nan;0;0
1527;4447;54;43;27;4;23;.852;3600000;0
1527;5883;37;63;39;5;34;.872;3543000;0
1527;35595;54;0;0;0;0;.00nan;0;0
1528;1486;43;44;31;5;26;.839;3600000;0
1528;3625;43;0;0;0;0;.00nan;0;0
1528;26967;63;0;0;0;0;.00nan;0;0
1528;34814;63;77;25;1;24;.960;3600000;0
1529;2824;65;96;38;2;36;.947;3600000;0
1529;4987;65;0;0;0;0;.00nan;0;0
1529;19640;41;0;0;0;0;.00nan;0;0
1529;23075;41;60;35;5;30;.857;3600000;0
1530;2152;49;0;0;0;0;.00nan;0;0
1530;4435;49;82;28;1;27;.964;3600000;0
1530;14351;40;67;34;3;31;.912;3558000;0
1530;26840;40;0;0;0;0;.00nan;0;0
1531;2016;61;49;24;4;20;.833;3596000;0
1531;7049;47;64;23;2;21;.913;3600000;0
1531;30971;61;0;0;0;0;.00nan;0;0
1531;33654;47;0;0;0;0;.00nan;0;0
1532;2152;49;62;24;3;21;.875;3900000;0
1532;4435;49;0;0;0;0;.00nan;0;0
1532;14351;40;0;0;0;0;.00nan;0;0
1532;26840;40;70;33;3;30;.909;3884000;0
1533;2796;59;0;0;0;0;.00nan;0;0
1533;19640;41;76;19;1;18;.947;3600000;0
1533;23075;41;0;0;0;0;.00nan;0;0
1533;34639;59;65;34;4;30;.882;3600000;0
1534;780;52;0;0;0;0;.00nan;0;0
1534;5137;58;0;0;0;0;.00nan;0;0
1534;14321;58;80;35;2;33;.943;3581000;0
1534;32146;52;91;31;1;30;.968;3600000;0
1535;2824;65;0;0;0;0;.00nan;0;0
1535;3847;38;58;39;6;33;.846;3115000;0
1535;4987;65;60;32;3;29;.906;3600000;0
1535;31021;38;60;5;0;5;1.000;485000;0
1536;2796;59;99;43;1;42;.977;3600000;0
1536;19640;41;0;0;0;0;.00nan;0;0
1536;23075;41;53;33;4;29;.879;3600000;0
1536;34639;59;0;0;0;0;.00nan;0;0
1537;6081;56;68;39;4;35;.897;3600000;0
1537;14874;36;52;21;3;18;.857;3600000;0
1537;26824;56;0;0;0;0;.00nan;0;0
1537;42825;36;0;0;0;0;.00nan;0;0
1538;907;39;97;34;1;33;.971;3900000;0
1538;2163;39;0;0;0;0;.00nan;0;0
1538;5298;55;0;0;0;0;.00nan;0;0
1538;34770;55;73;24;1;23;.958;3900000;0
1539;37;46;73;37;4;33;.892;3900000;0
1539;2553;46;0;0;0;0;.00nan;0;0
1539;4447;54;48;26;4;22;.846;3900000;0
1539;35595;54;0;0;0;0;.00nan;0;0
1540;6572;62;72;31;3;28;.903;3600000;0
1540;20717;60;45;24;4;20;.833;3600000;0
1540;26919;62;0;0;0;0;.00nan;0;0
1540;35536;60;0;0;0;0;.00nan;0;0
1541;5137;58;0;0;0;0;.00nan;0;0
1541;14321;58;89;35;2;33;.943;3600000;0
1541;28772;53;80;38;3;35;.921;3569000;0
1541;31156;53;0;0;0;0;.00nan;0;0
1542;780;52;0;0;0;0;.00nan;0;0
1542;3847;38;88;35;2;33;.943;3900000;0
1542;31021;38;0;0;0;0;.00nan;0;0
1542;32146;52;67;25;2;23;.920;3900000;0
1543;3533;57;0;0;0;0;.00nan;0;0
1543;8046;57;83;28;2;26;.929;3900000;0
1543;14874;36;67;29;2;27;.931;3900000;0
1543;42825;36;0;0;0;0;.00nan;0;0
1544;1486;43;0;0;0;0;.00nan;0;0
1544;3625;43;60;23;3;20;.870;3600000;0
1544;26967;63;0;0;0;0;.00nan;0;0
1544;34814;63;51;31;5;26;.839;3600000;0
1545;6081;56;65;32;3;29;.906;3600000;0
1545;23493;51;81;24;2;22;.917;3600000;0
1545;26824;56;0;0;0;0;.00nan;0;0
1545;31822;51;0;0;0;0;.00nan;0;0
1546;37;46;0;0;0;0;.00nan;0;0
1546;2553;46;100;36;1;35;.972;3600000;0
1546;5146;64;0;0;0;0;.00nan;0;0
1546;28845;64;59;30;4;26;.867;3600000;0
1547;907;39;85;31;1;30;.968;3600000;0
1547;2163;39;0;0;0;0;.00nan;0;0
1547;2824;65;0;0;0;0;.00nan;0;0
1547;4987;65;53;25;4;21;.840;3600000;0
1548;1098;42;0;0;0;0;.00nan;0;0
1548;4447;54;75;34;3;31;.912;3605000;0
1548;35595;54;0;0;0;0;.00nan;0;0
1548;37416;42;61;16;2;14;.875;3605000;0
1549;6572;62;0;0;0;0;.00nan;0;0
1549;20717;60;0;0;0;0;.00nan;0;0
1549;26919;62;75;47;4;43;.915;3557000;0
1549;35536;60;71;31;3;28;.903;3600000;0
1550;1051;44;57;30;4;26;.867;3775000;0
1550;2016;61;55;30;5;25;.833;3775000;0
1550;3281;44;0;0;0;0;.00nan;0;0
1550;30971;61;0;0;0;0;.00nan;0;0
1551;4716;4619;81;37;2;35;.946;3600000;0
1551;10698;4619;0;0;0;0;.00nan;0;0
1551;14351;40;71;29;3;26;.897;3551000;0
1551;26840;40;0;0;0;0;.00nan;0;0
1552;2152;49;0;0;0;0;.00nan;0;0
1552;4435;49;80;26;1;25;.962;3600000;0
1552;7049;47;75;38;2;36;.947;3600000;0
1552;33654;47;0;0;0;0;.00nan;0;0
1553;5137;58;0;0;0;0;.00nan;0;0
1553;14321;58;75;38;3;35;.921;3600000;0
1553;28772;53;0;0;0;0;.00nan;0;0
1553;31156;53;46;27;4;23;.852;3596000;0
1554;376;45;64;25;2;23;.920;3543000;0
1554;2198;45;0;0;0;0;.00nan;0;0
1554;2296;37;67;16;1;15;.938;3600000;0
1554;5883;37;0;0;0;0;.00nan;0;0
1555;1486;43;47;29;4;25;.862;3600000;0
1555;3625;43;0;0;0;0;.00nan;0;0
1555;26967;63;91;26;1;25;.962;3600000;0
1555;34814;63;0;0;0;0;.00nan;0;0
1556;3;50;0;0;0;0;.00nan;0;0
1556;3626;48;50;29;4;25;.862;3600000;0
1556;5048;50;79;21;1;20;.952;3600000;0
1556;38547;48;0;0;0;0;.00nan;0;0
1557;4716;4619;59;26;3;23;.885;3600000;0
1557;10698;4619;0;0;0;0;.00nan;0;0
1557;14351;40;0;0;0;0;.00nan;0;0
1557;26840;40;56;34;4;30;.882;3568000;0
1558;5298;55;0;0;0;0;.00nan;0;0
1558;19640;41;63;28;3;25;.893;3573000;0
1558;23075;41;0;0;0;0;.00nan;0;0
1558;34770;55;85;38;2;36;.947;3600000;0
1559;2796;59;0;0;0;0;.00nan;0;0
1559;3847;38;0;0;0;0;.00nan;0;0
1559;31021;38;89;38;2;36;.947;3900000;0
1559;34639;59;63;26;2;24;.923;3900000;0
1560;907;39;0;0;0;0;.00nan;0;0
1560;2163;39;66;34;4;30;.882;3600000;0
1560;14874;36;52;4;0;4;1.000;582000;0
1560;42825;36;25;25;6;19;.760;2932000;0
1561;6081;56;0;0;0;0;.00nan;0;0
1561;23493;51;51;29;4;25;.862;3600000;0
1561;26824;56;98;27;0;27;1.000;3600000;0
1561;31822;51;0;0;0;0;.00nan;0;0
1562;780;52;64;30;3;27;.900;3586000;0
1562;3533;57;68;29;2;27;.931;3600000;0
1562;8046;57;0;0;0;0;.00nan;0;0
1562;32146;52;0;0;0;0;.00nan;0;0
1563;1098;42;46;40;6;34;.850;3066000;0
1563;5146;64;82;24;1;23;.958;3600000;0
1563;28845;64;0;0;0;0;.00nan;0;0
1563;37416;42;69;13;0;13;1.000;534000;0
1564;2152;49;55;30;3;27;.900;3600000;0
1564;4435;49;0;0;0;0;.00nan;0;0
1564;20717;60;93;20;0;20;1.000;3600000;0
1564;35536;60;0;0;0;0;.00nan;0;0
1565;1051;44;0;0;0;0;.00nan;0;0
1565;2016;61;0;0;0;0;.00nan;0;0
1565;3281;44;56;27;3;24;.889;3559000;0
1565;30971;61;56;16;2;14;.875;3600000;0
1566;6572;62;58;23;3;20;.870;3900000;0
1566;7049;47;0;0;0;0;.00nan;0;0
1566;26919;62;0;0;0;0;.00nan;0;0
1566;33654;47;79;31;3;28;.903;3892000;0
1567;5298;55;60;30;4;26;.867;3815000;0
1567;19640;41;0;0;0;0;.00nan;0;0
1567;23075;41;63;38;5;33;.868;3815000;0
1567;34770;55;0;0;0;0;.00nan;0;0
1568;376;45;0;0;0;0;.00nan;0;0
1568;2198;45;85;39;2;37;.949;3600000;0
1568;2296;37;0;0;0;0;.00nan;0;0
1568;5883;37;47;22;3;19;.864;3587000;0
1569;37;46;100;40;1;39;.975;3897000;0
1569;2553;46;0;0;0;0;.00nan;0;0
1569;5146;64;0;0;0;0;.00nan;0;0
1569;28845;64;73;28;2;26;.929;3897000;0
1570;3;50;76;36;3;33;.917;3572000;0
1570;3626;48;0;0;0;0;.00nan;0;0
1570;5048;50;0;0;0;0;.00nan;0;0
1570;38547;48;75;21;1;20;.952;3600000;0
1571;2824;65;0;0;0;0;.00nan;0;0
1571;3533;57;0;0;0;0;.00nan;0;0
1571;4987;65;65;40;5;35;.875;3600000;0
1571;8046;57;68;38;4;34;.895;3600000;0
1572;4447;54;0;0;0;0;.00nan;0;0
1572;34788;42;0;0;0;0;.00nan;0;0
1572;35595;54;97;24;0;24;1.000;3600000;0
1572;37416;42;82;33;2;31;.939;3532000;0
1573;2016;61;23;27;7;20;.741;2663000;0
1573;2152;49;0;0;0;0;.00nan;0;0
1573;4435;49;81;28;1;27;.964;3600000;0
1573;30971;61;60;11;0;11;1.000;937000;0
1574;5137;58;0;0;0;0;.00nan;0;0
1574;14321;58;65;41;4;37;.902;3513000;0
1574;28772;53;84;38;2;36;.947;3600000;0
1574;31156;53;0;0;0;0;.00nan;0;0
1575;5298;55;95;25;0;25;1.000;3600000;0
1575;6081;56;0;0;0;0;.00nan;0;0
1575;26824;56;88;39;2;37;.949;3538000;0
1575;34770;55;0;0;0;0;.00nan;0;0
1576;2824;65;98;27;0;27;1.000;2882000;0
1576;3533;57;0;0;0;0;.00nan;0;0
1576;4987;65;25;14;4;10;.714;1018000;0
1576;8046;57;77;42;4;38;.905;3900000;0
1577;907;39;75;36;3;33;.917;3900000;0
1577;2163;39;0;0;0;0;.00nan;0;0
1577;14874;36;92;49;3;46;.939;3900000;0
1577;42825;36;0;0;0;0;.00nan;0;0
1578;376;45;0;0;0;0;.00nan;0;0
1578;2198;45;68;22;2;20;.909;3600000;0
1578;23493;51;40;21;4;17;.810;3551000;0
1578;31822;51;0;0;0;0;.00nan;0;0
1579;4447;54;0;0;0;0;.00nan;0;0
1579;34788;42;37;25;5;20;.800;3600000;0
1579;35595;54;100;34;1;33;.971;3600000;0
1579;37416;42;0;0;0;0;.00nan;0;0
1580;7049;47;92;34;2;32;.941;3600000;0
1580;14351;40;68;37;4;33;.892;3600000;0
1580;26840;40;0;0;0;0;.00nan;0;0
1580;33654;47;0;0;0;0;.00nan;0;0
1581;2016;61;0;0;0;0;.00nan;0;0
1581;2152;49;62;23;3;20;.870;3900000;0
1581;4435;49;0;0;0;0;.00nan;0;0
1581;30971;61;77;33;3;30;.909;3889000;0
1582;3;50;0;0;0;0;.00nan;0;0
1582;5048;50;68;39;4;35;.897;3543000;0
1582;5146;64;0;0;0;0;.00nan;0;0
1582;28845;64;77;34;3;31;.912;3600000;0
1583;2796;59;0;0;0;0;.00nan;0;0
1583;14874;36;56;22;3;19;.864;3746000;0
1583;34639;59;76;35;4;31;.886;3746000;0
1583;42825;36;0;0;0;0;.00nan;0;0
1584;1486;43;0;0;0;0;.00nan;0;0
1584;3625;43;80;36;3;33;.917;3600000;0
1584;4447;54;0;0;0;0;.00nan;0;0
1584;35595;54;57;31;4;27;.871;3541000;0
1585;376;45;0;0;0;0;.00nan;0;0
1585;2198;45;59;31;4;27;.871;3534000;0
1585;23493;51;0;0;0;0;.00nan;0;0
1585;31822;51;68;24;2;22;.917;3600000;0
1586;37;46;82;29;1;28;.966;3600000;0
1586;2553;46;0;0;0;0;.00nan;0;0
1586;34788;42;79;32;2;30;.938;3563000;0
1586;37416;42;0;0;0;0;.00nan;0;0
1587;3847;38;0;0;0;0;.00nan;0;0
1587;28772;53;50;26;4;22;.846;3600000;0
1587;31021;38;100;34;0;34;1.000;3600000;0
1587;31156;53;0;0;0;0;.00nan;0;0
1588;3533;57;0;0;0;0;.00nan;0;0
1588;8046;57;66;31;3;28;.903;3600000;0
1588;19640;41;99;21;0;21;1.000;3600000;0
1588;23075;41;0;0;0;0;.00nan;0;0
1589;907;39;87;30;1;29;.967;3600000;0
1589;2163;39;0;0;0;0;.00nan;0;0
1589;5137;58;0;0;0;0;.00nan;0;0
1589;14321;58;77;32;3;29;.906;3525000;0
1590;1051;44;0;0;0;0;.00nan;0;0
1590;3281;44;67;41;4;37;.902;3600000;0
1590;4716;4619;87;28;1;27;.964;3600000;0
1590;10698;4619;0;0;0;0;.00nan;0;0
1591;3626;48;98;46;2;44;.957;3900000;0
1591;7049;47;83;35;2;33;.943;3900000;0
1591;33654;47;0;0;0;0;.00nan;0;0
1591;38547;48;0;0;0;0;.00nan;0;0
1592;6572;62;0;0;0;0;.00nan;0;0
1592;14351;40;67;30;3;27;.900;3600000;0
1592;26840;40;0;0;0;0;.00nan;0;0
1592;26919;62;93;38;2;36;.947;3600000;0
1593;5137;58;83;34;2;32;.941;3599000;0
1593;14321;58;0;0;0;0;.00nan;0;0
1593;26967;63;0;0;0;0;.00nan;0;0
1593;34814;63;98;34;1;33;.971;3600000;0
1594;2796;59;67;26;2;24;.923;3900000;0
1594;19640;41;70;31;3;28;.903;3883000;0
1594;23075;41;0;0;0;0;.00nan;0;0
1594;34639;59;0;0;0;0;.00nan;0;0
1595;780;52;0;0;0;0;.00nan;0;0
1595;3847;38;66;35;4;31;.886;3587000;0
1595;31021;38;0;0;0;0;.00nan;0;0
1595;32146;52;73;32;2;30;.938;3600000;0
1596;907;39;0;0;0;0;.00nan;0;0
1596;2163;39;54;20;3;17;.850;3600000;0
1596;14874;36;0;0;0;0;.00nan;0;0
1596;42825;36;61;35;4;31;.886;3548000;0
1597;1486;43;84;30;1;29;.967;3600000;0
1597;3625;43;0;0;0;0;.00nan;0;0
1597;4447;54;76;23;2;21;.913;3555000;0
1597;35595;54;0;0;0;0;.00nan;0;0
1598;2296;37;0;0;0;0;.00nan;0;0
1598;5883;37;36;20;4;16;.800;3571000;0
1598;6081;56;88;45;3;42;.933;3600000;0
1598;26824;56;0;0;0;0;.00nan;0;0
1599;37;46;0;0;0;0;.00nan;0;0
1599;2553;46;48;36;5;31;.861;3834000;0
1599;34788;42;0;0;0;0;.00nan;0;0
1599;37416;42;71;37;4;33;.892;3834000;0
1600;3;50;0;0;0;0;.00nan;0;0
1600;5048;50;71;20;1;19;.950;3600000;0
1600;5146;64;0;0;0;0;.00nan;0;0
1600;28845;64;65;37;4;33;.892;3600000;0
1601;2824;65;81;26;1;25;.962;3600000;0
1601;3533;57;87;40;3;37;.925;3533000;0
1601;4987;65;0;0;0;0;.00nan;0;0
1601;8046;57;0;0;0;0;.00nan;0;0
1602;5298;55;21;11;5;6;.545;1660000;0
1602;28772;53;0;0;0;0;.00nan;0;0
1602;31156;53;60;43;6;37;.860;3711000;0
1602;34770;55;78;17;0;17;1.000;2051000;0
1603;6572;62;100;33;0;33;1.000;3600000;0
1603;14351;40;0;0;0;0;.00nan;0;0
1603;26840;40;68;27;3;24;.889;3600000;0
1603;26919;62;0;0;0;0;.00nan;0;0
1604;1051;44;74;29;3;26;.897;3900000;0
1604;3281;44;0;0;0;0;.00nan;0;0
1604;4716;4619;0;0;0;0;.00nan;0;0
1604;10698;4619;69;26;3;23;.885;3900000;0
1605;2152;49;0;0;0;0;.00nan;0;0
1605;4435;49;96;35;2;33;.943;3900000;0
1605;7049;47;0;0;0;0;.00nan;0;0
1605;33654;47;86;31;2;29;.935;3900000;0
1606;2016;61;61;21;2;19;.905;3555000;0
1606;20717;60;99;52;1;51;.981;3600000;0
1606;30971;61;0;0;0;0;.00nan;0;0
1606;35536;60;0;0;0;0;.00nan;0;0
1607;780;52;68;24;2;22;.917;3600000;0
1607;19640;41;0;0;0;0;.00nan;0;0
1607;23075;41;70;27;3;24;.889;3543000;0
1607;32146;52;0;0;0;0;.00nan;0;0
1608;2796;59;0;0;0;0;.00nan;0;0
1608;2824;65;0;0;0;0;.00nan;0;0
1608;4987;65;91;36;1;35;.972;3600000;0
1608;34639;59;56;26;3;23;.885;3595000;0
1609;2296;37;29;29;6;23;.793;3567000;0
1609;5883;37;0;0;0;0;.00nan;0;0
1609;6081;56;0;0;0;0;.00nan;0;0
1609;26824;56;66;37;4;33;.892;3600000;0
1610;3847;38;0;0;0;0;.00nan;0;0
1610;5298;55;76;31;2;29;.935;3600000;0
1610;31021;38;62;28;3;25;.893;3550000;0
1610;34770;55;0;0;0;0;.00nan;0;0
1611;23493;51;71;45;5;40;.889;3900000;0
1611;26967;63;65;40;5;35;.875;3900000;0
1611;31822;51;0;0;0;0;.00nan;0;0
1611;34814;63;0;0;0;0;.00nan;0;0
1612;3;50;56;30;4;26;.867;3900000;0
1612;5048;50;0;0;0;0;.00nan;0;0
1612;5146;64;61;33;4;29;.879;3900000;0
1612;28845;64;0;0;0;0;.00nan;0;0
1613;2016;61;0;0;0;0;.00nan;0;0
1613;20717;60;0;0;0;0;.00nan;0;0
1613;30971;61;54;21;3;18;.857;3600000;0
1613;35536;60;60;34;4;30;.882;3586000;0
1614;37;46;92;37;1;36;.973;3600000;0
1614;1486;43;0;0;0;0;.00nan;0;0
1614;2553;46;0;0;0;0;.00nan;0;0
1614;3625;43;36;18;4;14;.778;3600000;0
1615;2152;49;44;10;2;8;.800;3055000;0
1615;4435;49;15;6;4;2;.333;545000;0
1615;7049;47;87;26;1;25;.962;3600000;0
1615;33654;47;0;0;0;0;.00nan;0;0
1616;6081;56;0;0;0;0;.00nan;0;0
1616;26824;56;61;31;3;28;.903;3600000;0
1616;28772;53;57;32;4;28;.875;3600000;0
1616;31156;53;0;0;0;0;.00nan;0;0
1617;1486;43;0;0;0;0;.00nan;0;0
1617;3625;43;36;26;5;21;.808;3555000;0
1617;14874;36;46;21;3;18;.857;3600000;0
1617;42825;36;0;0;0;0;.00nan;0;0
1618;2796;59;0;0;0;0;.00nan;0;0
1618;2824;65;0;0;0;0;.00nan;0;0
1618;4987;65;56;26;3;23;.885;3543000;0
1618;34639;59;84;35;2;33;.943;3600000;0
1619;907;39;98;47;2;45;.957;3572000;0
1619;2163;39;0;0;0;0;.00nan;0;0
1619;5298;55;0;0;0;0;.00nan;0;0
1619;34770;55;87;15;0;15;1.000;3600000;0
1620;2296;37;57;28;4;24;.857;3041000;0
1620;5883;37;22;7;4;3;.429;559000;0
1620;23493;51;100;35;0;35;1.000;3600000;0
1620;31822;51;0;0;0;0;.00nan;0;0
1621;3;50;0;0;0;0;.00nan;0;0
1621;5048;50;76;27;1;26;.963;3600000;0
1621;34788;42;74;28;2;26;.929;3596000;0
1621;37416;42;0;0;0;0;.00nan;0;0
1622;376;45;0;0;0;0;.00nan;0;0
1622;2198;45;68;22;2;20;.909;3574000;0
1622;5146;64;89;26;1;25;.962;3600000;0
1622;28845;64;0;0;0;0;.00nan;0;0
1623;3533;57;0;0;0;0;.00nan;0;0
1623;8046;57;65;19;1;18;.947;3600000;0
1623;28772;53;0;0;0;0;.00nan;0;0
1623;31156;53;48;30;4;26;.867;3600000;0
1624;2900;36;0;0;0;0;.00nan;0;0
1624;14874;36;64;24;3;21;.875;3556000;0
1624;19640;41;61;25;2;23;.920;3600000;0
1624;23075;41;0;0;0;0;.00nan;0;0
1625;1486;43;0;0;0;0;.00nan;0;0
1625;3625;43;67;36;4;32;.889;3600000;0
1625;5298;55;0;0;0;0;.00nan;0;0
1625;34770;55;78;24;1;23;.958;3600000;0
1626;3847;38;71;26;2;24;.923;3600000;0
1626;6081;56;0;0;0;0;.00nan;0;0
1626;26824;56;79;36;3;33;.917;3565000;0
1626;31021;38;0;0;0;0;.00nan;0;0
1627;5137;58;0;0;0;0;.00nan;0;0
1627;14321;58;67;34;3;31;.912;3600000;0
1627;26967;63;95;30;1;29;.967;3600000;0
1627;34814;63;0;0;0;0;.00nan;0;0
1628;907;39;48;22;3;19;.864;3600000;0
1628;2163;39;0;0;0;0;.00nan;0;0
1628;23493;51;52;29;4;25;.862;3578000;0
1628;31822;51;0;0;0;0;.00nan;0;0
1629;37;46;31;28;6;22;.786;3600000;0
1629;2296;37;0;0;0;0;.00nan;0;0
1629;2553;46;0;0;0;0;.00nan;0;0
1629;5883;37;80;33;2;31;.939;3600000;0
1630;3;50;0;0;0;0;.00nan;0;0
1630;4447;54;0;0;0;0;.00nan;0;0
1630;5048;50;71;18;1;17;.944;3600000;0
1630;31643;54;55;32;5;27;.844;3600000;0
1631;3626;48;73;33;3;30;.909;3600000;0
1631;34788;42;0;0;0;0;.00nan;0;0
1631;37416;42;79;34;2;32;.941;3600000;0
1631;38547;48;0;0;0;0;.00nan;0;0
1632;1051;44;0;0;0;0;.00nan;0;0
1632;3281;44;49;31;5;26;.839;3580000;0
1632;14351;40;86;30;2;28;.933;3600000;0
1632;26840;40;0;0;0;0;.00nan;0;0
1633;4716;4619;100;26;0;26;1.000;3600000;0
1633;7049;47;93;38;2;36;.947;3547000;0
1633;10698;4619;0;0;0;0;.00nan;0;0
1633;33654;47;0;0;0;0;.00nan;0;0
1634;2152;49;0;0;0;0;.00nan;0;0
1634;4435;49;100;37;1;36;.973;3600000;0
1634;6572;62;35;30;6;24;.800;3600000;0
1634;26919;62;0;0;0;0;.00nan;0;0
1635;2016;61;0;0;0;0;.00nan;0;0
1635;20717;60;0;0;0;0;.00nan;0;0
1635;30971;61;75;40;4;36;.900;3600000;0
1635;35536;60;56;24;3;21;.875;3600000;0
1636;2900;36;77;53;5;48;.906;3600000;0
1636;14874;36;0;0;0;0;.00nan;0;0
1636;19640;41;0;0;0;0;.00nan;0;0
1636;23075;41;60;19;2;17;.895;3600000;0
1637;2796;59;0;0;0;0;.00nan;0;0
1637;2824;65;0;0;0;0;.00nan;0;0
1637;4987;65;81;36;2;34;.944;3600000;0
1637;34639;59;39;28;5;23;.821;3600000;0
1638;780;52;0;0;0;0;.00nan;0;0
1638;26967;63;0;0;0;0;.00nan;0;0
1638;32146;52;65;23;2;21;.913;3575000;0
1638;34814;63;77;25;1;24;.960;3600000;0
1639;37;46;0;0;0;0;.00nan;0;0
1639;2296;37;100;24;0;24;1.000;3600000;0
1639;2553;46;65;22;2;20;.909;3591000;0
1639;5883;37;0;0;0;0;.00nan;0;0
1640;3;50;0;0;0;0;.00nan;0;0
1640;4447;54;57;38;4;34;.895;3557000;0
1640;5048;50;77;32;3;29;.906;3600000;0
1640;31643;54;0;0;0;0;.00nan;0;0
1641;3626;48;0;0;0;0;.00nan;0;0
1641;34788;42;88;30;1;29;.967;3600000;0
1641;37416;42;0;0;0;0;.00nan;0;0
1641;38547;48;64;35;4;31;.886;3600000;0
1642;1486;43;65;38;4;34;.895;3600000;0
1642;3533;57;70;21;1;20;.952;3600000;0
1642;3625;43;0;0;0;0;.00nan;0;0
1642;8046;57;0;0;0;0;.00nan;0;0
1643;3847;38;0;0;0;0;.00nan;0;0
1643;5137;58;66;36;4;32;.889;3705000;0
1643;14321;58;0;0;0;0;.00nan;0;0
1643;31021;38;50;32;5;27;.844;3705000;0
1644;376;45;0;0;0;0;.00nan;0;0
1644;2198;45;72;23;1;22;.957;3600000;0
1644;5146;64;93;44;3;41;.932;3531000;0
1644;28845;64;0;0;0;0;.00nan;0;0
1645;1051;44;64;25;3;22;.880;3573000;0
1645;3281;44;0;0;0;0;.00nan;0;0
1645;14351;40;0;0;0;0;.00nan;0;0
1645;26840;40;81;27;1;26;.963;3600000;0
1646;4716;4619;76;28;2;26;.929;3600000;0
1646;7049;47;0;0;0;0;.00nan;0;0
1646;10698;4619;0;0;0;0;.00nan;0;0
1646;33654;47;67;34;3;31;.912;3600000;0
1647;2152;49;77;29;1;28;.966;3900000;0
1647;4435;49;0;0;0;0;.00nan;0;0
1647;6572;62;0;0;0;0;.00nan;0;0
1647;26919;62;94;31;1;30;.968;3900000;0
1648;780;52;71;21;1;20;.952;3600000;0
1648;6081;56;0;0;0;0;.00nan;0;0
1648;26824;56;78;37;3;34;.919;3586000;0
1648;32146;52;0;0;0;0;.00nan;0;0
1649;3847;38;74;23;1;22;.957;3600000;0
1649;26967;63;45;38;6;32;.842;3600000;0
1649;31021;38;0;0;0;0;.00nan;0;0
1649;34814;63;0;0;0;0;.00nan;0;0
1650;3533;57;0;0;0;0;.00nan;0;0
1650;8046;57;87;31;1;30;.968;3600000;0
1650;28772;53;73;30;2;28;.933;3575000;0
1650;31156;53;0;0;0;0;.00nan;0;0
1651;2796;59;54;43;7;36;.837;3600000;0
1651;5137;58;0;0;0;0;.00nan;0;0
1651;14321;58;100;30;0;30;1.000;3600000;0
1651;34639;59;0;0;0;0;.00nan;0;0
1652;2824;65;90;38;2;36;.947;3572000;0
1652;4987;65;0;0;0;0;.00nan;0;0
1652;23493;51;70;23;1;22;.957;3600000;0
1652;31822;51;0;0;0;0;.00nan;0;0
1653;376;45;84;41;3;38;.927;3600000;0
1653;2198;45;0;0;0;0;.00nan;0;0
1653;5146;64;0;0;0;0;.00nan;0;0
1653;28845;64;40;21;4;17;.810;3581000;0
1654;2016;61;63;19;1;18;.947;3542000;0
1654;20717;60;100;29;0;29;1.000;3600000;0
1654;30971;61;0;0;0;0;.00nan;0;0
1654;35536;60;0;0;0;0;.00nan;0;0
1655;907;39;100;38;1;37;.974;3600000;0
1655;2163;39;0;0;0;0;.00nan;0;0
1655;19640;41;41;38;7;31;.816;3600000;0
1655;23075;41;0;0;0;0;.00nan;0;0
1656;3;50;79;26;1;25;.962;3900000;0
1656;4447;54;96;31;1;30;.968;3900000;0
1656;5048;50;0;0;0;0;.00nan;0;0
1656;31643;54;0;0;0;0;.00nan;0;0
1657;1051;44;0;0;0;0;.00nan;0;0
1657;3281;44;96;54;2;52;.963;3900000;0
1657;3626;48;68;21;2;19;.905;3900000;0
1657;38547;48;0;0;0;0;.00nan;0;0
1658;907;39;0;0;0;0;.00nan;0;0
1658;2163;39;77;27;2;25;.926;3600000;0
1658;19640;41;66;8;0;8;1.000;1346000;0
1658;23075;41;37;20;4;16;.800;2188000;0
1659;7139;36;0;0;0;0;.00nan;0;0
1659;14874;36;51;21;3;18;.857;3600000;0
1659;26967;63;0;0;0;0;.00nan;0;0
1659;34814;63;62;34;4;30;.882;3552000;0
1660;3533;57;0;0;0;0;.00nan;0;0
1660;6081;56;77;22;1;21;.955;3600000;0
1660;8046;57;57;26;3;23;.885;3529000;0
1660;26824;56;0;0;0;0;.00nan;0;0
1661;1051;44;94;30;2;28;.933;3600000;0
1661;3281;44;0;0;0;0;.00nan;0;0
1661;3626;48;0;0;0;0;.00nan;0;0
1661;38547;48;51;24;3;21;.875;3600000;0
1662;7049;47;57;29;3;26;.897;3589000;0
1662;14351;40;84;28;1;27;.964;3600000;0
1662;26840;40;0;0;0;0;.00nan;0;0
1662;33654;47;0;0;0;0;.00nan;0;0
1663;2016;61;69;33;3;30;.909;3600000;0
1663;6572;62;18;32;7;25;.781;3600000;0
1663;26919;62;0;0;0;0;.00nan;0;0
1663;30971;61;0;0;0;0;.00nan;0;0
1664;4716;4619;33;21;5;16;.762;3600000;0
1664;10698;4619;0;0;0;0;.00nan;0;0
1664;20717;60;53;49;7;42;.857;3600000;0
1664;35536;60;0;0;0;0;.00nan;0;0
1665;2296;37;100;27;0;27;1.000;3600000;0
1665;5146;64;0;0;0;0;.00nan;0;0
1665;5883;37;0;0;0;0;.00nan;0;0
1665;28845;64;63;14;1;13;.929;3546000;0
1666;1486;43;73;37;3;34;.919;3577000;0
1666;3625;43;0;0;0;0;.00nan;0;0
1666;5298;55;0;0;0;0;.00nan;0;0
1666;34770;55;73;20;1;19;.950;3600000;0
1667;3533;57;0;0;0;0;.00nan;0;0
1667;8046;57;61;29;3;26;.897;3581000;0
1667;28772;53;86;21;1;20;.952;3600000;0
1667;31156;53;0;0;0;0;.00nan;0;0
1668;6081;56;0;0;0;0;.00nan;0;0
1668;7139;36;24;33;8;25;.758;2875000;0
1668;14874;36;63;9;0;9;1.000;725000;0
1668;26824;56;68;31;3;28;.903;3600000;0
1669;1486;43;0;0;0;0;.00nan;0;0
1669;3625;43;79;49;5;44;.898;3600000;0
1669;5298;55;94;22;0;22;1.000;3600000;0
1669;34770;55;0;0;0;0;.00nan;0;0
1670;714;51;0;0;0;0;.00nan;0;0
1670;3847;38;0;0;0;0;.00nan;0;0
1670;23493;51;69;26;2;24;.923;3600000;0
1670;31021;38;36;25;5;20;.800;3600000;0
1671;2824;65;93;54;4;50;.926;3584000;0
1671;4987;65;0;0;0;0;.00nan;0;0
1671;5137;58;0;0;0;0;.00nan;0;0
1671;14321;58;75;30;2;28;.933;3600000;0
1672;4447;54;0;0;0;0;.00nan;0;0
1672;5146;64;65;35;4;31;.886;3600000;0
1672;28845;64;0;0;0;0;.00nan;0;0
1672;31643;54;43;29;5;24;.828;3570000;0
1673;376;45;0;0;0;0;.00nan;0;0
1673;2198;45;75;31;3;28;.903;3600000;0
1673;34788;42;48;36;6;30;.833;3600000;0
1673;37416;42;0;0;0;0;.00nan;0;0
1674;3;50;0;0;0;0;.00nan;0;0
1674;2296;37;29;15;4;11;.733;721000;0
1674;5048;50;43;25;4;21;.840;3600000;0
1674;5883;37;83;28;2;26;.929;2858000;0
1675;2152;49;0;0;0;0;.00nan;0;0
1675;4435;49;83;23;1;22;.957;3600000;0
1675;20717;60;74;42;4;38;.905;3600000;0
1675;35536;60;0;0;0;0;.00nan;0;0
1676;6572;62;0;0;0;0;.00nan;0;0
1676;7049;47;88;37;3;34;.919;3900000;0
1676;26919;62;71;24;3;21;.875;3900000;0
1676;33654;47;0;0;0;0;.00nan;0;0
1677;4716;4619;79;22;2;20;.909;3850000;0
1677;10698;4619;0;0;0;0;.00nan;0;0
1677;14351;40;73;33;3;30;.909;3850000;0
1677;26840;40;0;0;0;0;.00nan;0;0
1678;780;52;0;0;0;0;.00nan;0;0
1678;19640;41;68;33;3;30;.909;3548000;0
1678;23075;41;0;0;0;0;.00nan;0;0
1678;32146;52;87;25;1;24;.960;3600000;0
1679;2796;59;0;0;0;0;.00nan;0;0
1679;2824;65;0;0;0;0;.00nan;0;0
1679;4987;65;79;29;2;27;.931;3600000;0
1679;34639;59;60;49;6;43;.878;3600000;0
1680;714;51;0;0;0;0;.00nan;0;0
1680;7139;36;0;0;0;0;.00nan;0;0
1680;14874;36;61;24;3;21;.875;3900000;0
1680;23493;51;60;25;3;22;.880;3899000;0
1681;3847;38;46;37;6;31;.838;3600000;0
1681;6081;56;91;30;1;29;.967;3600000;0
1681;26824;56;0;0;0;0;.00nan;0;0
1681;31021;38;0;0;0;0;.00nan;0;0
1682;37;46;83;28;1;27;.964;3600000;0
1682;2553;46;0;0;0;0;.00nan;0;0
1682;26967;63;76;25;2;23;.920;3550000;0
1682;34814;63;0;0;0;0;.00nan;0;0
1683;3;50;69;31;2;29;.935;3600000;0
1683;2296;37;91;47;3;44;.936;3563000;0
1683;5048;50;0;0;0;0;.00nan;0;0
1683;5883;37;0;0;0;0;.00nan;0;0
1684;907;39;75;22;1;21;.955;3600000;0
1684;2163;39;0;0;0;0;.00nan;0;0
1684;3533;57;65;35;4;31;.886;3600000;0
1684;8046;57;0;0;0;0;.00nan;0;0
1685;5137;58;32;32;6;26;.813;2782000;0
1685;14321;58;37;6;2;4;.667;818000;0
1685;28772;53;0;0;0;0;.00nan;0;0
1685;31156;53;50;25;4;21;.840;3600000;0
1686;4447;54;92;35;2;33;.943;3600000;0
1686;5146;64;0;0;0;0;.00nan;0;0
1686;28845;64;64;37;4;33;.892;3600000;0
1686;31643;54;0;0;0;0;.00nan;0;0
1687;376;45;66;37;5;32;.865;3600000;0
1687;2198;45;0;0;0;0;.00nan;0;0
1687;34788;42;0;0;0;0;.00nan;0;0
1687;37416;42;32;41;8;33;.805;3600000;0
1688;1051;44;0;0;0;0;.00nan;0;0
1688;2152;49;100;29;0;29;1.000;3600000;0
1688;3281;44;52;26;3;23;.885;3600000;0
1688;4435;49;0;0;0;0;.00nan;0;0
1689;4716;4619;67;34;3;31;.912;3600000;0
1689;10698;4619;0;0;0;0;.00nan;0;0
1689;14351;40;0;0;0;0;.00nan;0;0
1689;26840;40;54;27;4;23;.852;3573000;0
1690;6572;62;96;42;2;40;.952;3564000;0
1690;20717;60;0;0;0;0;.00nan;0;0
1690;26919;62;0;0;0;0;.00nan;0;0
1690;35536;60;78;23;1;22;.957;3600000;0
1691;2016;61;53;19;2;17;.895;3542000;0
1691;3626;48;100;26;0;26;1.000;3600000;0
1691;30971;61;0;0;0;0;.00nan;0;0
1691;38547;48;0;0;0;0;.00nan;0;0
1692;780;52;95;31;2;29;.935;3600000;0
1692;19640;41;0;0;0;0;.00nan;0;0
1692;23075;41;45;24;4;20;.833;3600000;0
1692;32146;52;0;0;0;0;.00nan;0;0
1693;5137;58;0;0;0;0;.00nan;0;0
1693;14321;58;87;32;1;31;.969;3600000;0
1693;28772;53;62;25;3;22;.880;3552000;0
1693;31156;53;0;0;0;0;.00nan;0;0
1694;37;46;0;0;0;0;.00nan;0;0
1694;2553;46;88;40;2;38;.950;3560000;0
1694;26967;63;0;0;0;0;.00nan;0;0
1694;34814;63;85;27;1;26;.963;3600000;0
1695;351;65;42;21;4;17;.810;2258000;0
1695;907;39;0;0;0;0;.00nan;0;0
1695;2163;39;63;32;4;28;.875;3600000;0
1695;2824;65;57;20;2;18;.900;1293000;0
1696;2016;61;62;6;0;6;1.000;396000;0
1696;3626;48;51;25;3;22;.880;3600000;0
1696;30971;61;25;34;7;27;.794;3204000;0
1696;38547;48;0;0;0;0;.00nan;0;0
1697;2796;59;0;0;0;0;.00nan;0;0
1697;26967;63;66;39;4;35;.897;3557000;0
1697;34639;59;48;20;3;17;.850;3600000;0
1697;34814;63;0;0;0;0;.00nan;0;0
1698;5298;55;49;22;3;19;.864;3558000;0
1698;6081;56;0;0;0;0;.00nan;0;0
1698;26824;56;91;34;2;32;.941;3600000;0
1698;34770;55;0;0;0;0;.00nan;0;0
1699;4447;54;0;0;0;0;.00nan;0;0
1699;31643;54;38;38;6;32;.842;3517000;0
1699;34788;42;0;0;0;0;.00nan;0;0
1699;37416;42;65;27;4;23;.852;3600000;0
1700;376;45;0;0;0;0;.00nan;0;0
1700;2198;45;59;23;3;20;.870;3600000;0
1700;2296;37;43;25;4;21;.840;3560000;0
1700;5883;37;0;0;0;0;.00nan;0;0
1701;4716;4619;14;7;4;3;.429;1046000;0
1701;10698;4619;37;18;4;14;.778;2554000;0
1701;20717;60;0;0;0;0;.00nan;0;0
1701;35536;60;100;35;1;34;.971;3600000;0
1702;376;45;73;29;3;26;.897;3600000;0
1702;2198;45;0;0;0;0;.00nan;0;0
1702;2296;37;0;0;0;0;.00nan;0;0
1702;5883;37;26;26;6;20;.769;3600000;0
1703;780;52;0;0;0;0;.00nan;0;0
1703;28772;53;0;0;0;0;.00nan;0;0
1703;31156;53;50;35;5;30;.857;3600000;0
1703;32146;52;47;41;7;34;.829;3600000;0
1704;351;65;52;27;3;24;.889;3560000;0
1704;2824;65;0;0;0;0;.00nan;0;0
1704;3533;57;0;0;0;0;.00nan;0;0
1704;8046;57;94;42;1;41;.976;3600000;0
1705;3847;38;0;0;0;0;.00nan;0;0
1705;7139;36;0;0;0;0;.00nan;0;0
1705;14874;36;45;26;4;22;.846;3600000;0
1705;31021;38;100;28;0;28;1.000;3600000;0
1706;1486;43;54;37;5;32;.865;3513000;0
1706;3625;43;0;0;0;0;.00nan;0;0
1706;5146;64;57;25;3;22;.880;3600000;0
1706;28845;64;0;0;0;0;.00nan;0;0
1707;37;46;95;46;2;44;.957;3592000;0
1707;2553;46;0;0;0;0;.00nan;0;0
1707;4447;54;0;0;0;0;.00nan;0;0
1707;31643;54;55;11;1;10;.909;3600000;0
1708;907;39;50;25;4;21;.840;3600000;0
1708;2163;39;0;0;0;0;.00nan;0;0
1708;2796;59;100;38;0;38;1.000;3600000;0
1708;34639;59;0;0;0;0;.00nan;0;0
1709;4716;4619;85;29;1;28;.966;3900000;0
1709;10698;4619;0;0;0;0;.00nan;0;0
1709;20717;60;89;22;1;21;.955;3900000;0
1709;35536;60;0;0;0;0;.00nan;0;0
1710;6572;62;98;37;2;35;.946;3564000;0
1710;14351;40;99;41;1;40;.976;3600000;0
1710;26840;40;0;0;0;0;.00nan;0;0
1710;26919;62;0;0;0;0;.00nan;0;0
1711;2152;49;50;24;3;21;.875;3539000;0
1711;3626;48;0;0;0;0;.00nan;0;0
1711;4435;49;0;0;0;0;.00nan;0;0
1711;38547;48;99;48;1;47;.979;3600000;0
1712;1051;44;0;0;0;0;.00nan;0;0
1712;2016;61;71;28;2;26;.929;3600000;0
1712;3281;44;77;36;3;33;.917;3576000;0
1712;30971;61;0;0;0;0;.00nan;0;0
1713;1486;43;0;0;0;0;.00nan;0;0
1713;3625;43;71;37;3;34;.919;3600000;0
1713;5146;64;0;0;0;0;.00nan;0;0
1713;28845;64;68;35;4;31;.886;3560000;0
1714;1051;44;71;45;4;41;.911;3600000;0
1714;2016;61;0;0;0;0;.00nan;0;0
1714;3281;44;0;0;0;0;.00nan;0;0
1714;30971;61;84;27;1;26;.963;3600000;0
1715;6081;56;72;42;4;38;.905;3742000;0
1715;26824;56;0;0;0;0;.00nan;0;0
1715;26967;63;76;38;3;35;.921;3742000;0
1715;34814;63;0;0;0;0;.00nan;0;0
1716;37;46;72;35;3;32;.914;3600000;0
1716;1486;43;100;28;0;28;1.000;3600000;0
1716;2553;46;0;0;0;0;.00nan;0;0
1716;3625;43;0;0;0;0;.00nan;0;0
1717;3;50;0;0;0;0;.00nan;0;0
1717;5048;50;75;38;4;34;.895;3600000;0
1717;34788;42;0;0;0;0;.00nan;0;0
1717;37416;42;68;32;3;29;.906;3600000;0
1718;2796;59;65;31;3;28;.903;3545000;0
1718;2824;65;74;26;2;24;.923;3600000;0
1718;4987;65;0;0;0;0;.00nan;0;0
1718;34639;59;0;0;0;0;.00nan;0;0
1719;907;39;82;33;2;31;.939;3600000;0
1719;2163;39;0;0;0;0;.00nan;0;0
1719;5298;55;0;0;0;0;.00nan;0;0
1719;34770;55;55;35;4;31;.886;3579000;0
1720;2152;49;0;0;0;0;.00nan;0;0
1720;4435;49;82;31;1;30;.968;3600000;0
1720;6572;62;73;41;4;37;.902;3600000;0
1720;26919;62;0;0;0;0;.00nan;0;0
1721;7049;47;89;37;1;36;.973;3600000;0
1721;20717;60;0;0;0;0;.00nan;0;0
1721;33654;47;0;0;0;0;.00nan;0;0
1721;35536;60;100;25;0;25;1.000;3600000;0
1722;780;52;0;0;0;0;.00nan;0;0
1722;5137;58;0;0;0;0;.00nan;0;0
1722;14321;58;64;23;2;21;.913;3600000;0
1722;32146;52;73;30;2;28;.933;3563000;0
1723;3847;38;0;0;0;0;.00nan;0;0
1723;26967;63;0;0;0;0;.00nan;0;0
1723;31021;38;72;31;3;28;.903;3882000;0
1723;34814;63;79;38;2;36;.947;3887000;0
1724;6081;56;0;0;0;0;.00nan;0;0
1724;7139;36;100;26;0;26;1.000;3600000;0
1724;14874;36;0;0;0;0;.00nan;0;0
1724;26824;56;73;45;4;41;.911;3600000;0
1725;5137;58;85;27;1;26;.963;3600000;0
1725;5298;55;0;0;0;0;.00nan;0;0
1725;14321;58;0;0;0;0;.00nan;0;0
1725;34770;55;64;35;4;31;.886;3600000;0
1726;780;52;43;25;4;21;.840;3900000;0
1726;28772;53;0;0;0;0;.00nan;0;0
1726;31156;53;100;53;4;49;.925;3900000;0
1726;32146;52;0;0;0;0;.00nan;0;0
1727;2796;59;0;0;0;0;.00nan;0;0
1727;2824;65;0;0;0;0;.00nan;0;0
1727;4987;65;59;36;4;32;.889;3543000;0
1727;34639;59;49;19;3;16;.842;3600000;0
1728;3;50;0;0;0;0;.00nan;0;0
1728;4716;4619;90;33;2;31;.939;3600000;0
1728;5048;50;54;36;5;31;.861;3600000;0
1728;10698;4619;0;0;0;0;.00nan;0;0
1729;1486;43;98;42;1;41;.976;3600000;0
1729;3533;57;0;0;0;0;.00nan;0;0
1729;3625;43;0;0;0;0;.00nan;0;0
1729;8046;57;100;29;0;29;1.000;3600000;0
1730;907;39;56;28;4;24;.857;3600000;0
1730;2163;39;0;0;0;0;.00nan;0;0
1730;3847;38;56;38;5;33;.868;3555000;0
1730;31021;38;0;0;0;0;.00nan;0;0
1731;7139;36;57;31;4;27;.871;3552000;0
1731;14874;36;0;0;0;0;.00nan;0;0
1731;23493;51;0;0;0;0;.00nan;0;0
1731;31822;51;54;26;3;23;.885;3600000;0
1732;2152;49;0;0;0;0;.00nan;0;0
1732;4435;49;75;23;1;22;.957;3600000;0
1732;7049;47;0;0;0;0;.00nan;0;0
1732;33654;47;58;37;4;33;.892;3600000;0
1733;3626;48;68;30;3;27;.900;3600000;0
1733;6572;62;50;25;4;21;.840;3579000;0
1733;26919;62;0;0;0;0;.00nan;0;0
1733;38547;48;0;0;0;0;.00nan;0;0
1734;14351;40;98;43;1;42;.977;3600000;0
1734;20717;60;0;0;0;0;.00nan;0;0
1734;26840;40;0;0;0;0;.00nan;0;0
1734;35536;60;43;26;5;21;.808;3600000;0
1735;6081;56;0;0;0;0;.00nan;0;0
1735;26824;56;70;30;3;27;.900;3600000;0
1735;26967;63;78;28;2;26;.929;3600000;0
1735;34814;63;0;0;0;0;.00nan;0;0
1736;4447;54;0;0;0;0;.00nan;0;0
1736;31643;54;70;19;1;18;.947;3600000;0
1736;34788;42;75;38;4;34;.895;3600000;0
1736;37416;42;0;0;0;0;.00nan;0;0
1737;2016;61;0;0;0;0;.00nan;0;0
1737;2296;37;65;39;4;35;.897;3900000;0
1737;5883;37;0;0;0;0;.00nan;0;0
1737;30971;61;50;30;4;26;.867;3900000;0
1738;3847;38;60;13;1;12;.923;3600000;0
1738;28772;53;38;26;4;22;.846;1679000;0
1738;31021;38;0;0;0;0;.00nan;0;0
1738;31156;53;71;15;0;15;1.000;1921000;0
1739;3;50;55;26;4;22;.846;3647000;0
1739;4716;4619;79;29;3;26;.897;3647000;0
1739;5048;50;0;0;0;0;.00nan;0;0
1739;10698;4619;0;0;0;0;.00nan;0;0
1740;14351;40;68;26;2;24;.923;3600000;0
1740;20717;60;0;0;0;0;.00nan;0;0
1740;26840;40;0;0;0;0;.00nan;0;0
1740;35536;60;90;44;3;41;.932;3559000;0
1741;3533;57;0;0;0;0;.00nan;0;0
1741;5298;55;0;0;0;0;.00nan;0;0
1741;26865;57;48;28;4;24;.857;3598000;0
1741;34770;55;82;32;2;30;.938;3600000;0
1742;2016;61;78;36;3;33;.917;3576000;0
1742;2296;37;0;0;0;0;.00nan;0;0
1742;5883;37;76;31;2;29;.935;3600000;0
1742;30971;61;0;0;0;0;.00nan;0;0
1743;1486;43;76;40;4;36;.900;3600000;0
1743;2796;59;0;0;0;0;.00nan;0;0
1743;3625;43;0;0;0;0;.00nan;0;0
1743;34639;59;32;26;5;21;.808;3553000;0
1744;37;46;78;34;2;32;.941;3900000;0
1744;2553;46;0;0;0;0;.00nan;0;0
1744;4447;54;0;0;0;0;.00nan;0;0
1744;31643;54;82;26;2;24;.923;3900000;0
1745;751;64;0;0;0;0;.00nan;0;0
1745;5146;64;59;22;3;19;.864;3600000;0
1745;34788;42;0;0;0;0;.00nan;0;0
1745;37416;42;100;34;0;34;1.000;3600000;0
1746;376;45;0;0;0;0;.00nan;0;0
1746;2198;45;40;28;5;23;.821;3591000;0
1746;19640;41;52;29;4;25;.862;3600000;0
1746;23075;41;0;0;0;0;.00nan;0;0
1747;1051;44;66;24;2;22;.917;3600000;0
1747;3281;44;0;0;0;0;.00nan;0;0
1747;6572;62;0;0;0;0;.00nan;0;0
1747;26919;62;70;36;3;33;.917;3600000;0
1748;2152;49;22;9;4;5;.556;1010000;0
1748;3626;48;43;39;6;33;.846;3572000;0
1748;4435;49;79;22;1;21;.955;2590000;0
1748;38547;48;0;0;0;0;.00nan;0;0
1749;907;39;54;33;5;28;.848;3585000;0
1749;2163;39;0;0;0;0;.00nan;0;0
1749;5137;58;0;0;0;0;.00nan;0;0
1749;14321;58;77;33;3;30;.909;3600000;0
1750;6081;56;53;30;5;25;.833;3600000;0
1750;26824;56;0;0;0;0;.00nan;0;0
1750;26967;63;90;36;2;34;.944;3600000;0
1750;34814;63;0;0;0;0;.00nan;0;0
1751;1486;43;0;0;0;0;.00nan;0;0
1751;2796;59;71;23;2;21;.913;3900000;0
1751;3625;43;100;40;2;38;.950;3900000;0
1751;34639;59;0;0;0;0;.00nan;0;0
1752;37;46;0;0;0;0;.00nan;0;0
1752;2553;46;87;49;4;45;.918;3600000;0
1752;4447;54;65;18;1;17;.944;3600000;0
1752;31643;54;0;0;0;0;.00nan;0;0
1753;751;64;54;24;3;21;.875;3515000;0
1753;5146;64;0;0;0;0;.00nan;0;0
1753;34788;42;0;0;0;0;.00nan;0;0
1753;37416;42;74;24;1;23;.958;3600000;0
1754;376;45;76;35;3;32;.914;3560000;0
1754;2198;45;0;0;0;0;.00nan;0;0
1754;19640;41;0;0;0;0;.00nan;0;0
1754;23075;41;88;27;1;26;.963;3600000;0
1755;3626;48;0;0;0;0;.00nan;0;0
1755;7049;47;0;0;0;0;.00nan;0;0
1755;33654;47;95;21;0;21;1.000;3600000;0
1755;38547;48;75;39;4;35;.897;3600000;0
1756;907;39;0;0;0;0;.00nan;0;0
1756;2163;39;90;30;1;29;.967;3600000;0
1756;28772;53;0;0;0;0;.00nan;0;0
1756;31156;53;70;31;3;28;.903;3545000;0
1757;780;52;0;0;0;0;.00nan;0;0
1757;2824;65;0;0;0;0;.00nan;0;0
1757;4987;65;93;37;2;35;.946;3579000;0
1757;32146;52;100;26;0;26;1.000;3600000;0
1758;3;50;0;0;0;0;.00nan;0;0
1758;2296;37;97;45;2;43;.956;3900000;0
1758;5048;50;67;23;2;21;.913;3900000;0
1758;5883;37;0;0;0;0;.00nan;0;0
1759;3847;38;0;0;0;0;.00nan;0;0
1759;5137;58;0;0;0;0;.00nan;0;0
1759;14321;58;53;35;5;30;.857;3600000;0
1759;31021;38;80;25;2;23;.920;3600000;0
1760;37;46;61;30;3;27;.900;3543000;0
1760;751;64;0;0;0;0;.00nan;0;0
1760;2553;46;0;0;0;0;.00nan;0;0
1760;5146;64;83;26;1;25;.962;3600000;0
1761;14351;40;73;27;2;25;.926;3597000;0
1761;20717;60;0;0;0;0;.00nan;0;0
1761;26840;40;0;0;0;0;.00nan;0;0
1761;35536;60;99;28;1;27;.964;3600000;0
1762;1051;44;52;24;3;21;.875;3600000;0
1762;3281;44;0;0;0;0;.00nan;0;0
1762;6572;62;72;42;4;38;.905;3600000;0
1762;26919;62;0;0;0;0;.00nan;0;0
1763;2152;49;0;0;0;0;.00nan;0;0
1763;4435;49;47;10;2;8;.800;3600000;0
1763;7049;47;51;6;1;5;.833;343000;0
1763;33654;47;87;63;6;57;.905;3257000;0
1764;3;50;0;0;0;0;.00nan;0;0
1764;2296;37;50;32;5;27;.844;3900000;0
1764;5048;50;75;36;5;31;.861;3900000;0
1764;5883;37;0;0;0;0;.00nan;0;0
1765;1051;44;0;0;0;0;.00nan;0;0
1765;3281;44;83;27;2;25;.926;3600000;0
1765;14351;40;57;26;3;23;.885;3591000;0
1765;26840;40;0;0;0;0;.00nan;0;0
1766;780;52;0;0;0;0;.00nan;0;0
1766;3847;38;0;0;0;0;.00nan;0;0
1766;31021;38;61;21;3;18;.857;3600000;0
1766;32146;52;62;37;6;31;.838;3600000;0
1767;5298;55;0;0;0;0;.00nan;0;0
1767;26967;63;58;36;4;32;.889;3600000;0
1767;34770;55;78;25;1;24;.960;3600000;0
1767;34814;63;0;0;0;0;.00nan;0;0
1768;37;46;38;21;4;17;.810;1990000;0
1768;4447;54;0;0;0;0;.00nan;0;0
1768;31643;54;93;28;1;27;.964;3600000;0
1768;35622;46;58;16;1;15;.938;1610000;0
1769;907;39;0;0;0;0;.00nan;0;0
1769;6081;56;0;0;0;0;.00nan;0;0
1769;26824;56;88;30;2;28;.933;3900000;0
1769;31126;39;66;26;2;24;.923;3900000;0
1770;5137;58;0;0;0;0;.00nan;0;0
1770;14321;58;66;29;3;26;.897;3884000;0
1770;23493;51;64;31;3;28;.903;3900000;0
1770;31822;51;0;0;0;0;.00nan;0;0
1771;1051;44;91;26;0;26;1.000;3600000;0
1771;3281;44;0;0;0;0;.00nan;0;0
1771;14351;40;0;0;0;0;.00nan;0;0
1771;26840;40;72;39;3;36;.923;3600000;0
1772;3626;48;57;23;3;20;.870;3600000;0
1772;6572;62;0;0;0;0;.00nan;0;0
1772;26919;62;69;39;4;35;.897;3600000;0
1772;38547;48;0;0;0;0;.00nan;0;0
1773;2824;65;57;4;0;4;1.000;494000;0
1773;4987;65;52;44;6;38;.864;3106000;0
1773;6062;36;0;0;0;0;.00nan;0;0
1773;14874;36;85;29;1;28;.966;3600000;0
1774;2796;59;0;0;0;0;.00nan;0;0
1774;5298;55;0;0;0;0;.00nan;0;0
1774;34639;59;66;17;1;16;.941;3600000;0
1774;34770;55;69;29;3;26;.897;3580000;0
1775;5137;58;0;0;0;0;.00nan;0;0
1775;6081;56;0;0;0;0;.00nan;0;0
1775;14321;58;58;30;4;26;.867;3600000;0
1775;26824;56;80;23;1;22;.957;3600000;0
1776;23493;51;66;31;3;28;.903;3600000;0
1776;26967;63;44;26;4;22;.846;3545000;0
1776;31822;51;0;0;0;0;.00nan;0;0
1776;34814;63;0;0;0;0;.00nan;0;0
1777;3;50;0;0;0;0;.00nan;0;0
1777;37;46;69;32;4;28;.875;3600000;0
1777;5048;50;100;35;1;34;.971;3600000;0
1777;35622;46;0;0;0;0;.00nan;0;0
1778;3533;57;67;11;0;11;1.000;536000;0
1778;3847;38;52;28;4;24;.857;3600000;0
1778;26865;57;32;31;6;25;.806;3064000;0
1778;31021;38;0;0;0;0;.00nan;0;0
1779;907;39;0;0;0;0;.00nan;0;0
1779;28772;53;0;0;0;0;.00nan;0;0
1779;31126;39;71;26;2;24;.923;3600000;0
1779;31156;53;44;39;6;33;.846;3600000;0
1780;1486;43;0;0;0;0;.00nan;0;0
1780;3625;43;77;44;4;40;.909;3600000;0
1780;4447;54;0;0;0;0;.00nan;0;0
1780;31643;54;80;23;1;22;.957;3600000;0
1781;751;64;0;0;0;0;.00nan;0;0
1781;5146;64;78;48;5;43;.896;3600000;0
1781;34788;42;0;0;0;0;.00nan;0;0
1781;37416;42;73;21;1;20;.952;3600000;0
1782;376;45;99;34;1;33;.971;3600000;0
1782;2198;45;0;0;0;0;.00nan;0;0
1782;2296;37;20;17;5;12;.706;3600000;0
1782;5883;37;0;0;0;0;.00nan;0;0
1783;6572;62;0;0;0;0;.00nan;0;0
1783;14351;40;39;28;5;23;.821;3600000;0
1783;26840;40;0;0;0;0;.00nan;0;0
1783;26919;62;45;37;6;31;.838;3600000;0
1784;3626;48;76;37;3;34;.919;3546000;0
1784;20717;60;0;0;0;0;.00nan;0;0
1784;35536;60;59;19;2;17;.895;3600000;0
1784;38547;48;0;0;0;0;.00nan;0;0
1785;2016;61;0;0;0;0;.00nan;0;0
1785;7049;47;54;35;6;29;.829;3600000;0
1785;30971;61;94;22;0;22;1.000;3600000;0
1785;33654;47;0;0;0;0;.00nan;0;0
1786;23493;51;0;0;0;0;.00nan;0;0
1786;26967;63;0;0;0;0;.00nan;0;0
1786;31822;51;96;48;3;45;.938;3600000;0
1786;34814;63;50;36;5;31;.861;3551000;0
1787;780;52;0;0;0;0;.00nan;0;0
1787;19640;41;0;0;0;0;.00nan;0;0
1787;23075;41;84;29;1;28;.966;3600000;0
1787;32146;52;86;34;2;32;.941;3600000;0
1788;2796;59;82;30;2;28;.933;3900000;0
1788;2824;65;79;33;2;31;.939;3900000;0
1788;4987;65;0;0;0;0;.00nan;0;0
1788;34639;59;0;0;0;0;.00nan;0;0
1789;907;39;64;29;3;26;.897;3600000;0
1789;6062;36;52;33;5;28;.848;3551000;0
1789;14874;36;0;0;0;0;.00nan;0;0
1789;31126;39;0;0;0;0;.00nan;0;0
1790;5298;55;63;18;2;16;.889;3600000;0
1790;28772;53;36;33;6;27;.818;3600000;0
1790;31156;53;0;0;0;0;.00nan;0;0
1790;34770;55;0;0;0;0;.00nan;0;0
1791;5137;58;0;0;0;0;.00nan;0;0
1791;6081;56;0;0;0;0;.00nan;0;0
1791;14321;58;57;19;2;17;.895;3600000;0
1791;26824;56;68;29;3;26;.897;3600000;0
1792;4447;54;62;23;3;20;.870;3900000;0
1792;31643;54;0;0;0;0;.00nan;0;0
1792;34788;42;78;30;3;27;.900;3900000;0
1792;37416;42;0;0;0;0;.00nan;0;0
1793;37;46;0;0;0;0;.00nan;0;0
1793;1486;43;63;35;3;32;.914;3600000;0
1793;3625;43;0;0;0;0;.00nan;0;0
1793;35622;46;64;23;2;21;.913;3600000;0
1794;3;50;0;0;0;0;.00nan;0;0
1794;751;64;83;28;2;26;.929;3600000;0
1794;5048;50;62;29;3;26;.897;3572000;0
1794;5146;64;0;0;0;0;.00nan;0;0
1795;376;45;0;0;0;0;.00nan;0;0
1795;2198;45;84;37;3;34;.919;3900000;0
1795;2296;37;0;0;0;0;.00nan;0;0
1795;5883;37;90;41;3;38;.927;3900000;0
1796;2152;49;93;21;0;21;1.000;3600000;0
1796;4435;49;0;0;0;0;.00nan;0;0
1796;6572;62;73;40;4;36;.900;3600000;0
1796;26919;62;0;0;0;0;.00nan;0;0
1797;1051;44;100;30;0;30;1.000;3900000;0
1797;3281;44;0;0;0;0;.00nan;0;0
1797;4716;4619;97;27;0;27;1.000;3900000;0
1797;10698;4619;0;0;0;0;.00nan;0;0
1798;3626;48;0;0;0;0;.00nan;0;0
1798;20717;60;92;26;1;25;.962;3600000;0
1798;35536;60;0;0;0;0;.00nan;0;0
1798;38547;48;61;20;2;18;.900;3600000;0
1799;780;52;82;36;3;33;.917;3524000;0
1799;19640;41;76;25;2;23;.920;3600000;0
1799;23075;41;0;0;0;0;.00nan;0;0
1799;32146;52;0;0;0;0;.00nan;0;0
1800;3533;57;0;0;0;0;.00nan;0;0
1800;3847;38;0;0;0;0;.00nan;0;0
1800;26865;57;83;19;0;19;1.000;3600000;0
1800;31021;38;45;32;6;26;.813;3600000;0
1801;751;64;0;0;0;0;.00nan;0;0
1801;1486;43;0;0;0;0;.00nan;0;0
1801;3625;43;89;38;2;36;.947;3899000;0
1801;5146;64;51;19;3;16;.842;3899000;0
1802;2796;59;0;0;0;0;.00nan;0;0
1802;2824;65;0;0;0;0;.00nan;0;0
1802;4987;65;59;43;5;38;.884;3899000;0
1802;34639;59;69;39;5;34;.872;3900000;0
1803;2152;49;58;17;2;15;.882;3600000;0
1803;4435;49;0;0;0;0;.00nan;0;0
1803;14351;40;71;45;5;40;.889;3600000;0
1803;26840;40;0;0;0;0;.00nan;0;0
1804;1051;44;46;29;5;24;.828;3541000;0
1804;3281;44;0;0;0;0;.00nan;0;0
1804;4716;4619;48;22;3;19;.864;3600000;0
1804;10698;4619;0;0;0;0;.00nan;0;0
1805;2016;61;0;0;0;0;.00nan;0;0
1805;7049;47;56;36;4;32;.889;3600000;0
1805;30971;61;78;24;3;21;.875;3600000;0
1805;33654;47;0;0;0;0;.00nan;0;0
1806;3;50;0;0;0;0;.00nan;0;0
1806;5048;50;84;29;1;28;.966;3600000;0
1806;34788;42;0;0;0;0;.00nan;0;0
1806;37416;42;37;21;4;17;.810;3600000;0
1807;19640;41;63;39;6;33;.846;3600000;0
1807;23075;41;0;0;0;0;.00nan;0;0
1807;28772;53;0;0;0;0;.00nan;0;0
1807;31156;53;74;38;3;35;.921;3600000;0
1808;780;52;0;0;0;0;.00nan;0;0
1808;2824;65;0;0;0;0;.00nan;0;0
1808;4987;65;91;33;1;32;.970;3600000;0
1808;32146;52;59;18;2;16;.889;3579000;0
1809;6081;56;0;0;0;0;.00nan;0;0
1809;26824;56;52;22;3;19;.864;3551000;0
1809;26967;63;99;39;1;38;.974;3600000;0
1809;34814;63;0;0;0;0;.00nan;0;0
1810;907;39;0;0;0;0;.00nan;0;0
1810;5298;55;32;26;5;21;.808;3557000;0
1810;31126;39;50;21;3;18;.857;3600000;0
1810;34770;55;0;0;0;0;.00nan;0;0
1811;6062;36;34;36;6;30;.833;3584000;0
1811;14874;36;0;0;0;0;.00nan;0;0
1811;23493;51;0;0;0;0;.00nan;0;0
1811;31822;51;54;33;4;29;.879;3600000;0
1812;2296;37;29;27;6;21;.778;2783000;0
1812;4447;54;0;0;0;0;.00nan;0;0
1812;5883;37;45;5;1;4;.800;817000;0
1812;31643;54;100;26;0;26;1.000;3600000;0
1813;37;46;94;26;0;26;1.000;3600000;0
1813;751;64;0;0;0;0;.00nan;0;0
1813;2553;46;0;0;0;0;.00nan;0;0
1813;5146;64;75;36;3;33;.917;3600000;0
1814;1051;44;85;43;3;40;.930;3558000;0
1814;3281;44;0;0;0;0;.00nan;0;0
1814;20717;60;0;0;0;0;.00nan;0;0
1814;35536;60;67;26;2;24;.923;3600000;0
1815;3626;48;36;24;5;19;.792;3894000;0
1815;14351;40;56;31;5;26;.839;3900000;0
1815;26840;40;0;0;0;0;.00nan;0;0
1815;38547;48;0;0;0;0;.00nan;0;0
1816;5298;55;0;0;0;0;.00nan;0;0
1816;6062;36;0;0;0;0;.00nan;0;0
1816;14874;36;79;43;4;39;.907;3594000;0
1816;34770;55;81;40;3;37;.925;3600000;0
1817;37;46;57;40;5;35;.875;3600000;0
1817;2296;37;49;22;4;18;.818;3600000;0
1817;2553;46;0;0;0;0;.00nan;0;0
1817;5883;37;0;0;0;0;.00nan;0;0
1818;3;50;55;27;3;24;.889;3567000;0
1818;751;64;0;0;0;0;.00nan;0;0
1818;5048;50;0;0;0;0;.00nan;0;0
1818;5146;64;74;26;2;24;.923;3600000;0
1819;3847;38;43;34;5;29;.853;3900000;0
1819;28772;53;44;29;5;24;.828;2945000;0
1819;31021;38;0;0;0;0;.00nan;0;0
1819;31156;53;53;6;0;6;1.000;955000;0
1820;2796;59;0;0;0;0;.00nan;0;0
1820;3533;57;0;0;0;0;.00nan;0;0
1820;26865;57;90;31;1;30;.968;3600000;0
1820;34639;59;38;22;4;18;.818;3600000;0
1821;5137;58;0;0;0;0;.00nan;0;0
1821;14321;58;51;36;5;31;.861;3600000;0
1821;23493;51;0;0;0;0;.00nan;0;0
1821;31822;51;80;24;1;23;.958;3600000;0
1822;907;39;0;0;0;0;.00nan;0;0
1822;6081;56;0;0;0;0;.00nan;0;0
1822;26824;56;67;26;2;24;.923;3600000;0
1822;31126;39;50;20;3;17;.850;3551000;0
1823;1486;43;0;0;0;0;.00nan;0;0
1823;3625;43;88;37;1;36;.973;3575000;0
1823;34788;42;78;11;0;11;1.000;3600000;0
1823;37416;42;0;0;0;0;.00nan;0;0
1824;4447;54;0;0;0;0;.00nan;0;0
1824;4716;4619;98;46;2;44;.957;3600000;0
1824;10698;4619;0;0;0;0;.00nan;0;0
1824;31643;54;67;28;3;25;.893;3559000;0
1825;7049;47;0;0;0;0;.00nan;0;0
1825;14351;40;64;32;5;27;.844;3600000;0
1825;26840;40;0;0;0;0;.00nan;0;0
1825;33654;47;65;23;2;21;.913;3600000;0
1826;2152;49;0;0;0;0;.00nan;0;0
1826;3626;48;43;24;5;19;.792;1935000;0
1826;4435;49;41;21;4;17;.810;3600000;0
1826;38547;48;49;16;2;14;.875;1665000;0
1827;2016;61;0;0;0;0;.00nan;0;0
1827;6572;62;92;49;3;46;.939;3555000;0
1827;26919;62;0;0;0;0;.00nan;0;0
1827;30971;61;72;24;2;22;.917;3600000;0
1828;1051;44;76;33;2;31;.939;3600000;0
1828;3281;44;0;0;0;0;.00nan;0;0
1828;20717;60;0;0;0;0;.00nan;0;0
1828;35536;60;52;30;4;26;.867;3590000;0
1829;3;50;0;0;0;0;.00nan;0;0
1829;751;64;69;37;4;33;.892;3600000;0
1829;5048;50;75;22;1;21;.955;3600000;0
1829;5146;64;0;0;0;0;.00nan;0;0
1830;376;45;0;0;0;0;.00nan;0;0
1830;2198;45;91;43;2;41;.953;3600000;0
1830;19640;41;0;0;0;0;.00nan;0;0
1830;23075;41;55;22;3;19;.864;3593000;0
1831;907;39;70;29;3;26;.897;3900000;0
1831;6081;56;0;0;0;0;.00nan;0;0
1831;26824;56;97;47;3;44;.936;3900000;0
1831;31126;39;0;0;0;0;.00nan;0;0
1832;23493;51;37;23;5;18;.783;3560000;0
1832;28772;53;0;0;0;0;.00nan;0;0
1832;31156;53;84;35;3;32;.914;3600000;0
1832;31822;51;0;0;0;0;.00nan;0;0
1833;2824;65;0;0;0;0;.00nan;0;0
1833;4987;65;100;40;2;38;.950;3600000;0
1833;26967;63;58;24;3;21;.875;3559000;0
1833;34814;63;0;0;0;0;.00nan;0;0
1834;5298;55;54;23;3;20;.870;3572000;0
1834;6062;36;78;34;2;32;.941;3600000;0
1834;14874;36;0;0;0;0;.00nan;0;0
1834;34770;55;0;0;0;0;.00nan;0;0
1835;37;46;0;0;0;0;.00nan;0;0
1835;2296;37;0;0;0;0;.00nan;0;0
1835;2553;46;71;30;2;28;.933;3593000;0
1835;5883;37;90;22;0;22;1.000;3600000;0
1836;1486;43;76;41;4;37;.902;3600000;0
1836;3625;43;0;0;0;0;.00nan;0;0
1836;34788;42;75;24;1;23;.958;3600000;0
1836;37416;42;0;0;0;0;.00nan;0;0
1837;2796;59;41;15;3;12;.800;3600000;0
1837;3533;57;72;51;6;45;.882;3600000;0
1837;26865;57;0;0;0;0;.00nan;0;0
1837;34639;59;0;0;0;0;.00nan;0;0
1838;3847;38;0;0;0;0;.00nan;0;0
1838;5137;58;0;0;0;0;.00nan;0;0
1838;14321;58;83;43;3;40;.930;3600000;0
1838;31021;38;88;38;2;36;.947;3600000;0
1839;4447;54;77;33;3;30;.909;3624000;0
1839;4716;4619;65;20;2;18;.900;3624000;0
1839;10698;4619;0;0;0;0;.00nan;0;0
1839;31643;54;0;0;0;0;.00nan;0;0
1840;7049;47;87;43;3;40;.930;3600000;0
1840;20717;60;100;27;0;27;1.000;3600000;0
1840;33654;47;0;0;0;0;.00nan;0;0
1840;35536;60;0;0;0;0;.00nan;0;0
1841;2016;61;100;35;0;35;1.000;3600000;0
1841;6572;62;0;0;0;0;.00nan;0;0
1841;26919;62;86;28;1;27;.964;3600000;0
1841;30971;61;0;0;0;0;.00nan;0;0
1842;1051;44;92;41;3;38;.927;3900000;0
1842;3281;44;0;0;0;0;.00nan;0;0
1842;14351;40;0;0;0;0;.00nan;0;0
1842;26840;40;96;44;3;41;.932;3866000;0
1843;2152;49;57;33;5;28;.848;3900000;0
1843;3626;48;63;41;5;36;.878;3900000;0
1843;38547;48;0;0;0;0;.00nan;0;0
1843;38817;49;0;0;0;0;.00nan;0;0
1844;376;45;47;37;6;31;.838;3683000;0
1844;2198;45;0;0;0;0;.00nan;0;0
1844;19640;41;57;33;5;28;.848;3683000;0
1844;23075;41;0;0;0;0;.00nan;0;0
1845;780;52;0;0;0;0;.00nan;0;0
1845;3847;38;49;39;6;33;.846;3600000;0
1845;31021;38;0;0;0;0;.00nan;0;0
1845;32146;52;94;21;0;21;1.000;3600000;0
1846;3533;57;0;0;0;0;.00nan;0;0
1846;26865;57;58;25;3;22;.880;3600000;0
1846;26967;63;0;0;0;0;.00nan;0;0
1846;34814;63;60;29;4;25;.862;3563000;0
1847;2796;59;0;0;0;0;.00nan;0;0
1847;2824;65;90;47;3;44;.936;3580000;0
1847;4987;65;0;0;0;0;.00nan;0;0
1847;34639;59;55;15;2;13;.867;3600000;0
1848;6062;36;0;0;0;0;.00nan;0;0
1848;6081;56;0;0;0;0;.00nan;0;0
1848;14874;36;60;36;5;31;.861;3600000;0
1848;26824;56;56;27;4;23;.852;3600000;0
1849;751;64;0;0;0;0;.00nan;0;0
1849;5146;64;59;41;5;36;.878;3600000;0
1849;34788;42;0;0;0;0;.00nan;0;0
1849;37416;42;94;31;1;30;.968;3600000;0
1850;3;50;0;0;0;0;.00nan;0;0
1850;4447;54;0;0;0;0;.00nan;0;0
1850;5048;50;95;27;0;27;1.000;3600000;0
1850;31643;54;39;29;5;24;.828;3600000;0
1851;2016;61;61;21;2;19;.905;3600000;0
1851;2152;49;31;10;3;7;.700;592000;0
1851;30971;61;0;0;0;0;.00nan;0;0
1851;38817;49;72;17;0;17;1.000;2960000;0
1852;5137;58;0;0;0;0;.00nan;0;0
1852;14321;58;59;34;5;29;.853;3542000;0
1852;19640;41;61;26;3;23;.885;3600000;0
1852;23075;41;0;0;0;0;.00nan;0;0
1853;37;46;78;37;2;35;.946;3600000;0
1853;1486;43;66;33;3;30;.909;3600000;0
1853;2553;46;0;0;0;0;.00nan;0;0
1853;3625;43;0;0;0;0;.00nan;0;0
1854;6572;62;0;0;0;0;.00nan;0;0
1854;20717;60;98;21;0;21;1.000;3600000;0
1854;26919;62;61;29;4;25;.862;3600000;0
1854;35536;60;0;0;0;0;.00nan;0;0
1855;26967;63;87;34;2;32;.941;3600000;0
1855;28772;53;74;44;4;40;.909;3562000;0
1855;31156;53;0;0;0;0;.00nan;0;0
1855;34814;63;0;0;0;0;.00nan;0;0
1856;2796;59;0;0;0;0;.00nan;0;0
1856;3533;57;0;0;0;0;.00nan;0;0
1856;26865;57;66;32;4;28;.875;3600000;0
1856;34639;59;58;40;5;35;.875;3547000;0
1857;907;39;0;0;0;0;.00nan;0;0
1857;6062;36;78;47;5;42;.894;3600000;0
1857;14874;36;0;0;0;0;.00nan;0;0
1857;31126;39;55;9;1;8;.889;3600000;0
1858;5298;55;41;18;3;15;.833;3600000;0
1858;23493;51;53;34;5;29;.853;3539000;0
1858;31822;51;0;0;0;0;.00nan;0;0
1858;34770;55;0;0;0;0;.00nan;0;0
1859;376;45;0;0;0;0;.00nan;0;0
1859;2198;45;99;35;1;34;.971;3600000;0
1859;4447;54;0;0;0;0;.00nan;0;0
1859;31643;54;52;16;2;14;.875;3583000;0
1860;1051;44;78;30;2;28;.933;3568000;0
1860;3281;44;0;0;0;0;.00nan;0;0
1860;7049;47;56;10;1;9;.900;3600000;0
1860;33654;47;0;0;0;0;.00nan;0;0
1861;6572;62;52;28;4;24;.857;3542000;0
1861;14351;40;79;36;3;33;.917;3600000;0
1861;26840;40;0;0;0;0;.00nan;0;0
1861;26919;62;0;0;0;0;.00nan;0;0
1862;5137;58;0;0;0;0;.00nan;0;0
1862;14321;58;46;18;3;15;.833;3573000;0
1862;19640;41;80;32;2;30;.938;3600000;0
1862;23075;41;0;0;0;0;.00nan;0;0
1863;5298;55;71;23;1;22;.957;3600000;0
1863;6062;36;0;0;0;0;.00nan;0;0
1863;14874;36;49;38;6;32;.842;3600000;0
1863;34770;55;0;0;0;0;.00nan;0;0
1864;907;39;0;0;0;0;.00nan;0;0
1864;1486;43;95;40;3;37;.925;3515000;0
1864;3625;43;0;0;0;0;.00nan;0;0
1864;31126;39;100;37;1;36;.973;3600000;0
1865;6081;56;0;0;0;0;.00nan;0;0
1865;23493;51;0;0;0;0;.00nan;0;0
1865;26824;56;70;41;5;36;.878;3600000;0
1865;31822;51;76;30;2;28;.933;3600000;0
1866;780;52;0;0;0;0;.00nan;0;0
1866;3847;38;62;24;3;21;.875;3600000;0
1866;31021;38;0;0;0;0;.00nan;0;0
1866;32146;52;38;26;5;21;.808;3526000;0
1867;2796;59;0;0;0;0;.00nan;0;0
1867;26967;63;79;31;2;29;.935;3568000;0
1867;34639;59;65;16;1;15;.938;3600000;0
1867;34814;63;0;0;0;0;.00nan;0;0
1868;376;45;40;34;6;28;.824;3242000;0
1868;2198;45;54;3;0;3;1.000;358000;0
1868;34788;42;82;27;1;26;.963;3600000;0
1868;37416;42;0;0;0;0;.00nan;0;0
1869;3;50;0;0;0;0;.00nan;0;0
1869;4716;4619;93;47;4;43;.915;3900000;0
1869;5048;50;34;23;4;19;.826;3900000;0
1869;10698;4619;0;0;0;0;.00nan;0;0
1870;3626;48;0;0;0;0;.00nan;0;0
1870;14351;40;0;0;0;0;.00nan;0;0
1870;26840;40;100;36;0;36;1.000;3600000;0
1870;38547;48;72;34;2;32;.941;3540000;0
1871;907;39;53;16;2;14;.875;3600000;0
1871;1486;43;0;0;0;0;.00nan;0;0
1871;3625;43;65;41;4;37;.902;3564000;0
1871;31126;39;0;0;0;0;.00nan;0;0
1872;751;64;0;0;0;0;.00nan;0;0
1872;2296;37;0;0;0;0;.00nan;0;0
1872;5146;64;92;34;1;33;.971;3684000;0
1872;5883;37;82;32;2;30;.938;3684000;0
1873;3533;57;0;0;0;0;.00nan;0;0
1873;19640;41;0;0;0;0;.00nan;0;0
1873;23075;41;57;36;5;31;.861;3600000;0
1873;26865;57;100;34;0;34;1.000;3600000;0
1874;2796;59;92;40;2;38;.950;3900000;0
1874;26967;63;0;0;0;0;.00nan;0;0
1874;34639;59;0;0;0;0;.00nan;0;0
1874;34814;63;91;37;2;35;.946;3900000;0
1875;780;52;71;31;3;28;.903;3600000;0
1875;3847;38;36;25;6;19;.760;3600000;0
1875;31021;38;0;0;0;0;.00nan;0;0
1875;32146;52;0;0;0;0;.00nan;0;0
1876;2824;65;0;0;0;0;.00nan;0;0
1876;4987;65;91;47;4;43;.915;3558000;0
1876;28772;53;69;23;2;21;.913;3600000;0
1876;31156;53;0;0;0;0;.00nan;0;0
1877;5298;55;0;0;0;0;.00nan;0;0
1877;6062;36;59;32;4;28;.875;3600000;0
1877;14874;36;0;0;0;0;.00nan;0;0
1877;34770;55;39;25;5;20;.800;3569000;0
1878;6081;56;84;30;2;28;.933;3600000;0
1878;23493;51;0;0;0;0;.00nan;0;0
1878;26824;56;0;0;0;0;.00nan;0;0
1878;31822;51;61;37;5;32;.865;3600000;0
1879;37;46;82;57;4;53;.930;3600000;0
1879;2553;46;0;0;0;0;.00nan;0;0
1879;4447;54;0;0;0;0;.00nan;0;0
1879;31643;54;86;14;0;14;1.000;3600000;0
1880;376;45;0;0;0;0;.00nan;0;0
1880;2198;45;64;36;4;32;.889;3600000;0
1880;34788;42;0;0;0;0;.00nan;0;0
1880;37416;42;100;29;0;29;1.000;3600000;0
1881;1051;44;51;30;4;26;.867;3600000;0
1881;2152;49;0;0;0;0;.00nan;0;0
1881;3281;44;0;0;0;0;.00nan;0;0
1881;4435;49;75;22;1;21;.955;3600000;0
1882;3626;48;87;30;1;29;.967;3600000;0
1882;14351;40;0;0;0;0;.00nan;0;0
1882;26840;40;79;34;2;32;.941;3574000;0
1882;38547;48;0;0;0;0;.00nan;0;0
1883;3;50;0;0;0;0;.00nan;0;0
1883;4716;4619;76;30;2;28;.933;3549000;0
1883;5048;50;86;25;1;24;.960;3600000;0
1883;10698;4619;0;0;0;0;.00nan;0;0
1884;7049;47;100;35;1;34;.971;3900000;0
1884;20717;60;83;25;1;24;.960;3900000;0
1884;33654;47;0;0;0;0;.00nan;0;0
1884;35536;60;0;0;0;0;.00nan;0;0
1885;2016;61;90;21;0;21;1.000;3600000;0
1885;6572;62;0;0;0;0;.00nan;0;0
1885;26919;62;75;37;4;33;.892;3600000;0
1885;30971;61;0;0;0;0;.00nan;0;0
1886;3533;57;0;0;0;0;.00nan;0;0
1886;19640;41;36;16;4;12;.750;3673000;0
1886;23075;41;0;0;0;0;.00nan;0;0
1886;26865;57;49;31;5;26;.839;3673000;0
1887;780;52;0;0;0;0;.00nan;0;0
1887;5137;58;0;0;0;0;.00nan;0;0
1887;14321;58;42;29;5;24;.828;3532000;0
1887;32146;52;67;28;3;25;.893;3600000;0
1888;2824;65;77;31;2;29;.935;3600000;0
1888;4987;65;0;0;0;0;.00nan;0;0
1888;28772;53;0;0;0;0;.00nan;0;0
1888;31156;53;66;32;3;29;.906;3564000;0
1889;751;64;95;37;2;35;.946;3900000;0
1889;2296;37;90;29;2;27;.931;3900000;0
1889;5146;64;0;0;0;0;.00nan;0;0
1889;5883;37;0;0;0;0;.00nan;0;0
1890;1051;44;0;0;0;0;.00nan;0;0
1890;2152;49;68;24;2;22;.917;3600000;0
1890;3281;44;67;42;5;37;.881;3600000;0
1890;4435;49;0;0;0;0;.00nan;0;0
1891;2016;61;37;20;4;16;.800;3600000;0
1891;6572;62;74;20;1;19;.950;3600000;0
1891;26919;62;0;0;0;0;.00nan;0;0
1891;30971;61;0;0;0;0;.00nan;0;0
1892;7049;47;0;0;0;0;.00nan;0;0
1892;20717;60;0;0;0;0;.00nan;0;0
1892;33654;47;83;38;3;35;.921;3600000;0
1892;35536;60;44;35;5;30;.857;3568000;0
1893;2796;59;0;0;0;0;.00nan;0;0
1893;2824;65;0;0;0;0;.00nan;0;0
1893;4987;65;61;34;4;30;.882;3600000;0
1893;34639;59;58;28;3;25;.893;3600000;0
1894;2152;49;0;0;0;0;.00nan;0;0
1894;4435;49;59;36;4;32;.889;3578000;0
1894;20717;60;0;0;0;0;.00nan;0;0
1894;35536;60;67;28;3;25;.893;3600000;0
1895;1486;43;0;0;0;0;.00nan;0;0
1895;3625;43;71;30;3;27;.900;3545000;0
1895;6062;36;0;0;0;0;.00nan;0;0
1895;14874;36;87;30;1;29;.967;3600000;0
1896;3847;38;0;0;0;0;.00nan;0;0
1896;5298;55;83;28;2;26;.929;3600000;0
1896;31021;38;63;34;4;30;.882;3585000;0
1896;34770;55;0;0;0;0;.00nan;0;0
1897;37;46;96;40;3;37;.925;3600000;0
1897;2553;46;0;0;0;0;.00nan;0;0
1897;4447;54;0;0;0;0;.00nan;0;0
1897;31643;54;91;17;0;17;1.000;3600000;0
1898;376;45;0;0;0;0;.00nan;0;0
1898;751;64;0;0;0;0;.00nan;0;0
1898;2198;45;71;25;2;23;.920;3557000;0
1898;5146;64;80;27;1;26;.963;3600000;0
1899;3;50;0;0;0;0;.00nan;0;0
1899;5048;50;53;19;3;16;.842;3600000;0
1899;34788;42;0;0;0;0;.00nan;0;0
1899;37416;42;61;35;4;31;.886;3575000;0
1900;1051;44;62;23;2;21;.913;3600000;0
1900;3281;44;0;0;0;0;.00nan;0;0
1900;7049;47;62;33;4;29;.879;3580000;0
1900;33654;47;0;0;0;0;.00nan;0;0
1901;4716;4619;100;25;0;25;1.000;3600000;0
1901;6572;62;0;0;0;0;.00nan;0;0
1901;10698;4619;0;0;0;0;.00nan;0;0
1901;26919;62;74;34;3;31;.912;3600000;0
1902;3847;38;0;0;0;0;.00nan;0;0
1902;28772;53;89;33;1;32;.970;3900000;0
1902;31021;38;85;27;1;26;.963;3900000;0
1902;31156;53;0;0;0;0;.00nan;0;0
1903;1486;43;89;38;1;37;.974;3600000;0
1903;2796;59;0;0;0;0;.00nan;0;0
1903;3625;43;0;0;0;0;.00nan;0;0
1903;34639;59;61;20;2;18;.900;3588000;0
1904;5298;55;0;0;0;0;.00nan;0;0
1904;19640;41;99;39;1;38;.974;3600000;0
1904;23075;41;0;0;0;0;.00nan;0;0
1904;34770;55;47;28;4;24;.857;3600000;0
1905;6081;56;0;0;0;0;.00nan;0;0
1905;26824;56;78;22;1;21;.955;3600000;0
1905;26967;63;79;31;2;29;.935;3592000;0
1905;34814;63;0;0;0;0;.00nan;0;0
1906;3533;57;0;0;0;0;.00nan;0;0
1906;5137;58;0;0;0;0;.00nan;0;0
1906;14321;58;54;22;3;19;.864;3900000;0
1906;26865;57;93;42;3;39;.929;3900000;0
1907;907;39;0;0;0;0;.00nan;0;0
1907;6062;36;0;0;0;0;.00nan;0;0
1907;14874;36;67;45;4;41;.911;3600000;0
1907;31126;39;80;15;0;15;1.000;3600000;0
1908;4447;54;0;0;0;0;.00nan;0;0
1908;31643;54;59;35;4;31;.886;3600000;0
1908;34788;42;51;35;6;29;.829;3016000;0
1908;37416;42;48;0;0;0;.00nan;529000;0
1909;37;46;74;38;4;34;.895;3515000;0
1909;751;64;0;0;0;0;.00nan;0;0
1909;2553;46;0;0;0;0;.00nan;0;0
1909;5146;64;77;28;2;26;.929;3600000;0
1910;376;45;0;0;0;0;.00nan;0;0
1910;2198;45;84;23;1;22;.957;3600000;0
1910;23493;51;68;26;2;24;.923;3544000;0
1910;31822;51;0;0;0;0;.00nan;0;0
1911;3;50;0;0;0;0;.00nan;0;0
1911;5048;50;75;22;1;21;.955;3600000;0
1911;6572;62;0;0;0;0;.00nan;0;0
1911;26919;62;54;39;5;34;.872;3600000;0
1912;1051;44;17;26;7;19;.731;3036000;0
1912;3281;44;48;0;0;0;.00nan;564000;0
1912;7049;47;62;31;4;27;.871;3600000;0
1912;33654;47;0;0;0;0;.00nan;0;0
1913;2152;49;0;0;0;0;.00nan;0;0
1913;4435;49;78;29;2;27;.931;3600000;0
1913;20717;60;0;0;0;0;.00nan;0;0
1913;35536;60;79;35;3;32;.914;3566000;0
1914;3626;48;63;17;2;15;.882;3600000;0
1914;4716;4619;68;39;4;35;.897;3600000;0
1914;10698;4619;0;0;0;0;.00nan;0;0
1914;38547;48;0;0;0;0;.00nan;0;0
1915;2016;61;43;18;3;15;.833;3564000;0
1915;2296;37;0;0;0;0;.00nan;0;0
1915;5883;37;75;33;2;31;.939;3600000;0
1915;30971;61;0;0;0;0;.00nan;0;0
1916;907;39;0;0;0;0;.00nan;0;0
1916;31126;39;75;22;1;21;.955;3600000;0
1916;32340;55;0;0;0;0;.00nan;0;0
1916;34770;55;61;27;3;24;.889;3561000;0
1917;3533;57;46;21;3;18;.857;3900000;0
1917;26865;57;0;0;0;0;.00nan;0;0
1917;28772;53;0;0;0;0;.00nan;0;0
1917;31156;53;77;43;3;40;.930;3900000;0
1918;780;52;0;0;0;0;.00nan;0;0
1918;2824;65;0;0;0;0;.00nan;0;0
1918;4987;65;68;32;3;29;.906;3623000;0
1918;32146;52;51;25;4;21;.840;3641000;0
1919;6062;36;60;20;2;18;.900;3600000;0
1919;14874;36;0;0;0;0;.00nan;0;0
1919;19640;41;0;0;0;0;.00nan;0;0
1919;23075;41;50;26;4;22;.846;3522000;0
1920;1486;43;0;0;0;0;.00nan;0;0
1920;2796;59;40;20;4;16;.800;3600000;0
1920;3625;43;42;32;5;27;.844;3580000;0
1920;34639;59;0;0;0;0;.00nan;0;0
1921;6081;56;0;0;0;0;.00nan;0;0
1921;26824;56;81;29;2;27;.931;3533000;0
1921;26967;63;0;0;0;0;.00nan;0;0
1921;34814;63;92;22;0;22;1.000;3600000;0
1922;37;46;0;0;0;0;.00nan;0;0
1922;2553;46;77;35;3;32;.914;3533000;0
1922;4447;54;0;0;0;0;.00nan;0;0
1922;31643;54;80;24;1;23;.958;3600000;0
1923;3;50;62;28;3;25;.893;3600000;0
1923;5048;50;0;0;0;0;.00nan;0;0
1923;6572;62;80;34;2;32;.941;3600000;0
1923;26919;62;0;0;0;0;.00nan;0;0
1924;3847;38;65;48;5;43;.896;3600000;0
1924;5137;58;81;27;2;25;.926;3600000;0
1924;14321;58;0;0;0;0;.00nan;0;0
1924;31021;38;0;0;0;0;.00nan;0;0
1925;751;64;24;24;6;18;.750;2039000;0
1925;5146;64;58;15;1;14;.933;1561000;0
1925;34788;42;0;0;0;0;.00nan;0;0
1925;37416;42;66;34;4;30;.882;3600000;0
1926;376;45;70;35;4;31;.886;3572000;0
1926;2198;45;0;0;0;0;.00nan;0;0
1926;23493;51;0;0;0;0;.00nan;0;0
1926;31822;51;70;28;2;26;.929;3600000;0
1927;2152;49;80;21;1;20;.952;3600000;0
1927;4435;49;0;0;0;0;.00nan;0;0
1927;14351;40;0;0;0;0;.00nan;0;0
1927;26840;40;39;30;6;24;.800;3600000;0
1928;1051;44;0;0;0;0;.00nan;0;0
1928;3281;44;73;10;0;10;1.000;3600000;0
1928;7049;47;0;0;0;0;.00nan;0;0
1928;33654;47;62;41;5;36;.878;3600000;0
1929;3626;48;96;32;1;31;.969;3825000;0
1929;4716;4619;65;23;2;21;.913;3825000;0
1929;10698;4619;0;0;0;0;.00nan;0;0
1929;38547;48;0;0;0;0;.00nan;0;0
1930;2016;61;0;0;0;0;.00nan;0;0
1930;2296;37;92;41;2;39;.951;3772000;0
1930;5883;37;0;0;0;0;.00nan;0;0
1930;30971;61;82;39;3;36;.923;3772000;0
1931;2824;65;72;21;2;19;.905;3600000;0
1931;3533;57;0;0;0;0;.00nan;0;0
1931;4987;65;0;0;0;0;.00nan;0;0
1931;26865;57;72;38;3;35;.921;3571000;0
1932;780;52;0;0;0;0;.00nan;0;0
1932;3533;57;80;38;3;35;.921;3900000;0
1932;26865;57;0;0;0;0;.00nan;0;0
1932;32146;52;89;38;3;35;.921;3900000;0
1933;2824;65;0;0;0;0;.00nan;0;0
1933;4987;65;73;25;2;23;.920;3600000;0
1933;28772;53;0;0;0;0;.00nan;0;0
1933;31156;53;81;44;3;41;.932;3600000;0
1934;23493;51;61;28;3;25;.893;3600000;0
1934;31822;51;0;0;0;0;.00nan;0;0
1934;32340;55;0;0;0;0;.00nan;0;0
1934;34770;55;84;41;4;37;.902;3546000;0
1935;6062;36;0;0;0;0;.00nan;0;0
1935;6081;56;0;0;0;0;.00nan;0;0
1935;14874;36;86;35;2;33;.943;3600000;0
1935;26824;56;48;31;5;26;.839;3600000;0
1936;2796;59;0;0;0;0;.00nan;0;0
1936;5137;58;0;0;0;0;.00nan;0;0
1936;14321;58;86;55;4;51;.927;3590000;0
1936;34639;59;73;27;2;25;.926;3600000;0
1937;907;39;0;0;0;0;.00nan;0;0
1937;19640;41;99;52;1;51;.981;3600000;0
1937;23075;41;0;0;0;0;.00nan;0;0
1937;31126;39;70;23;2;21;.913;3545000;0
1938;4447;54;0;0;0;0;.00nan;0;0
1938;31643;54;71;19;1;18;.947;3600000;0
1938;34788;42;0;0;0;0;.00nan;0;0
1938;37416;42;46;38;6;32;.842;3600000;0
1939;4716;4619;21;27;6;21;.778;3296000;0
1939;6572;62;68;46;5;41;.891;3600000;0
1939;10698;4619;39;1;1;0;.000;235000;0
1939;26919;62;0;0;0;0;.00nan;0;0
1940;3626;48;84;34;3;31;.912;3703000;0
1940;20717;60;0;0;0;0;.00nan;0;0
1940;35536;60;88;39;2;37;.949;3703000;0
1940;38547;48;0;0;0;0;.00nan;0;0
1941;1486;43;61;36;4;32;.889;3600000;0
1941;3625;43;0;0;0;0;.00nan;0;0
1941;26967;63;0;0;0;0;.00nan;0;0
1941;34814;63;100;33;0;33;1.000;3600000;0
1942;3626;48;0;0;0;0;.00nan;0;0
1942;20717;60;48;32;5;27;.844;3600000;0
1942;35536;60;0;0;0;0;.00nan;0;0
1942;38547;48;80;32;2;30;.938;3600000;0
1943;2016;61;0;0;0;0;.00nan;0;0
1943;14351;40;0;0;0;0;.00nan;0;0
1943;26840;40;48;22;4;18;.818;3845000;0
1943;30971;61;58;24;3;21;.875;3845000;0
1944;1486;43;0;0;0;0;.00nan;0;0
1944;2824;65;0;0;0;0;.00nan;0;0
1944;3625;43;41;53;7;46;.868;3600000;0
1944;4987;65;81;36;3;33;.917;3600000;0
1945;23493;51;79;39;3;36;.923;3600000;0
1945;31822;51;0;0;0;0;.00nan;0;0
1945;32340;55;29;9;3;6;.667;512000;0
1945;34770;55;79;28;1;27;.964;3063000;0
1946;6062;36;0;0;0;0;.00nan;0;0
1946;6081;56;49;34;5;29;.853;3600000;0
1946;14874;36;81;28;2;26;.929;3600000;0
1946;26628;56;0;0;0;0;.00nan;0;0
1947;37;46;79;35;3;32;.914;3618000;0
1947;2152;49;0;0;0;0;.00nan;0;0
1947;2553;46;0;0;0;0;.00nan;0;0
1947;4435;49;80;30;2;28;.933;3618000;0
1948;3533;57;0;0;0;0;.00nan;0;0
1948;3847;38;0;0;0;0;.00nan;0;0
1948;27474;57;98;31;1;30;.968;3600000;0
1948;31021;38;82;33;2;31;.939;3543000;0
1949;780;52;0;0;0;0;.00nan;0;0
1949;2796;59;0;0;0;0;.00nan;0;0
1949;32146;52;54;25;3;22;.880;3566000;0
1949;34639;59;76;33;2;31;.939;3600000;0
1950;5137;58;0;0;0;0;.00nan;0;0
1950;14321;58;64;24;3;21;.875;3600000;0
1950;28772;53;0;0;0;0;.00nan;0;0
1950;31156;53;66;35;4;31;.886;3597000;0
1951;907;39;0;0;0;0;.00nan;0;0
1951;19640;41;37;23;5;18;.783;3600000;0
1951;23075;41;0;0;0;0;.00nan;0;0
1951;31126;39;89;38;2;36;.947;3600000;0
1952;376;45;0;0;0;0;.00nan;0;0
1952;2198;45;61;28;3;25;.893;3556000;0
1952;2296;37;0;0;0;0;.00nan;0;0
1952;5883;37;67;28;2;26;.929;3600000;0
1953;751;64;55;4;0;4;1.000;449000;0
1953;4447;54;57;22;3;19;.864;3600000;0
1953;5146;64;69;42;6;36;.857;3151000;0
1953;31643;54;0;0;0;0;.00nan;0;0
1954;3;50;0;0;0;0;.00nan;0;0
1954;5048;50;48;27;5;22;.815;3521000;0
1954;34788;42;0;0;0;0;.00nan;0;0
1954;37416;42;85;39;3;36;.923;3600000;0
1955;4716;4619;59;29;3;26;.897;3600000;0
1955;7049;47;91;35;2;33;.943;3600000;0
1955;10698;4619;0;0;0;0;.00nan;0;0
1955;33654;47;0;0;0;0;.00nan;0;0
1956;1051;44;0;0;0;0;.00nan;0;0
1956;3281;44;78;44;4;40;.909;3600000;0
1956;6572;62;44;34;5;29;.853;3554000;0
1956;26919;62;0;0;0;0;.00nan;0;0
1957;2016;61;69;17;1;16;.941;3600000;0
1957;14351;40;22;23;6;17;.739;2712000;0
1957;26840;40;51;8;1;7;.875;888000;0
1957;30971;61;0;0;0;0;.00nan;0;0
1958;1486;43;58;38;5;33;.868;3600000;0
1958;2824;65;0;0;0;0;.00nan;0;0
1958;3625;43;0;0;0;0;.00nan;0;0
1958;4987;65;33;28;6;22;.786;3600000;0
1959;907;39;72;22;1;21;.955;3600000;0
1959;26967;63;0;0;0;0;.00nan;0;0
1959;31126;39;0;0;0;0;.00nan;0;0
1959;34814;63;80;42;4;38;.905;3600000;0
1960;2796;59;86;32;2;30;.938;3600000;0
1960;3847;38;67;40;4;36;.900;3600000;0
1960;31021;38;0;0;0;0;.00nan;0;0
1960;34639;59;0;0;0;0;.00nan;0;0
1961;6062;36;54;34;5;29;.853;3600000;0
1961;14874;36;0;0;0;0;.00nan;0;0
1961;19640;41;0;0;0;0;.00nan;0;0
1961;23075;41;67;31;3;28;.903;3600000;0
1962;5137;58;64;28;4;24;.857;3522000;0
1962;14321;58;0;0;0;0;.00nan;0;0
1962;32340;55;83;32;2;30;.938;3600000;0
1962;34770;55;0;0;0;0;.00nan;0;0
1963;6081;56;73;49;5;44;.898;3600000;0
1963;14061;56;0;0;0;0;.00nan;0;0
1963;23493;51;0;0;0;0;.00nan;0;0
1963;31822;51;24;31;7;24;.774;3518000;0
1964;376;45;74;29;2;27;.931;3600000;0
1964;2198;45;0;0;0;0;.00nan;0;0
1964;2296;37;28;6;3;3;.500;594000;0
1964;5883;37;57;33;5;28;.848;3006000;0
1965;751;64;60;26;3;23;.885;3600000;0
1965;4447;54;0;0;0;0;.00nan;0;0
1965;5146;64;0;0;0;0;.00nan;0;0
1965;31643;54;62;17;1;16;.941;3600000;0
1966;37;46;96;37;1;36;.973;3600000;0
1966;2152;49;36;12;3;9;.750;3581000;0
1966;2553;46;0;0;0;0;.00nan;0;0
1966;4435;49;0;0;0;0;.00nan;0;0
1967;3;50;86;38;2;36;.947;3600000;0
1967;5048;50;0;0;0;0;.00nan;0;0
1967;34788;42;58;27;3;24;.889;3544000;0
1967;37416;42;0;0;0;0;.00nan;0;0
1968;780;52;0;0;0;0;.00nan;0;0
1968;3533;57;74;50;5;45;.900;3600000;0
1968;27474;57;0;0;0;0;.00nan;0;0
1968;32146;52;65;26;2;24;.923;3600000;0
1969;4716;4619;58;24;3;21;.875;3600000;0
1969;7049;47;54;37;5;32;.865;3571000;0
1969;10698;4619;0;0;0;0;.00nan;0;0
1969;33654;47;0;0;0;0;.00nan;0;0
1970;1051;44;79;23;2;21;.913;3900000;0
1970;3281;44;0;0;0;0;.00nan;0;0
1970;6572;62;0;0;0;0;.00nan;0;0
1970;26919;62;97;35;2;33;.943;3900000;0
1971;3;50;0;0;0;0;.00nan;0;0
1971;37;46;75;27;2;25;.926;3600000;0
1971;2553;46;0;0;0;0;.00nan;0;0
1971;5048;50;92;28;1;27;.964;3600000;0
1972;5137;58;0;0;0;0;.00nan;0;0
1972;14321;58;61;14;1;13;.929;3600000;0
1972;28772;53;80;55;5;50;.909;3600000;0
1972;31156;53;0;0;0;0;.00nan;0;0
1973;780;52;0;0;0;0;.00nan;0;0
1973;19640;41;68;39;5;34;.872;3900000;0
1973;23075;41;0;0;0;0;.00nan;0;0
1973;32146;52;54;32;5;27;.844;3900000;0
1974;1486;43;84;43;3;40;.930;3600000;0
1974;3625;43;0;0;0;0;.00nan;0;0
1974;5298;55;83;11;0;11;1.000;3600000;0
1974;34770;55;0;0;0;0;.00nan;0;0
1975;6062;36;0;0;0;0;.00nan;0;0
1975;14874;36;55;33;5;28;.848;3600000;0
1975;23493;51;65;27;3;24;.889;3600000;0
1975;31822;51;0;0;0;0;.00nan;0;0
1976;907;39;0;0;0;0;.00nan;0;0
1976;3847;38;94;24;1;23;.958;3600000;0
1976;31021;38;0;0;0;0;.00nan;0;0
1976;31126;39;56;24;3;21;.875;3559000;0
1977;351;65;61;20;3;17;.850;3900000;0
1977;2824;65;0;0;0;0;.00nan;0;0
1977;3533;57;0;0;0;0;.00nan;0;0
1977;27474;57;84;36;3;33;.917;3900000;0
1978;2796;59;0;0;0;0;.00nan;0;0
1978;6081;56;71;34;3;31;.912;3545000;0
1978;14061;56;0;0;0;0;.00nan;0;0
1978;34639;59;66;22;2;20;.909;3600000;0
1979;751;64;0;0;0;0;.00nan;0;0
1979;5146;64;82;30;2;28;.933;3566000;0
1979;34788;42;0;0;0;0;.00nan;0;0
1979;37416;42;89;24;1;23;.958;3600000;0
1980;376;45;0;0;0;0;.00nan;0;0
1980;2198;45;54;32;4;28;.875;3600000;0
1980;4447;54;25;21;5;16;.762;1750000;0
1980;31643;54;54;9;1;8;.889;1762000;0
1981;3;50;0;0;0;0;.00nan;0;0
1981;37;46;89;29;1;28;.966;3600000;0
1981;2553;46;0;0;0;0;.00nan;0;0
1981;5048;50;63;19;2;17;.895;3553000;0
1982;1051;44;86;37;2;35;.946;3900000;0
1982;3281;44;0;0;0;0;.00nan;0;0
1982;4716;4619;0;0;0;0;.00nan;0;0
1982;10698;4619;72;25;2;23;.920;3900000;0
1983;3626;48;51;33;4;29;.879;3900000;0
1983;7049;47;54;25;4;21;.840;3900000;0
1983;33654;47;0;0;0;0;.00nan;0;0
1983;38547;48;0;0;0;0;.00nan;0;0
1984;6572;62;79;25;2;23;.920;3600000;0
1984;20717;60;0;0;0;0;.00nan;0;0
1984;26919;62;0;0;0;0;.00nan;0;0
1984;35536;60;50;29;4;25;.862;3593000;0
1985;2152;49;0;0;0;0;.00nan;0;0
1985;4435;49;37;21;4;17;.810;3532000;0
1985;14351;40;0;0;0;0;.00nan;0;0
1985;26840;40;88;39;2;37;.949;3600000;0
1986;2016;61;0;0;0;0;.00nan;0;0
1986;2296;37;0;0;0;0;.00nan;0;0
1986;5883;37;66;39;4;35;.897;3600000;0
1986;30971;61;60;26;3;23;.885;3600000;0
1987;6062;36;71;20;1;19;.950;3600000;0
1987;14874;36;0;0;0;0;.00nan;0;0
1987;23493;51;0;0;0;0;.00nan;0;0
1987;31822;51;57;33;5;28;.848;3600000;0
1988;780;52;0;0;0;0;.00nan;0;0
1988;19640;41;0;0;0;0;.00nan;0;0
1988;23075;41;86;20;0;20;1.000;3600000;0
1988;32146;52;41;30;5;25;.833;3600000;0
1989;907;39;73;18;1;17;.944;3600000;0
1989;28772;53;0;0;0;0;.00nan;0;0
1989;31126;39;0;0;0;0;.00nan;0;0
1989;31156;53;68;40;5;35;.875;3600000;0
1990;351;65;0;0;0;0;.00nan;0;0
1990;2824;65;64;35;5;30;.857;3550000;0
1990;6081;56;0;0;0;0;.00nan;0;0
1990;14061;56;59;23;3;20;.870;3600000;0
1991;1486;43;0;0;0;0;.00nan;0;0
1991;3625;43;97;45;3;42;.933;3600000;0
1991;5298;55;50;24;4;20;.833;3556000;0
1991;34770;55;0;0;0;0;.00nan;0;0
1992;2796;59;73;34;3;31;.912;3712000;0
1992;3533;57;66;24;2;22;.917;3712000;0
1992;27474;57;0;0;0;0;.00nan;0;0
1992;34639;59;0;0;0;0;.00nan;0;0
1993;3847;38;0;0;0;0;.00nan;0;0
1993;5137;58;25;12;4;8;.667;1117000;0
1993;14321;58;94;15;0;15;1.000;2432000;0
1993;31021;38;61;26;3;23;.885;3600000;0
1994;751;64;68;32;3;29;.906;3600000;0
1994;5146;64;0;0;0;0;.00nan;0;0
1994;34788;42;0;0;0;0;.00nan;0;0
1994;37416;42;43;24;4;20;.833;3547000;0
1995;376;45;93;40;2;38;.950;3552000;0
1995;2198;45;0;0;0;0;.00nan;0;0
1995;4447;54;0;0;0;0;.00nan;0;0
1995;31643;54;81;19;1;18;.947;3600000;0
1996;2152;49;66;18;2;16;.889;3600000;0
1996;4338;40;59;48;6;42;.875;3600000;0
1996;4435;49;0;0;0;0;.00nan;0;0
1996;28712;40;0;0;0;0;.00nan;0;0
1997;1051;44;0;0;0;0;.00nan;0;0
1997;3281;44;71;38;4;34;.895;3900000;0
1997;4716;4619;55;28;4;24;.857;3900000;0
1997;10698;4619;0;0;0;0;.00nan;0;0
1998;3626;48;29;25;6;19;.760;2996000;0
1998;7049;47;59;38;5;33;.868;3600000;0
1998;33654;47;0;0;0;0;.00nan;0;0
1998;38547;48;49;8;1;7;.875;604000;0
1999;2016;61;70;22;2;20;.909;3600000;0
1999;2296;37;49;35;5;30;.857;3600000;0
1999;5883;37;0;0;0;0;.00nan;0;0
1999;30971;61;0;0;0;0;.00nan;0;0
2000;751;64;0;0;0;0;.00nan;0;0
2000;4447;54;87;27;1;26;.963;3600000;0
2000;5146;64;76;40;3;37;.925;3600000;0
2000;31643;54;0;0;0;0;.00nan;0;0
2001;780;52;0;0;0;0;.00nan;0;0
2001;907;39;0;0;0;0;.00nan;0;0
2001;31126;39;42;18;4;14;.778;3600000;0
2001;32146;52;82;26;1;25;.962;3600000;0
2002;2796;59;0;0;0;0;.00nan;0;0
2002;19640;41;61;7;0;7;1.000;1112000;0
2002;23075;41;23;26;6;20;.769;2488000;0
2002;34639;59;66;33;3;30;.909;3600000;0
2003;37;46;96;34;1;33;.971;3600000;0
2003;2198;45;63;29;3;26;.897;3533000;0
2003;2553;46;0;0;0;0;.00nan;0;0
2003;34815;45;0;0;0;0;.00nan;0;0
2004;3626;48;100;51;2;49;.961;3900000;0
2004;4716;4619;51;21;2;19;.905;3900000;0
2004;10698;4619;0;0;0;0;.00nan;0;0
2004;38547;48;0;0;0;0;.00nan;0;0
2005;1592;63;0;0;0;0;.00nan;0;0
2005;5298;55;0;0;0;0;.00nan;0;0
2005;34770;55;35;23;4;19;.826;3600000;0
2005;34814;63;100;38;0;38;1.000;3600000;0
2006;2796;59;42;39;7;32;.821;3600000;0
2006;19640;41;100;36;0;36;1.000;3600000;0
2006;23075;41;0;0;0;0;.00nan;0;0
2006;34639;59;0;0;0;0;.00nan;0;0
2007;6081;56;83;42;4;38;.905;3900000;0
2007;14061;56;0;0;0;0;.00nan;0;0
2007;23493;51;47;26;4;22;.846;3900000;0
2007;31822;51;0;0;0;0;.00nan;0;0
2008;3533;57;0;0;0;0;.00nan;0;0
2008;5137;58;0;0;0;0;.00nan;0;0
2008;14321;58;64;27;3;24;.889;3600000;0
2008;27474;57;58;32;4;28;.875;3542000;0
2009;4447;54;0;0;0;0;.00nan;0;0
2009;31643;54;66;33;3;30;.909;3580000;0
2009;34788;42;0;0;0;0;.00nan;0;0
2009;37416;42;67;25;2;23;.920;3600000;0
2010;37;46;54;23;3;20;.870;3600000;0
2010;2198;45;0;0;0;0;.00nan;0;0
2010;2553;46;0;0;0;0;.00nan;0;0
2010;34815;45;24;33;7;26;.788;3600000;0
2011;2267;48;43;29;4;25;.862;2553000;0
2011;4716;4619;66;17;2;15;.882;3600000;0
2011;10698;4619;0;0;0;0;.00nan;0;0
2011;38547;48;44;21;4;17;.810;1047000;0
2012;2016;61;89;31;2;29;.935;3600000;0
2012;7049;47;54;34;4;30;.882;3531000;0
2012;33654;47;0;0;0;0;.00nan;0;0
2012;40296;61;0;0;0;0;.00nan;0;0
2013;6572;62;55;23;3;20;.870;3874000;0
2013;20717;60;0;0;0;0;.00nan;0;0
2013;26919;62;0;0;0;0;.00nan;0;0
2013;35536;60;82;36;3;33;.917;3900000;0
2014;6062;36;0;0;0;0;.00nan;0;0
2014;14874;36;47;27;4;23;.852;3600000;0
2014;23493;51;86;27;1;26;.963;3600000;0
2014;31822;51;0;0;0;0;.00nan;0;0
2015;907;39;0;0;0;0;.00nan;0;0
2015;5298;55;64;27;3;24;.889;3600000;0
2015;31126;39;51;32;5;27;.844;3546000;0
2015;34770;55;0;0;0;0;.00nan;0;0
2016;1592;63;0;0;0;0;.00nan;0;0
2016;6081;56;80;28;1;27;.964;3577000;0
2016;14061;56;0;0;0;0;.00nan;0;0
2016;34814;63;100;38;0;38;1.000;3600000;0
2017;351;65;27;24;6;18;.750;2521000;0
2017;2824;65;44;11;2;9;.818;1079000;0
2017;3847;38;73;19;1;18;.947;3600000;0
2017;31021;38;0;0;0;0;.00nan;0;0
2018;1592;63;0;0;0;0;.00nan;0;0
2018;6081;56;0;0;0;0;.00nan;0;0
2018;14061;56;63;22;2;20;.909;3550000;0
2018;34814;63;93;32;1;31;.969;3600000;0
2019;1486;43;58;30;3;27;.900;3900000;0
2019;3625;43;0;0;0;0;.00nan;0;0
2019;19640;41;67;31;3;28;.903;3900000;0
2019;23075;41;0;0;0;0;.00nan;0;0
2020;2796;59;0;0;0;0;.00nan;0;0
2020;5137;58;0;0;0;0;.00nan;0;0
2020;14321;58;56;29;4;25;.862;3554000;0
2020;34639;59;63;27;3;24;.889;3600000;0
2021;22970;38;0;0;0;0;.00nan;0;0
2021;28772;53;84;34;2;32;.941;3600000;0
2021;31021;38;78;17;1;16;.941;3600000;0
2021;31156;53;0;0;0;0;.00nan;0;0
2022;351;65;0;0;0;0;.00nan;0;0
2022;780;52;0;0;0;0;.00nan;0;0
2022;2824;65;63;33;4;29;.879;3545000;0
2022;32146;52;51;23;3;20;.870;3600000;0
2023;907;39;36;24;5;19;.792;3600000;0
2023;6062;36;17;28;7;21;.750;2909000;0
2023;14874;36;41;8;2;6;.750;691000;0
2023;31126;39;0;0;0;0;.00nan;0;0
2024;37;46;54;31;4;27;.871;3557000;0
2024;2553;46;0;0;0;0;.00nan;0;0
2024;34788;42;0;0;0;0;.00nan;0;0
2024;37416;42;63;21;2;19;.905;3600000;0
2025;3533;57;0;0;0;0;.00nan;0;0
2025;5298;55;0;0;0;0;.00nan;0;0
2025;27474;57;65;24;2;22;.917;3563000;0
2025;34770;55;80;26;1;25;.962;3600000;0
2026;3;50;0;0;0;0;.00nan;0;0
2026;751;64;0;0;0;0;.00nan;0;0
2026;33661;50;60;46;6;40;.870;3600000;0
2026;38651;64;59;21;3;18;.857;3600000;0
2027;2198;45;86;34;1;33;.971;3600000;0
2027;20717;60;0;0;0;0;.00nan;0;0
2027;34815;45;0;0;0;0;.00nan;0;0
2027;35536;60;63;25;3;22;.880;3528000;0
2028;1051;44;51;26;4;22;.846;3543000;0
2028;2267;48;0;0;0;0;.00nan;0;0
2028;3281;44;0;0;0;0;.00nan;0;0
2028;38547;48;84;38;3;35;.921;3600000;0
2029;2016;61;0;0;0;0;.00nan;0;0
2029;4716;4619;100;19;0;19;1.000;3600000;0
2029;10698;4619;0;0;0;0;.00nan;0;0
2029;30971;61;64;31;4;27;.871;3600000;0
2030;4338;40;92;42;2;40;.952;3546000;0
2030;7049;47;95;23;0;23;1.000;3600000;0
2030;28712;40;0;0;0;0;.00nan;0;0
2030;33654;47;0;0;0;0;.00nan;0;0
2031;2152;49;74;23;1;22;.957;3600000;0
2031;4435;49;0;0;0;0;.00nan;0;0
2031;6572;62;0;0;0;0;.00nan;0;0
2031;26919;62;98;47;2;45;.957;3559000;0
2032;1486;43;0;0;0;0;.00nan;0;0
2032;3625;43;54;29;4;25;.862;3600000;0
2032;19640;41;0;0;0;0;.00nan;0;0
2032;23075;41;52;14;2;12;.857;3600000;0
2033;780;52;82;29;1;28;.966;3600000;0
2033;28772;53;0;0;0;0;.00nan;0;0
2033;31156;53;53;28;4;24;.857;3600000;0
2033;32146;52;0;0;0;0;.00nan;0;0
2034;904;54;59;22;2;20;.909;3600000;0
2034;2296;37;0;0;0;0;.00nan;0;0
2034;23043;37;69;31;3;28;.903;3578000;0
2034;35595;54;0;0;0;0;.00nan;0;0
2035;351;65;85;27;1;26;.963;3600000;0
2035;2824;65;0;0;0;0;.00nan;0;0
2035;22970;38;37;19;4;15;.789;2184000;0
2035;31021;38;65;8;0;8;1.000;1416000;0
2036;3533;57;83;31;1;30;.968;3600000;0
2036;5137;58;66;33;3;30;.909;3541000;0
2036;14321;58;0;0;0;0;.00nan;0;0
2036;27474;57;0;0;0;0;.00nan;0;0
2037;907;39;0;0;0;0;.00nan;0;0
2037;23493;51;93;34;2;32;.941;3600000;0
2037;31126;39;68;38;4;34;.895;3534000;0
2037;31822;51;0;0;0;0;.00nan;0;0
2038;3;50;39;39;6;33;.846;3600000;0
2038;751;64;64;34;3;31;.912;3600000;0
2038;5048;50;0;0;0;0;.00nan;0;0
2038;38651;64;0;0;0;0;.00nan;0;0
2039;37;46;66;32;3;29;.906;3600000;0
2039;2553;46;0;0;0;0;.00nan;0;0
2039;34788;42;82;31;2;29;.935;3600000;0
2039;37416;42;0;0;0;0;.00nan;0;0
2040;2016;61;62;36;4;32;.889;3600000;0
2040;4716;4619;40;14;3;11;.786;3600000;0
2040;10698;4619;0;0;0;0;.00nan;0;0
2040;30971;61;0;0;0;0;.00nan;0;0
2041;376;45;45;18;3;15;.833;3580000;0
2041;2198;45;0;0;0;0;.00nan;0;0
2041;20717;60;91;36;2;34;.944;3600000;0
2041;35536;60;0;0;0;0;.00nan;0;0
2042;2152;49;0;0;0;0;.00nan;0;0
2042;4435;49;68;20;1;19;.950;3600000;0
2042;6572;62;90;44;2;42;.955;3556000;0
2042;26919;62;0;0;0;0;.00nan;0;0
2043;4338;40;0;0;0;0;.00nan;0;0
2043;7049;47;81;31;2;29;.935;3600000;0
2043;28712;40;68;32;3;29;.906;3545000;0
2043;33654;47;0;0;0;0;.00nan;0;0
2044;1592;63;0;0;0;0;.00nan;0;0
2044;23493;51;0;0;0;0;.00nan;0;0
2044;31822;51;80;31;2;29;.935;3847000;0
2044;34814;63;87;47;3;44;.936;3847000;0
2045;6062;36;0;0;0;0;.00nan;0;0
2045;6081;56;100;37;2;35;.946;3900000;0
2045;14061;56;0;0;0;0;.00nan;0;0
2045;14874;36;97;47;2;45;.957;3900000;0
2046;904;54;0;0;0;0;.00nan;0;0
2046;2296;37;55;35;4;31;.886;3563000;0
2046;23043;37;0;0;0;0;.00nan;0;0
2046;35595;54;85;35;2;33;.943;3600000;0
2047;1051;44;82;16;0;16;1.000;3600000;0
2047;2267;48;0;0;0;0;.00nan;0;0
2047;3281;44;0;0;0;0;.00nan;0;0
2047;38547;48;56;34;5;29;.853;3600000;0
2048;3;50;0;0;0;0;.00nan;0;0
2048;376;45;0;0;0;0;.00nan;0;0
2048;2198;45;55;34;4;30;.882;3900000;0
2048;5048;50;66;34;4;30;.882;3900000;0
2049;23493;51;73;31;3;28;.903;3571000;0
2049;26967;63;0;0;0;0;.00nan;0;0
2049;31822;51;0;0;0;0;.00nan;0;0
2049;34814;63;71;31;2;29;.935;3600000;0
2050;37;46;71;24;1;23;.958;3560000;0
2050;1486;43;96;26;0;26;1.000;3600000;0
2050;2553;46;0;0;0;0;.00nan;0;0
2050;3625;43;0;0;0;0;.00nan;0;0
2051;2796;59;0;0;0;0;.00nan;0;0
2051;3533;57;0;0;0;0;.00nan;0;0
2051;27474;57;100;57;2;55;.965;3900000;0
2051;34639;59;64;22;2;20;.909;3900000;0
2052;780;52;0;0;0;0;.00nan;0;0
2052;5137;58;0;0;0;0;.00nan;0;0
2052;14321;58;64;23;2;21;.913;3600000;0
2052;32146;52;52;23;3;20;.870;3560000;0
2053;2296;37;0;0;0;0;.00nan;0;0
2053;4447;54;0;0;0;0;.00nan;0;0
2053;5883;37;57;37;5;32;.865;3600000;0
2053;35595;54;67;19;1;18;.947;3600000;0
2054;7049;47;82;36;2;34;.944;3600000;0
2054;20717;60;0;0;0;0;.00nan;0;0
2054;25787;47;0;0;0;0;.00nan;0;0
2054;35536;60;85;39;3;36;.923;3587000;0
2055;2152;49;0;0;0;0;.00nan;0;0
2055;3626;48;79;37;3;34;.919;3900000;0
2055;4435;49;71;26;3;23;.885;3900000;0
2055;38547;48;0;0;0;0;.00nan;0;0
2056;3;50;48;27;5;22;.815;3600000;0
2056;376;45;0;0;0;0;.00nan;0;0
2056;2198;45;90;35;1;34;.971;3600000;0
2056;5048;50;0;0;0;0;.00nan;0;0
2057;6062;36;0;0;0;0;.00nan;0;0
2057;14874;36;61;34;4;30;.882;3600000;0
2057;21469;39;0;0;0;0;.00nan;0;0
2057;31126;39;42;37;5;32;.865;3551000;0
2058;1486;43;87;30;1;29;.967;3600000;0
2058;3533;57;0;0;0;0;.00nan;0;0
2058;3625;43;0;0;0;0;.00nan;0;0
2058;27474;57;69;33;4;29;.879;3600000;0
2059;351;65;81;51;5;46;.902;3600000;0
2059;2824;65;0;0;0;0;.00nan;0;0
2059;5298;55;62;16;1;15;.938;3600000;0
2059;34770;55;0;0;0;0;.00nan;0;0
2060;6081;56;0;0;0;0;.00nan;0;0
2060;14061;56;36;19;4;15;.789;3542000;0
2060;23493;51;100;64;2;62;.969;3600000;0
2060;31822;51;0;0;0;0;.00nan;0;0
2061;37;46;0;0;0;0;.00nan;0;0
2061;2553;46;60;21;2;19;.905;3600000;0
2061;7049;47;48;13;2;11;.846;1431000;0
2061;25787;47;67;21;1;20;.952;2169000;0
2062;3847;38;79;28;1;27;.964;3600000;0
2062;19640;41;43;25;4;21;.840;3600000;0
2062;23075;41;0;0;0;0;.00nan;0;0
2062;31021;38;0;0;0;0;.00nan;0;0
2063;5137;58;0;0;0;0;.00nan;0;0
2063;14321;58;78;36;2;34;.944;3900000;0
2063;28772;53;0;0;0;0;.00nan;0;0
2063;31156;53;66;23;2;21;.913;3877000;0
2064;3;50;0;0;0;0;.00nan;0;0
2064;5048;50;95;21;0;21;1.000;3600000;0
2064;34788;42;0;0;0;0;.00nan;0;0
2064;37416;42;91;36;2;34;.944;3593000;0
2065;3626;48;54;28;3;25;.893;3564000;0
2065;6572;62;66;26;2;24;.923;3600000;0
2065;26919;62;0;0;0;0;.00nan;0;0
2065;38547;48;0;0;0;0;.00nan;0;0
2066;2016;61;0;0;0;0;.00nan;0;0
2066;14351;40;0;0;0;0;.00nan;0;0
2066;26840;40;68;30;2;28;.933;3900000;0
2066;30971;61;74;24;2;22;.917;3900000;0
2067;1486;43;0;0;0;0;.00nan;0;0
2067;3533;57;55;21;2;19;.905;3600000;0
2067;3625;43;79;36;3;33;.917;3555000;0
2067;27474;57;0;0;0;0;.00nan;0;0
2068;6081;56;96;31;1;30;.968;3900000;0
2068;14061;56;0;0;0;0;.00nan;0;0
2068;23493;51;0;0;0;0;.00nan;0;0
2068;31822;51;90;28;1;27;.964;3900000;0
2069;751;64;0;0;0;0;.00nan;0;0
2069;2296;37;0;0;0;0;.00nan;0;0
2069;5146;64;50;29;4;25;.862;3600000;0
2069;5883;37;72;23;1;22;.957;3600000;0
2070;21469;39;65;22;2;20;.909;3600000;0
2070;26967;63;0;0;0;0;.00nan;0;0
2070;31126;39;0;0;0;0;.00nan;0;0
2070;34814;63;88;44;3;41;.932;3550000;0
2071;3847;38;0;0;0;0;.00nan;0;0
2071;28772;53;69;38;4;34;.895;3571000;0
2071;31021;38;52;20;3;17;.850;3600000;0
2071;31156;53;0;0;0;0;.00nan;0;0
2072;780;52;0;0;0;0;.00nan;0;0
2072;2796;59;0;0;0;0;.00nan;0;0
2072;32146;52;64;23;3;20;.870;3580000;0
2072;34639;59;95;37;2;35;.946;3600000;0
2073;5298;55;0;0;0;0;.00nan;0;0
2073;6062;36;50;37;5;32;.865;3600000;0
2073;14874;36;0;0;0;0;.00nan;0;0
2073;34770;55;100;46;0;46;1.000;3600000;0
2074;4447;54;78;25;1;24;.960;3900000;0
2074;4716;4619;84;23;1;22;.957;3900000;0
2074;5182;4619;0;0;0;0;.00nan;0;0
2074;31643;54;0;0;0;0;.00nan;0;0
2075;37;46;81;14;0;14;1.000;3600000;0
2075;2553;46;0;0;0;0;.00nan;0;0
2075;25787;47;72;36;3;33;.917;3600000;0
2075;33654;47;0;0;0;0;.00nan;0;0
2076;376;45;0;0;0;0;.00nan;0;0
2076;2198;45;47;31;5;26;.839;3763000;0
2076;34788;42;0;0;0;0;.00nan;0;0
2076;37416;42;61;36;4;32;.889;3763000;0
2077;5137;58;65;29;3;26;.897;3600000;0
2077;14321;58;0;0;0;0;.00nan;0;0
2077;19640;41;0;0;0;0;.00nan;0;0
2077;23075;41;67;39;4;35;.897;3554000;0
2078;1051;44;65;23;3;20;.870;3547000;0
2078;2152;49;0;0;0;0;.00nan;0;0
2078;3281;44;0;0;0;0;.00nan;0;0
2078;4435;49;64;22;2;20;.909;3600000;0
2079;3626;48;0;0;0;0;.00nan;0;0
2079;6572;62;0;0;0;0;.00nan;0;0
2079;26919;62;60;28;3;25;.893;3591000;0
2079;38547;48;73;21;2;19;.905;3600000;0
2080;780;52;71;21;2;19;.905;3600000;0
2080;19640;41;24;12;4;8;.667;736000;0
2080;23075;41;86;31;1;30;.968;2864000;0
2080;32146;52;0;0;0;0;.00nan;0;0
2081;751;64;76;24;2;22;.917;3600000;0
2081;2296;37;81;37;3;34;.919;3545000;0
2081;5146;64;0;0;0;0;.00nan;0;0
2081;5883;37;0;0;0;0;.00nan;0;0
2082;3847;38;92;34;1;33;.971;3600000;0
2082;28772;53;0;0;0;0;.00nan;0;0
2082;31021;38;0;0;0;0;.00nan;0;0
2082;31156;53;82;34;2;32;.941;3586000;0
2083;2796;59;52;28;4;24;.857;3600000;0
2083;6062;36;43;4;1;3;.750;337000;0
2083;14874;36;28;37;7;30;.811;3263000;0
2083;34639;59;0;0;0;0;.00nan;0;0
2084;21469;39;0;0;0;0;.00nan;0;0
2084;26967;63;67;27;2;25;.926;3600000;0
2084;31126;39;36;29;5;24;.828;3600000;0
2084;34814;63;0;0;0;0;.00nan;0;0
2085;4447;54;0;0;0;0;.00nan;0;0
2085;4716;4619;0;0;0;0;.00nan;0;0
2085;5182;4619;69;31;3;28;.903;3600000;0
2085;31643;54;66;21;2;19;.905;3600000;0
2086;351;65;73;29;2;27;.931;3600000;0
2086;2824;65;0;0;0;0;.00nan;0;0
2086;5298;55;0;0;0;0;.00nan;0;0
2086;34770;55;65;29;3;26;.897;3546000;0
2087;376;45;78;33;3;30;.909;3577000;0
2087;2198;45;0;0;0;0;.00nan;0;0
2087;34788;42;93;28;1;27;.964;3600000;0
2087;37416;42;0;0;0;0;.00nan;0;0
2088;1051;44;0;0;0;0;.00nan;0;0
2088;2152;49;88;17;0;17;1.000;3600000;0
2088;3281;44;22;22;6;16;.727;3600000;0
2088;4435;49;0;0;0;0;.00nan;0;0
2089;2016;61;0;0;0;0;.00nan;0;0
2089;14351;40;0;0;0;0;.00nan;0;0
2089;26840;40;68;42;3;39;.929;3900000;0
2089;30971;61;58;26;3;23;.885;3900000;0
2090;1486;43;75;34;3;31;.912;3600000;0
2090;3625;43;0;0;0;0;.00nan;0;0
2090;23493;51;36;32;6;26;.813;3600000;0
2090;31822;51;0;0;0;0;.00nan;0;0
2091;351;65;65;34;4;30;.882;3600000;0
2091;2824;65;0;0;0;0;.00nan;0;0
2091;19640;41;44;31;5;26;.839;3583000;0
2091;23075;41;0;0;0;0;.00nan;0;0
2092;2016;61;0;0;0;0;.00nan;0;0
2092;26967;63;0;0;0;0;.00nan;0;0
2092;30971;61;72;25;2;23;.920;3549000;0
2092;34814;63;96;23;0;23;1.000;3600000;0
2093;3533;57;0;0;0;0;.00nan;0;0
2093;3847;38;83;24;1;23;.958;3880000;0
2093;27474;57;89;29;1;28;.966;3900000;0
2093;31021;38;0;0;0;0;.00nan;0;0
2094;6062;36;0;0;0;0;.00nan;0;0
2094;14874;36;62;28;2;26;.929;3600000;0
2094;21469;39;0;0;0;0;.00nan;0;0
2094;31126;39;82;26;1;25;.962;3600000;0
2095;1486;43;90;31;1;30;.968;3600000;0
2095;3625;43;0;0;0;0;.00nan;0;0
2095;23493;51;54;24;3;21;.875;3600000;0
2095;31822;51;0;0;0;0;.00nan;0;0
2096;376;45;0;0;0;0;.00nan;0;0
2096;751;64;0;0;0;0;.00nan;0;0
2096;2198;45;89;40;1;39;.975;3579000;0
2096;5146;64;100;23;0;23;1.000;3600000;0
2097;4716;4619;100;29;0;29;1.000;3600000;0
2097;5182;4619;0;0;0;0;.00nan;0;0
2097;6572;62;98;39;1;38;.974;3600000;0
2097;26919;62;0;0;0;0;.00nan;0;0
2098;1051;44;86;38;2;36;.947;3587000;0
2098;2152;49;82;24;1;23;.958;3600000;0
2098;3281;44;0;0;0;0;.00nan;0;0
2098;4435;49;0;0;0;0;.00nan;0;0
2099;2296;37;0;0;0;0;.00nan;0;0
2099;5883;37;65;21;2;19;.905;3550000;0
2099;34788;42;0;0;0;0;.00nan;0;0
2099;37416;42;98;33;1;32;.970;3600000;0
2100;780;52;0;0;0;0;.00nan;0;0
2100;2796;59;0;0;0;0;.00nan;0;0
2100;32146;52;57;31;4;27;.871;3600000;0
2100;34639;59;83;30;1;29;.967;3600000;0
2101;5298;55;74;25;2;23;.920;3900000;0
2101;6062;36;0;0;0;0;.00nan;0;0
2101;14874;36;84;41;2;39;.951;3900000;0
2101;34770;55;0;0;0;0;.00nan;0;0
2102;6081;56;46;26;4;22;.846;3665000;0
2102;14061;56;0;0;0;0;.00nan;0;0
2102;21469;39;0;0;0;0;.00nan;0;0
2102;31126;39;77;35;3;32;.914;3700000;0
2103;2016;61;0;0;0;0;.00nan;0;0
2103;23493;51;51;20;3;17;.850;3600000;0
2103;30971;61;65;37;4;33;.892;3595000;0
2103;31822;51;0;0;0;0;.00nan;0;0
2104;3;50;0;0;0;0;.00nan;0;0
2104;37;46;35;32;6;26;.813;3600000;0
2104;2553;46;0;0;0;0;.00nan;0;0
2104;5048;50;55;25;3;22;.880;3600000;0
2105;3533;57;0;0;0;0;.00nan;0;0
2105;19640;41;0;0;0;0;.00nan;0;0
2105;23075;41;75;26;2;24;.923;3705000;0
2105;27474;57;89;40;3;37;.925;3705000;0
2106;351;65;70;31;3;28;.903;3574000;0
2106;2824;65;0;0;0;0;.00nan;0;0
2106;5137;58;0;0;0;0;.00nan;0;0
2106;14321;58;65;20;2;18;.900;3600000;0
2107;376;45;0;0;0;0;.00nan;0;0
2107;2198;45;68;35;4;31;.886;3600000;0
2107;4447;54;0;0;0;0;.00nan;0;0
2107;31643;54;54;35;5;30;.857;3553000;0
2108;4716;4619;30;15;4;11;.733;3534000;0
2108;6572;62;100;45;2;43;.956;3600000;0
2108;17360;4619;0;0;0;0;.00nan;0;0
2108;26919;62;0;0;0;0;.00nan;0;0
2109;2152;49;0;0;0;0;.00nan;0;0
2109;3626;48;50;28;4;24;.857;3531000;0
2109;4435;49;77;31;2;29;.935;3600000;0
2109;38547;48;0;0;0;0;.00nan;0;0
2110;7049;47;0;0;0;0;.00nan;0;0
2110;14351;40;0;0;0;0;.00nan;0;0
2110;25787;47;56;19;3;16;.842;3600000;0
2110;26840;40;66;31;4;27;.871;3555000;0
2111;2016;61;38;27;5;22;.815;3563000;0
2111;23493;51;0;0;0;0;.00nan;0;0
2111;30971;61;0;0;0;0;.00nan;0;0
2111;31822;51;94;52;4;48;.923;3600000;0
2112;2296;37;0;0;0;0;.00nan;0;0
2112;5883;37;99;54;3;51;.944;3600000;0
2112;34788;42;0;0;0;0;.00nan;0;0
2112;37416;42;25;26;6;20;.769;3568000;0
2113;780;52;86;32;1;31;.969;3600000;0
2113;2796;59;0;0;0;0;.00nan;0;0
2113;32146;52;0;0;0;0;.00nan;0;0
2113;34639;59;63;24;2;22;.917;3556000;0
2114;5298;55;0;0;0;0;.00nan;0;0
2114;6062;36;70;35;3;32;.914;3600000;0
2114;14874;36;0;0;0;0;.00nan;0;0
2114;34770;55;27;18;4;14;.778;3577000;0
2115;1486;43;50;36;5;31;.861;3579000;0
2115;3625;43;0;0;0;0;.00nan;0;0
2115;26967;63;0;0;0;0;.00nan;0;0
2115;34814;63;67;31;3;28;.903;3600000;0
2116;6081;56;0;0;0;0;.00nan;0;0
2116;14061;56;67;24;2;22;.917;3548000;0
2116;21469;39;96;38;1;37;.974;3600000;0
2116;31126;39;0;0;0;0;.00nan;0;0
2117;3;50;43;33;6;27;.818;3678000;0
2117;37;46;0;0;0;0;.00nan;0;0
2117;2553;46;42;32;5;27;.844;3678000;0
2117;5048;50;0;0;0;0;.00nan;0;0
2118;3533;57;94;36;1;35;.972;3600000;0
2118;19640;41;76;30;2;28;.933;3577000;0
2118;23075;41;0;0;0;0;.00nan;0;0
2118;27474;57;0;0;0;0;.00nan;0;0
2119;3847;38;70;33;3;30;.909;3600000;0
2119;5137;58;0;0;0;0;.00nan;0;0
2119;14321;58;42;25;4;21;.840;3582000;0
2119;31021;38;0;0;0;0;.00nan;0;0
2120;351;65;0;0;0;0;.00nan;0;0
2120;2824;65;70;28;2;26;.929;3900000;0
2120;28772;53;82;27;2;25;.926;3900000;0
2120;31156;53;0;0;0;0;.00nan;0;0
2121;376;45;92;34;2;32;.941;3600000;0
2121;751;64;0;0;0;0;.00nan;0;0
2121;2198;45;0;0;0;0;.00nan;0;0
2121;5146;64;21;25;6;19;.760;3600000;0
2122;2152;49;62;19;2;17;.895;3600000;0
2122;3626;48;0;0;0;0;.00nan;0;0
2122;4435;49;0;0;0;0;.00nan;0;0
2122;38547;48;78;44;4;40;.909;3570000;0
2123;14351;40;80;26;1;25;.962;3600000;0
2123;20717;60;70;34;3;31;.912;3551000;0
2123;26840;40;0;0;0;0;.00nan;0;0
2123;35536;60;0;0;0;0;.00nan;0;0
2124;4716;4619;84;22;1;21;.955;3600000;0
2124;6572;62;49;29;4;25;.862;3600000;0
2124;17360;4619;0;0;0;0;.00nan;0;0
2124;26919;62;0;0;0;0;.00nan;0;0
2125;1051;44;50;20;3;17;.850;3544000;0
2125;3281;44;0;0;0;0;.00nan;0;0
2125;7049;47;98;37;2;35;.946;3600000;0
2125;25787;47;0;0;0;0;.00nan;0;0
2126;780;52;0;0;0;0;.00nan;0;0
2126;28772;53;0;0;0;0;.00nan;0;0
2126;31156;53;100;28;0;28;1.000;3600000;0
2126;32146;52;42;32;5;27;.844;3600000;0
2127;2796;59;0;0;0;0;.00nan;0;0
2127;3847;38;0;0;0;0;.00nan;0;0
2127;31021;38;92;30;1;29;.967;3600000;0
2127;34639;59;54;30;4;26;.867;3600000;0
2128;3;50;0;0;0;0;.00nan;0;0
2128;751;64;100;31;0;31;1.000;3600000;0
2128;5048;50;91;27;1;26;.963;3558000;0
2128;5146;64;0;0;0;0;.00nan;0;0
2129;37;46;51;29;6;23;.793;3600000;0
2129;2553;46;0;0;0;0;.00nan;0;0
2129;4447;54;0;0;0;0;.00nan;0;0
2129;31643;54;67;32;3;29;.906;3600000;0
2130;1051;44;73;37;5;32;.865;3560000;0
2130;3281;44;0;0;0;0;.00nan;0;0
2130;20717;60;0;0;0;0;.00nan;0;0
2130;35536;60;63;36;4;32;.889;3600000;0
2131;2016;61;0;0;0;0;.00nan;0;0
2131;26967;63;0;0;0;0;.00nan;0;0
2131;30971;61;82;26;1;25;.962;3900000;0
2131;34814;63;98;38;1;37;.974;3900000;0
2132;3;50;0;0;0;0;.00nan;0;0
2132;4447;54;0;0;0;0;.00nan;0;0
2132;5048;50;66;40;4;36;.900;3600000;0
2132;31643;54;77;34;3;31;.912;3600000;0
2133;5298;55;70;31;2;29;.935;3600000;0
2133;6062;36;0;0;0;0;.00nan;0;0
2133;14874;36;43;36;6;30;.833;3600000;0
2133;34770;55;0;0;0;0;.00nan;0;0
2134;37;46;0;0;0;0;.00nan;0;0
2134;751;64;56;33;5;28;.848;3570000;0
2134;2553;46;74;33;3;30;.909;3600000;0
2134;5146;64;0;0;0;0;.00nan;0;0
2135;3847;38;60;27;3;24;.889;3600000;0
2135;5137;58;0;0;0;0;.00nan;0;0
2135;14321;58;100;29;0;29;1.000;3600000;0
2135;31021;38;0;0;0;0;.00nan;0;0
2136;351;65;71;34;3;31;.912;3600000;0
2136;2796;59;0;0;0;0;.00nan;0;0
2136;2824;65;0;0;0;0;.00nan;0;0
2136;34639;59;68;42;4;38;.905;3567000;0
2137;21469;39;0;0;0;0;.00nan;0;0
2137;23493;51;65;31;3;28;.903;3900000;0
2137;31126;39;60;23;3;20;.870;3900000;0
2137;31822;51;0;0;0;0;.00nan;0;0
2138;6572;62;71;28;2;26;.929;3900000;0
2138;14351;40;0;0;0;0;.00nan;0;0
2138;26840;40;85;33;2;31;.939;3900000;0
2138;26919;62;0;0;0;0;.00nan;0;0
2139;2152;49;0;0;0;0;.00nan;0;0
2139;4435;49;47;20;3;17;.850;3600000;0
2139;20717;60;20;9;4;5;.556;1046000;0
2139;35536;60;87;24;1;23;.958;2554000;0
2140;351;65;56;36;4;32;.889;3600000;0
2140;780;52;0;0;0;0;.00nan;0;0
2140;2824;65;0;0;0;0;.00nan;0;0
2140;32146;52;83;31;2;29;.935;3600000;0
2141;5137;58;0;0;0;0;.00nan;0;0
2141;14321;58;70;27;3;24;.889;3544000;0
2141;19640;41;85;31;1;30;.968;3600000;0
2141;23075;41;0;0;0;0;.00nan;0;0
2142;5298;55;0;0;0;0;.00nan;0;0
2142;26967;63;0;0;0;0;.00nan;0;0
2142;34770;55;82;33;2;31;.939;3600000;0
2142;34814;63;86;44;4;40;.909;3560000;0
2143;37;46;0;0;0;0;.00nan;0;0
2143;1486;43;57;28;3;25;.893;3600000;0
2143;2553;46;84;17;0;17;1.000;3600000;0
2143;3625;43;0;0;0;0;.00nan;0;0
2144;23493;51;93;30;1;29;.967;3600000;0
2144;26865;57;0;0;0;0;.00nan;0;0
2144;27474;57;56;40;5;35;.875;3600000;0
2144;31822;51;0;0;0;0;.00nan;0;0
2145;6062;36;0;0;0;0;.00nan;0;0
2145;14874;36;88;39;3;36;.923;3548000;0
2145;21469;39;0;0;0;0;.00nan;0;0
2145;31126;39;70;26;2;24;.923;3600000;0
2146;2296;37;0;0;0;0;.00nan;0;0
2146;5883;37;62;27;3;24;.889;3541000;0
2146;6081;56;81;30;1;29;.967;3600000;0
2146;14061;56;0;0;0;0;.00nan;0;0
2147;4447;54;0;0;0;0;.00nan;0;0
2147;31643;54;99;23;0;23;1.000;3600000;0
2147;34788;42;0;0;0;0;.00nan;0;0
2147;37416;42;81;44;3;41;.932;3600000;0
2148;376;45;0;0;0;0;.00nan;0;0
2148;1051;44;94;47;3;44;.936;3900000;0
2148;2198;45;67;27;3;24;.889;3900000;0
2148;3281;44;0;0;0;0;.00nan;0;0
2149;6572;62;87;38;2;36;.947;3570000;0
2149;7049;47;0;0;0;0;.00nan;0;0
2149;25787;47;94;25;0;25;1.000;3600000;0
2149;26919;62;0;0;0;0;.00nan;0;0
2150;14351;40;0;0;0;0;.00nan;0;0
2150;20717;60;0;0;0;0;.00nan;0;0
2150;26840;40;98;44;2;42;.955;3600000;0
2150;35536;60;40;20;4;16;.800;3513000;0
2151;2016;61;0;0;0;0;.00nan;0;0
2151;4716;4619;0;0;0;0;.00nan;0;0
2151;17360;4619;68;17;1;16;.941;3600000;0
2151;30971;61;43;35;5;30;.857;3600000;0
2152;5137;58;0;0;0;0;.00nan;0;0
2152;14321;58;59;39;5;34;.872;3600000;0
2152;19640;41;0;0;0;0;.00nan;0;0
2152;23075;41;57;19;2;17;.895;3600000;0
2153;2796;59;0;0;0;0;.00nan;0;0
2153;23493;51;0;0;0;0;.00nan;0;0
2153;31822;51;64;38;4;34;.895;3587000;0
2153;34639;59;64;22;2;20;.909;3600000;0
2154;6062;36;54;26;3;23;.885;3591000;0
2154;14874;36;0;0;0;0;.00nan;0;0
2154;26967;63;83;36;2;34;.944;3600000;0
2154;34814;63;0;0;0;0;.00nan;0;0
2155;5298;55;100;42;2;40;.952;3600000;0
2155;31044;39;0;0;0;0;.00nan;0;0
2155;31126;39;49;27;4;23;.852;3565000;0
2155;34770;55;0;0;0;0;.00nan;0;0
2156;2296;37;83;37;4;33;.892;3600000;0
2156;5883;37;0;0;0;0;.00nan;0;0
2156;6081;56;32;26;5;21;.808;3591000;0
2156;14061;56;0;0;0;0;.00nan;0;0
2157;751;64;71;33;3;30;.909;3900000;0
2157;4447;54;0;0;0;0;.00nan;0;0
2157;5146;64;0;0;0;0;.00nan;0;0
2157;31643;54;60;28;3;25;.893;3900000;0
2158;3;50;0;0;0;0;.00nan;0;0
2158;3626;48;64;32;4;28;.875;3600000;0
2158;5048;50;40;38;6;32;.842;3566000;0
2158;38547;48;0;0;0;0;.00nan;0;0
2159;780;52;0;0;0;0;.00nan;0;0
2159;3847;38;83;31;2;29;.935;3600000;0
2159;31021;38;0;0;0;0;.00nan;0;0
2159;32146;52;41;26;4;22;.846;3600000;0
2160;26865;57;98;20;0;20;1.000;3600000;0
2160;27474;57;0;0;0;0;.00nan;0;0
2160;28772;53;0;0;0;0;.00nan;0;0
2160;31156;53;76;31;2;29;.935;3550000;0
2161;376;45;88;36;2;34;.944;3600000;0
2161;1051;44;0;0;0;0;.00nan;0;0
2161;2198;45;0;0;0;0;.00nan;0;0
2161;3281;44;82;36;3;33;.917;3600000;0
2162;14351;40;44;30;5;25;.833;3600000;0
2162;20717;60;58;20;2;18;.900;3600000;0
2162;26840;40;0;0;0;0;.00nan;0;0
2162;35536;60;0;0;0;0;.00nan;0;0
2163;2152;49;68;23;2;21;.913;3593000;0
2163;4435;49;0;0;0;0;.00nan;0;0
2163;6572;62;0;0;0;0;.00nan;0;0
2163;26919;62;89;33;1;32;.970;3600000;0
2164;1486;43;43;32;5;27;.844;3600000;0
2164;3625;43;0;0;0;0;.00nan;0;0
2164;34788;42;0;0;0;0;.00nan;0;0
2164;37416;42;83;25;1;24;.960;3600000;0
2165;780;52;0;0;0;0;.00nan;0;0
2165;3847;38;0;0;0;0;.00nan;0;0
2165;31021;38;53;9;1;8;.889;3600000;0
2165;32146;52;76;43;4;39;.907;3600000;0
2166;2796;59;0;0;0;0;.00nan;0;0
2166;28772;53;80;34;3;31;.912;3900000;0
2166;31156;53;0;0;0;0;.00nan;0;0
2166;34639;59;77;40;3;37;.925;3900000;0
2167;37;46;0;0;0;0;.00nan;0;0
2167;751;64;0;0;0;0;.00nan;0;0
2167;2553;46;63;31;3;28;.903;3595000;0
2167;5146;64;100;37;1;36;.973;3600000;0
2168;3;50;80;26;1;25;.962;3600000;0
2168;3626;48;0;0;0;0;.00nan;0;0
2168;5048;50;0;0;0;0;.00nan;0;0
2168;38547;48;45;30;5;25;.833;3600000;0
2169;351;65;93;19;0;19;1.000;3600000;0
2169;2824;65;0;0;0;0;.00nan;0;0
2169;26865;57;80;42;3;39;.929;3600000;0
2169;27474;57;0;0;0;0;.00nan;0;0
2170;2016;61;0;0;0;0;.00nan;0;0
2170;4716;4619;0;0;0;0;.00nan;0;0
2170;17360;4619;100;24;0;24;1.000;3600000;0
2170;30971;61;70;40;4;36;.900;3600000;0
2171;1486;43;47;33;5;28;.848;3600000;0
2171;3625;43;0;0;0;0;.00nan;0;0
2171;34788;42;0;0;0;0;.00nan;0;0
2171;37416;42;100;21;0;21;1.000;3600000;0
2172;2016;61;0;0;0;0;.00nan;0;0
2172;2296;37;0;0;0;0;.00nan;0;0
2172;5883;37;74;31;2;29;.935;3600000;0
2172;30971;61;60;36;4;32;.889;3582000;0
2173;780;52;0;0;0;0;.00nan;0;0
2173;5137;58;0;0;0;0;.00nan;0;0
2173;14321;58;94;44;3;41;.932;3600000;0
2173;32146;52;60;28;4;24;.857;3553000;0
2174;6062;36;0;0;0;0;.00nan;0;0
2174;14874;36;60;30;3;27;.900;3600000;0
2174;28772;53;63;9;0;9;1.000;1310000;0
2174;31156;53;23;23;6;17;.739;2290000;0
2175;37;46;25;25;6;19;.760;3735000;0
2175;376;45;0;0;0;0;.00nan;0;0
2175;2198;45;57;34;5;29;.853;3735000;0
2175;2553;46;0;0;0;0;.00nan;0;0
2176;751;64;0;0;0;0;.00nan;0;0
2176;4447;54;0;0;0;0;.00nan;0;0
2176;5146;64;100;27;0;27;1.000;3600000;0
2176;31643;54;55;34;5;29;.853;3600000;0
2177;7049;47;0;0;0;0;.00nan;0;0
2177;14351;40;0;0;0;0;.00nan;0;0
2177;25787;47;48;22;4;18;.818;3793000;0
2177;26840;40;64;27;3;24;.889;3793000;0
2178;1051;44;90;31;1;30;.968;3600000;0
2178;3281;44;0;0;0;0;.00nan;0;0
2178;20717;60;70;27;2;25;.926;3563000;0
2178;35536;60;0;0;0;0;.00nan;0;0
2179;3626;48;30;32;6;26;.813;3600000;0
2179;6572;62;88;33;2;31;.939;3600000;0
2179;26919;62;0;0;0;0;.00nan;0;0
2179;38547;48;0;0;0;0;.00nan;0;0
2180;2016;61;72;22;1;21;.955;3600000;0
2180;2296;37;94;32;2;30;.938;3557000;0
2180;5883;37;0;0;0;0;.00nan;0;0
2180;30971;61;0;0;0;0;.00nan;0;0
2181;351;65;45;19;4;15;.789;3900000;0
2181;2824;65;0;0;0;0;.00nan;0;0
2181;26967;63;0;0;0;0;.00nan;0;0
2181;34814;63;91;49;4;45;.918;3900000;0
2182;3847;38;0;0;0;0;.00nan;0;0
2182;19640;41;66;15;2;13;.867;3900000;0
2182;23075;41;0;0;0;0;.00nan;0;0
2182;31021;38;97;42;2;40;.952;3900000;0
2183;780;52;0;0;0;0;.00nan;0;0
2183;6062;36;0;0;0;0;.00nan;0;0
2183;14874;36;61;34;4;30;.882;3586000;0
2183;32146;52;51;17;3;14;.824;3600000;0
2184;351;65;0;0;0;0;.00nan;0;0
2184;2824;65;99;55;3;52;.945;3600000;0
2184;6081;56;59;27;4;23;.852;3554000;0
2184;14061;56;0;0;0;0;.00nan;0;0
2185;23493;51;0;0;0;0;.00nan;0;0
2185;28772;53;74;28;2;26;.929;3658000;0
2185;31035;51;86;28;3;25;.893;3658000;0
2185;31156;53;0;0;0;0;.00nan;0;0
2186;37;46;0;0;0;0;.00nan;0;0
2186;376;45;0;0;0;0;.00nan;0;0
2186;2198;45;75;42;4;38;.905;3600000;0
2186;2553;46;44;31;5;26;.839;3547000;0
2187;2796;59;0;0;0;0;.00nan;0;0
2187;5298;55;41;40;5;35;.875;3900000;0
2187;34639;59;55;31;5;26;.839;3900000;0
2187;34770;55;0;0;0;0;.00nan;0;0
2188;5137;58;0;0;0;0;.00nan;0;0
2188;14321;58;76;34;3;31;.912;3600000;0
2188;26865;57;0;0;0;0;.00nan;0;0
2188;27474;57;45;26;4;22;.846;3575000;0
2189;907;39;0;0;0;0;.00nan;0;0
2189;1486;43;75;26;2;24;.923;3600000;0
2189;3625;43;0;0;0;0;.00nan;0;0
2189;31126;39;51;32;4;28;.875;3531000;0
2190;4716;4619;0;0;0;0;.00nan;0;0
2190;14351;40;0;0;0;0;.00nan;0;0
2190;17360;4619;71;24;2;22;.917;3600000;0
2190;26840;40;58;40;5;35;.875;3600000;0
2191;2152;49;0;0;0;0;.00nan;0;0
2191;4435;49;60;28;3;25;.893;3563000;0
2191;7049;47;0;0;0;0;.00nan;0;0
2191;25787;47;99;33;1;32;.970;3600000;0
2192;3626;48;96;44;3;41;.932;3600000;0
2192;6572;62;78;23;2;21;.913;3600000;0
2192;26919;62;0;0;0;0;.00nan;0;0
2192;38547;48;0;0;0;0;.00nan;0;0
2193;1051;44;95;34;1;33;.971;3600000;0
2193;3281;44;0;0;0;0;.00nan;0;0
2193;20717;60;83;35;2;33;.943;3546000;0
2193;35536;60;0;0;0;0;.00nan;0;0
2194;351;65;37;19;4;15;.789;3595000;0
2194;2824;65;0;0;0;0;.00nan;0;0
2194;23493;51;77;41;3;38;.927;3600000;0
2194;31035;51;0;0;0;0;.00nan;0;0
2195;751;64;0;0;0;0;.00nan;0;0
2195;5146;64;98;33;1;32;.970;3600000;0
2195;26967;63;0;0;0;0;.00nan;0;0
2195;34814;63;83;34;2;32;.941;3557000;0
2196;3847;38;65;9;0;9;1.000;638000;0
2196;19640;41;0;0;0;0;.00nan;0;0
2196;23075;41;68;27;3;24;.889;3600000;0
2196;31021;38;45;33;6;27;.818;2962000;0
2197;2796;59;0;0;0;0;.00nan;0;0
2197;6062;36;96;45;2;43;.956;3900000;0
2197;14874;36;0;0;0;0;.00nan;0;0
2197;34639;59;75;25;2;23;.920;3900000;0
2198;907;39;67;35;4;31;.886;3600000;0
2198;1486;43;0;0;0;0;.00nan;0;0
2198;3625;43;100;34;0;34;1.000;3600000;0
2198;31126;39;0;0;0;0;.00nan;0;0
2199;780;52;66;36;4;32;.889;3538000;0
2199;5298;55;0;0;0;0;.00nan;0;0
2199;32146;52;0;0;0;0;.00nan;0;0
2199;34770;55;75;26;2;24;.923;3600000;0
2200;6081;56;0;0;0;0;.00nan;0;0
2200;14061;56;74;23;1;22;.957;3600000;0
2200;28772;53;0;0;0;0;.00nan;0;0
2200;31156;53;44;41;6;35;.854;3600000;0
2201;376;45;0;0;0;0;.00nan;0;0
2201;2198;45;58;40;5;35;.875;3900000;0
2201;4447;54;0;0;0;0;.00nan;0;0
2201;31643;54;44;27;5;22;.815;3900000;0
2202;37;46;45;18;3;15;.833;3600000;0
2202;2553;46;0;0;0;0;.00nan;0;0
2202;34788;42;0;0;0;0;.00nan;0;0
2202;37416;42;74;24;2;22;.917;3600000;0
2203;3;50;0;0;0;0;.00nan;0;0
2203;2296;37;0;0;0;0;.00nan;0;0
2203;5048;50;84;26;1;25;.962;3600000;0
2203;5883;37;73;33;3;30;.909;3545000;0
2204;5137;58;0;0;0;0;.00nan;0;0
2204;14321;58;46;25;4;21;.840;3543000;0
2204;26865;57;89;34;2;32;.941;3600000;0
2204;27474;57;0;0;0;0;.00nan;0;0
2205;4716;4619;77;20;1;19;.950;3600000;0
2205;14351;40;79;36;3;33;.917;3574000;0
2205;17360;4619;0;0;0;0;.00nan;0;0
2205;26840;40;0;0;0;0;.00nan;0;0
2206;2016;61;0;0;0;0;.00nan;0;0
2206;7049;47;32;10;3;7;.700;536000;0
2206;25787;47;67;26;2;24;.923;3064000;0
2206;30971;61;46;23;4;19;.826;3600000;0
2207;1051;44;0;0;0;0;.00nan;0;0
2207;3281;44;79;13;0;13;1.000;3600000;0
2207;20717;60;0;0;0;0;.00nan;0;0
2207;35536;60;57;31;4;27;.871;3600000;0
2208;3626;48;0;0;0;0;.00nan;0;0
2208;6572;62;73;41;4;37;.902;3521000;0
2208;26919;62;0;0;0;0;.00nan;0;0
2208;38547;48;62;27;3;24;.889;3600000;0
2209;3847;38;70;36;4;32;.889;3600000;0
2209;19640;41;85;25;1;24;.960;3600000;0
2209;23075;41;0;0;0;0;.00nan;0;0
2209;31021;38;0;0;0;0;.00nan;0;0
2210;751;64;54;38;5;33;.868;3600000;0
2210;5146;64;0;0;0;0;.00nan;0;0
2210;26967;63;70;22;1;21;.955;3600000;0
2210;34814;63;0;0;0;0;.00nan;0;0
2211;4447;54;0;0;0;0;.00nan;0;0
2211;31643;54;79;21;1;20;.952;3600000;0
2211;34788;42;69;40;4;36;.900;3600000;0
2211;37416;42;0;0;0;0;.00nan;0;0
2212;2796;59;57;20;2;18;.900;3900000;0
2212;26865;57;0;0;0;0;.00nan;0;0
2212;27474;57;88;34;2;32;.941;3900000;0
2212;34639;59;0;0;0;0;.00nan;0;0
2213;2016;61;0;0;0;0;.00nan;0;0
2213;2152;49;0;0;0;0;.00nan;0;0
2213;4435;49;74;25;1;24;.960;3600000;0
2213;30971;61;67;38;4;34;.895;3600000;0
2214;1486;43;0;0;0;0;.00nan;0;0
2214;3625;43;91;43;3;40;.930;3845000;0
2214;5298;55;0;0;0;0;.00nan;0;0
2214;34770;55;55;34;4;30;.882;3845000;0
2215;3;50;0;0;0;0;.00nan;0;0
2215;2296;37;33;29;6;23;.793;2442000;0
2215;5048;50;61;27;4;23;.852;3600000;0
2215;5883;37;32;17;4;13;.765;1158000;0
2216;376;45;0;0;0;0;.00nan;0;0
2216;751;64;49;16;2;14;.875;1922000;0
2216;2198;45;83;26;1;25;.962;3600000;0
2216;5146;64;11;16;6;10;.625;1678000;0
2217;37;46;84;28;1;27;.964;3600000;0
2217;2152;49;46;26;4;22;.846;3600000;0
2217;2553;46;0;0;0;0;.00nan;0;0
2217;4435;49;0;0;0;0;.00nan;0;0
2218;5137;58;48;7;1;6;.857;763000;0
2218;14321;58;33;28;6;22;.786;2837000;0
2218;28772;53;81;24;1;23;.958;3600000;0
2218;31156;53;0;0;0;0;.00nan;0;0
2219;351;65;87;33;2;31;.939;3600000;0
2219;2824;65;0;0;0;0;.00nan;0;0
2219;26865;57;0;0;0;0;.00nan;0;0
2219;27474;57;61;26;3;23;.885;3544000;0
2220;1486;43;43;25;4;21;.840;3600000;0
2220;3625;43;0;0;0;0;.00nan;0;0
2220;6062;36;62;30;3;27;.900;3600000;0
2220;14874;36;0;0;0;0;.00nan;0;0
2221;2796;59;0;0;0;0;.00nan;0;0
2221;26967;63;0;0;0;0;.00nan;0;0
2221;34639;59;76;33;2;31;.939;3600000;0
2221;34814;63;75;32;3;29;.906;3545000;0
2222;780;52;54;10;1;9;.900;1569000;0
2222;5298;55;93;35;1;34;.971;3600000;0
2222;32146;52;7;16;6;10;.625;2031000;0
2222;34770;55;0;0;0;0;.00nan;0;0
2223;2296;37;0;0;0;0;.00nan;0;0
2223;5883;37;67;19;1;18;.947;3600000;0
2223;34788;42;0;0;0;0;.00nan;0;0
2223;37416;42;87;46;4;42;.913;3600000;0
2224;4716;4619;0;0;0;0;.00nan;0;0
2224;7049;47;60;43;5;38;.884;3870000;0
2224;17360;4619;42;24;4;20;.833;3870000;0
2224;25787;47;0;0;0;0;.00nan;0;0
2225;1051;44;0;0;0;0;.00nan;0;0
2225;3281;44;75;30;1;29;.967;3600000;0
2225;6572;62;94;37;2;35;.946;3551000;0
2225;26919;62;0;0;0;0;.00nan;0;0
2226;2016;61;0;0;0;0;.00nan;0;0
2226;20717;60;0;0;0;0;.00nan;0;0
2226;30971;61;34;25;5;20;.800;3557000;0
2226;35536;60;40;19;4;15;.789;3600000;0
2227;5137;58;0;0;0;0;.00nan;0;0
2227;14321;58;66;35;4;31;.886;3557000;0
2227;28772;53;72;24;2;22;.917;3600000;0
2227;31156;53;0;0;0;0;.00nan;0;0
2228;1486;43;99;39;2;37;.949;3900000;0
2228;3625;43;0;0;0;0;.00nan;0;0
2228;19640;41;69;21;2;19;.905;3900000;0
2228;23075;41;0;0;0;0;.00nan;0;0
2229;5298;55;0;0;0;0;.00nan;0;0
2229;6062;36;60;27;3;24;.889;3600000;0
2229;14874;36;0;0;0;0;.00nan;0;0
2229;34770;55;100;26;0;26;1.000;3600000;0
2230;2796;59;0;0;0;0;.00nan;0;0
2230;6081;56;87;39;3;36;.923;3900000;0
2230;14061;56;0;0;0;0;.00nan;0;0
2230;34639;59;75;28;3;25;.893;3900000;0
2231;3533;57;0;0;0;0;.00nan;0;0
2231;23493;51;63;14;1;13;.929;3900000;0
2231;27474;57;97;44;1;43;.977;3900000;0
2231;31035;51;0;0;0;0;.00nan;0;0
2232;351;65;79;34;2;32;.941;3600000;0
2232;2824;65;0;0;0;0;.00nan;0;0
2232;3847;38;54;30;4;26;.867;3563000;0
2232;31021;38;0;0;0;0;.00nan;0;0
2233;907;39;0;0;0;0;.00nan;0;0
2233;26967;63;0;0;0;0;.00nan;0;0
2233;31126;39;59;23;2;21;.913;3900000;0
2233;34814;63;100;38;2;36;.947;3900000;0
2234;751;64;0;0;0;0;.00nan;0;0
2234;2296;37;0;0;0;0;.00nan;0;0
2234;5146;64;47;36;5;31;.861;3600000;0
2234;5883;37;50;20;3;17;.850;3600000;0
2235;376;45;0;0;0;0;.00nan;0;0
2235;2198;45;66;38;4;34;.895;3600000;0
2235;4447;54;0;0;0;0;.00nan;0;0
2235;31643;54;87;31;2;29;.935;3600000;0
2236;3;50;0;0;0;0;.00nan;0;0
2236;5048;50;78;35;3;32;.914;3600000;0
2236;34788;42;0;0;0;0;.00nan;0;0
2236;37416;42;100;26;0;26;1.000;3600000;0
2237;37;46;63;26;2;24;.923;3600000;0
2237;2553;46;0;0;0;0;.00nan;0;0
2237;7049;47;0;0;0;0;.00nan;0;0
2237;33654;47;66;39;4;35;.897;3583000;0
2238;2016;61;0;0;0;0;.00nan;0;0
2238;14351;40;0;0;0;0;.00nan;0;0
2238;26840;40;97;43;3;40;.930;3600000;0
2238;30971;61;53;36;5;31;.861;3567000;0
2239;1051;44;51;18;2;16;.889;3900000;0
2239;3281;44;0;0;0;0;.00nan;0;0
2239;3626;48;0;0;0;0;.00nan;0;0
2239;38547;48;85;35;2;33;.943;3900000;0
2240;2796;59;0;0;0;0;.00nan;0;0
2240;23493;51;0;0;0;0;.00nan;0;0
2240;31035;51;55;25;3;22;.880;3555000;0
2240;34639;59;69;22;2;20;.909;3600000;0
2241;780;52;0;0;0;0;.00nan;0;0
2241;26967;63;87;33;2;31;.939;3600000;0
2241;32146;52;84;30;1;29;.967;3600000;0
2241;34814;63;0;0;0;0;.00nan;0;0
2242;4716;4619;0;0;0;0;.00nan;0;0
2242;17360;4619;100;40;1;39;.975;3600000;0
2242;20717;60;0;0;0;0;.00nan;0;0
2242;35536;60;55;34;5;29;.853;3600000;0
2243;1051;44;0;0;0;0;.00nan;0;0
2243;3281;44;47;22;4;18;.818;3600000;0
2243;3626;48;54;37;5;32;.865;3593000;0
2243;38547;48;0;0;0;0;.00nan;0;0
2244;351;65;0;0;0;0;.00nan;0;0
2244;2824;65;58;40;5;35;.875;3600000;0
2244;28772;53;0;0;0;0;.00nan;0;0
2244;31156;53;86;37;2;35;.946;3600000;0
2245;907;39;65;27;3;24;.889;3600000;0
2245;6062;36;0;0;0;0;.00nan;0;0
2245;14874;36;54;31;4;27;.871;3545000;0
2245;31126;39;0;0;0;0;.00nan;0;0
2246;3533;57;0;0;0;0;.00nan;0;0
2246;6081;56;69;23;1;22;.957;3600000;0
2246;14061;56;0;0;0;0;.00nan;0;0
2246;27474;57;91;35;2;33;.943;3545000;0
2247;2296;37;61;33;5;28;.848;3600000;0
2247;5883;37;0;0;0;0;.00nan;0;0
2247;34788;42;0;0;0;0;.00nan;0;0
2247;37416;42;99;31;1;30;.968;3600000;0
2248;3847;38;0;0;0;0;.00nan;0;0
2248;5137;58;0;0;0;0;.00nan;0;0
2248;14321;58;100;39;1;38;.974;3600000;0
2248;31021;38;67;25;2;23;.920;3550000;0
2249;376;45;0;0;0;0;.00nan;0;0
2249;2198;45;64;30;3;27;.900;3900000;0
2249;4447;54;0;0;0;0;.00nan;0;0
2249;31643;54;65;33;3;30;.909;3900000;0
2250;37;46;0;0;0;0;.00nan;0;0
2250;2553;46;69;24;2;22;.917;3900000;0
2250;7049;47;96;42;2;40;.952;3900000;0
2250;33654;47;0;0;0;0;.00nan;0;0
2251;2152;49;0;0;0;0;.00nan;0;0
2251;4435;49;99;31;1;30;.968;3600000;0
2251;6572;62;93;42;2;40;.952;3600000;0
2251;26919;62;0;0;0;0;.00nan;0;0
2252;1486;43;65;37;4;33;.892;3600000;0
2252;3625;43;0;0;0;0;.00nan;0;0
2252;19640;41;100;32;1;31;.969;3600000;0
2252;23075;41;0;0;0;0;.00nan;0;0
2253;3847;38;66;36;4;32;.889;3530000;0
2253;5298;55;0;0;0;0;.00nan;0;0
2253;31021;38;0;0;0;0;.00nan;0;0
2253;34770;55;68;27;2;25;.926;3600000;0
2254;780;52;80;29;1;28;.966;3600000;0
2254;907;39;0;0;0;0;.00nan;0;0
2254;31126;39;65;30;3;27;.900;3524000;0
2254;32146;52;0;0;0;0;.00nan;0;0
2255;3;50;0;0;0;0;.00nan;0;0
2255;751;64;0;0;0;0;.00nan;0;0
2255;5048;50;84;29;2;27;.931;3900000;0
2255;5146;64;87;40;2;38;.950;3900000;0
2256;37;46;100;39;0;39;1.000;3600000;0
2256;2152;49;39;24;4;20;.833;3600000;0
2256;2553;46;0;0;0;0;.00nan;0;0
2256;4435;49;0;0;0;0;.00nan;0;0
2257;4716;4619;0;0;0;0;.00nan;0;0
2257;17360;4619;46;23;5;18;.783;3600000;0
2257;20717;60;44;39;6;33;.846;3600000;0
2257;35536;60;0;0;0;0;.00nan;0;0
2258;6572;62;61;41;5;36;.878;3600000;0
2258;14351;40;0;0;0;0;.00nan;0;0
2258;26840;40;59;19;2;17;.895;3600000;0
2258;26919;62;0;0;0;0;.00nan;0;0
2259;2296;37;49;9;1;8;.889;1398000;0
2259;5883;37;34;16;4;12;.750;2202000;0
2259;23493;51;0;0;0;0;.00nan;0;0
2259;31035;51;66;27;2;25;.926;3600000;0
2260;4447;54;0;0;0;0;.00nan;0;0
2260;31643;54;41;29;5;24;.828;3539000;0
2260;34788;42;0;0;0;0;.00nan;0;0
2260;37416;42;90;48;3;45;.938;3600000;0
2261;2016;61;0;0;0;0;.00nan;0;0
2261;26967;63;38;10;3;7;.700;919000;0
2261;30971;61;61;20;2;18;.900;3600000;0
2261;34814;63;21;31;7;24;.774;2681000;0
2262;2152;49;36;24;5;19;.792;3600000;0
2262;4435;49;0;0;0;0;.00nan;0;0
2262;20717;60;99;42;2;40;.952;3600000;0
2262;35536;60;0;0;0;0;.00nan;0;0
2263;2796;59;0;0;0;0;.00nan;0;0
2263;28772;53;61;44;6;38;.864;3600000;0
2263;31156;53;0;0;0;0;.00nan;0;0
2263;34639;59;67;25;2;23;.920;3600000;0
2264;907;39;0;0;0;0;.00nan;0;0
2264;5298;55;74;21;1;20;.952;3600000;0
2264;31126;39;57;36;4;32;.889;3600000;0
2264;34770;55;0;0;0;0;.00nan;0;0
2265;2296;37;0;0;0;0;.00nan;0;0
2265;5883;37;76;30;2;28;.933;3600000;0
2265;23493;51;64;39;5;34;.872;3600000;0
2265;31035;51;0;0;0;0;.00nan;0;0
2266;4716;4619;0;0;0;0;.00nan;0;0
2266;14351;40;0;0;0;0;.00nan;0;0
2266;17360;4619;65;19;2;17;.895;3525000;0
2266;26840;40;100;34;0;34;1.000;3600000;0
2267;2016;61;51;21;3;18;.857;3587000;0
2267;26967;63;91;43;2;41;.953;3600000;0
2267;30971;61;0;0;0;0;.00nan;0;0
2267;34814;63;0;0;0;0;.00nan;0;0
2268;6081;56;63;29;3;26;.897;3600000;0
2268;14061;56;0;0;0;0;.00nan;0;0
2268;28772;53;76;30;2;28;.933;3600000;0
2268;31156;53;0;0;0;0;.00nan;0;0
2269;351;65;46;24;4;20;.833;3600000;0
2269;2824;65;0;0;0;0;.00nan;0;0
2269;19640;41;41;16;4;12;.750;1144000;0
2269;23075;41;62;15;1;14;.933;2419000;0
2270;907;39;0;0;0;0;.00nan;0;0
2270;1486;43;74;24;1;23;.958;3600000;0
2270;3625;43;0;0;0;0;.00nan;0;0
2270;31126;39;71;29;4;25;.862;3600000;0
2271;5298;55;78;33;3;30;.909;3569000;0
2271;6062;36;0;0;0;0;.00nan;0;0
2271;14874;36;88;27;1;26;.963;3600000;0
2271;34770;55;0;0;0;0;.00nan;0;0
2272;37;46;78;24;1;23;.958;3600000;0
2272;376;45;0;0;0;0;.00nan;0;0
2272;2198;45;66;40;4;36;.900;3600000;0
2272;2553;46;0;0;0;0;.00nan;0;0
2273;3847;38;0;0;0;0;.00nan;0;0
2273;5137;58;0;0;0;0;.00nan;0;0
2273;14321;58;85;40;3;37;.925;3600000;0
2273;31021;38;100;35;1;34;.971;3600000;0
2274;2796;59;0;0;0;0;.00nan;0;0
2274;3533;57;0;0;0;0;.00nan;0;0
2274;27474;57;81;30;2;28;.933;3600000;0
2274;34639;59;45;22;3;19;.864;3573000;0
2275;2296;37;0;0;0;0;.00nan;0;0
2275;5883;37;56;31;4;27;.871;3600000;0
2275;26967;63;0;0;0;0;.00nan;0;0
2275;34814;63;61;25;3;22;.880;3600000;0
2276;751;64;0;0;0;0;.00nan;0;0
2276;4447;54;0;0;0;0;.00nan;0;0
2276;5146;64;73;41;4;37;.902;3900000;0
2276;31643;54;78;36;4;32;.889;3900000;0
2277;3626;48;0;0;0;0;.00nan;0;0
2277;7049;47;0;0;0;0;.00nan;0;0
2277;33654;47;77;40;3;37;.925;3600000;0
2277;38547;48;60;39;5;34;.872;3561000;0
2278;2152;49;44;4;1;3;.750;1228000;0
2278;4435;49;28;24;6;18;.750;2372000;0
2278;4716;4619;0;0;0;0;.00nan;0;0
2278;17360;4619;56;27;4;23;.852;3600000;0
2279;3;50;0;0;0;0;.00nan;0;0
2279;5048;50;75;24;1;23;.958;3600000;0
2279;6572;62;74;42;4;38;.905;3600000;0
2279;26919;62;0;0;0;0;.00nan;0;0
2280;1051;44;100;32;0;32;1.000;3600000;0
2280;3281;44;0;0;0;0;.00nan;0;0
2280;34788;42;0;0;0;0;.00nan;0;0
2280;37416;42;63;17;1;16;.941;3568000;0
2281;351;65;31;24;5;19;.792;3569000;0
2281;2824;65;0;0;0;0;.00nan;0;0
2281;19640;41;0;0;0;0;.00nan;0;0
2281;23075;41;57;33;4;29;.879;3600000;0
2282;780;52;55;11;1;10;.909;3153000;0
2282;2796;59;86;29;1;28;.966;3600000;0
2282;32146;52;28;7;3;4;.571;447000;0
2282;34639;59;0;0;0;0;.00nan;0;0
2283;5137;58;0;0;0;0;.00nan;0;0
2283;6081;56;0;0;0;0;.00nan;0;0
2283;14061;56;56;31;5;26;.839;3550000;0
2283;14321;58;53;20;3;17;.850;3600000;0
2284;6062;36;65;31;3;28;.903;3600000;0
2284;14874;36;0;0;0;0;.00nan;0;0
2284;28772;53;0;0;0;0;.00nan;0;0
2284;31156;53;78;24;1;23;.958;3600000;0
2285;907;39;0;0;0;0;.00nan;0;0
2285;1486;43;0;0;0;0;.00nan;0;0
2285;3625;43;90;27;1;26;.963;3900000;0
2285;31126;39;84;27;1;26;.963;3900000;0
2286;37;46;0;0;0;0;.00nan;0;0
2286;376;45;57;23;3;20;.870;3544000;0
2286;2198;45;0;0;0;0;.00nan;0;0
2286;2553;46;84;29;2;27;.931;3600000;0
2287;3533;57;0;0;0;0;.00nan;0;0
2287;5298;55;0;0;0;0;.00nan;0;0
2287;27474;57;80;35;2;33;.943;3570000;0
2287;34770;55;84;24;1;23;.958;3600000;0
2288;751;64;69;45;5;40;.889;3564000;0
2288;4447;54;0;0;0;0;.00nan;0;0
2288;5146;64;0;0;0;0;.00nan;0;0
2288;31643;54;67;36;4;32;.889;3600000;0
2289;2152;49;57;13;1;12;.923;3600000;0
2289;4435;49;0;0;0;0;.00nan;0;0
2289;4716;4619;71;41;5;36;.878;3600000;0
2289;17360;4619;0;0;0;0;.00nan;0;0
2290;14351;40;0;0;0;0;.00nan;0;0
2290;20717;60;80;27;2;25;.926;3600000;0
2290;26840;40;96;50;4;46;.920;3600000;0
2290;35536;60;0;0;0;0;.00nan;0;0
2291;3;50;60;24;3;21;.875;3527000;0
2291;5048;50;0;0;0;0;.00nan;0;0
2291;6572;62;0;0;0;0;.00nan;0;0
2291;26919;62;75;25;1;24;.960;3600000;0
2292;1051;44;86;37;2;35;.946;3543000;0
2292;3281;44;0;0;0;0;.00nan;0;0
2292;34788;42;86;28;1;27;.964;3600000;0
2292;37416;42;0;0;0;0;.00nan;0;0
2293;3626;48;88;25;1;24;.960;3600000;0
2293;7049;47;67;34;3;31;.912;3586000;0
2293;33654;47;0;0;0;0;.00nan;0;0
2293;38547;48;0;0;0;0;.00nan;0;0
2294;2016;61;0;0;0;0;.00nan;0;0
2294;23493;51;0;0;0;0;.00nan;0;0
2294;30971;61;42;22;4;18;.818;3545000;0
2294;31035;51;84;32;2;30;.938;3600000;0
2295;5137;58;65;34;4;30;.882;3600000;0
2295;6081;56;87;30;1;29;.967;3600000;0
2295;14061;56;0;0;0;0;.00nan;0;0
2295;14321;58;0;0;0;0;.00nan;0;0
2296;780;52;0;0;0;0;.00nan;0;0
2296;3533;57;0;0;0;0;.00nan;0;0
2296;27474;57;65;33;3;30;.909;3600000;0
2296;32146;52;60;27;4;23;.852;3545000;0
2297;2296;37;0;0;0;0;.00nan;0;0
2297;5883;37;100;33;0;33;1.000;3600000;0
2297;26967;63;0;0;0;0;.00nan;0;0
2297;34814;63;78;48;4;44;.917;3600000;0
2298;376;45;0;0;0;0;.00nan;0;0
2298;751;64;82;19;0;19;1.000;1554000;0
2298;2198;45;42;31;5;26;.839;3600000;0
2298;5146;64;22;22;6;16;.727;2011000;0
2299;3847;38;0;0;0;0;.00nan;0;0
2299;6062;36;0;0;0;0;.00nan;0;0
2299;14874;36;76;35;3;32;.914;3900000;0
2299;31021;38;70;29;3;26;.897;3900000;0
2300;37;46;51;22;3;19;.864;3600000;0
2300;2553;46;0;0;0;0;.00nan;0;0
2300;4447;54;0;0;0;0;.00nan;0;0
2300;31643;54;45;28;5;23;.821;3542000;0
2301;14351;40;78;30;3;27;.900;3680000;0
2301;20717;60;85;30;2;28;.933;3680000;0
2301;26840;40;0;0;0;0;.00nan;0;0
2301;35536;60;0;0;0;0;.00nan;0;0
2302;2016;61;51;34;4;30;.882;3900000;0
2302;23493;51;55;33;4;29;.879;3900000;0
2302;30971;61;0;0;0;0;.00nan;0;0
2302;31035;51;0;0;0;0;.00nan;0;0
2303;3626;48;0;0;0;0;.00nan;0;0
2303;34788;42;0;0;0;0;.00nan;0;0
2303;37416;42;88;28;1;27;.964;3600000;0
2303;38547;48;74;40;4;36;.900;3600000;0
2304;351;65;36;20;4;16;.800;3600000;0
2304;780;52;0;0;0;0;.00nan;0;0
2304;2824;65;0;0;0;0;.00nan;0;0
2304;32146;52;42;32;6;26;.813;3582000;0
2305;3;50;0;0;0;0;.00nan;0;0
2305;1051;44;54;24;3;21;.875;3600000;0
2305;3281;44;0;0;0;0;.00nan;0;0
2305;5048;50;85;43;4;39;.907;3552000;0
2306;3626;48;68;22;2;20;.909;3900000;0
2306;34788;42;83;32;2;30;.938;3900000;0
2306;37416;42;0;0;0;0;.00nan;0;0
2306;38547;48;0;0;0;0;.00nan;0;0
2307;6062;36;79;27;1;26;.963;3600000;0
2307;14874;36;0;0;0;0;.00nan;0;0
2307;26967;63;0;0;0;0;.00nan;0;0
2307;34814;63;62;28;3;25;.893;3553000;0
2308;2296;37;0;0;0;0;.00nan;0;0
2308;4447;54;0;0;0;0;.00nan;0;0
2308;5883;37;83;29;1;28;.966;3600000;0
2308;31643;54;34;34;6;28;.824;3600000;0
2309;376;45;0;0;0;0;.00nan;0;0
2309;751;64;0;0;0;0;.00nan;0;0
2309;2198;45;53;33;5;28;.848;3600000;0
2309;5146;64;84;29;1;28;.966;3600000;0
2310;5298;55;92;19;0;19;1.000;3600000;0
2310;6081;56;72;34;3;31;.912;3600000;0
2310;14061;56;0;0;0;0;.00nan;0;0
2310;34770;55;0;0;0;0;.00nan;0;0
2311;37;46;61;22;3;19;.864;3600000;0
2311;1486;43;39;32;5;27;.844;3097000;0
2311;2553;46;0;0;0;0;.00nan;0;0
2311;3625;43;51;3;0;3;1.000;433000;0
2312;2796;59;0;0;0;0;.00nan;0;0
2312;3533;57;0;0;0;0;.00nan;0;0
2312;27474;57;58;35;5;30;.857;3900000;0
2312;34639;59;46;32;5;27;.844;3900000;0
2313;907;39;0;0;0;0;.00nan;0;0
2313;23493;51;100;37;1;36;.973;3600000;0
2313;31035;51;0;0;0;0;.00nan;0;0
2313;31126;39;74;25;2;23;.920;3554000;0
2314;7049;47;0;0;0;0;.00nan;0;0
2314;20717;60;61;17;2;15;.882;3600000;0
2314;33654;47;65;35;4;31;.886;3600000;0
2314;35536;60;0;0;0;0;.00nan;0;0
2315;3;50;0;0;0;0;.00nan;0;0
2315;1051;44;0;0;0;0;.00nan;0;0
2315;3281;44;80;34;2;32;.941;3600000;0
2315;5048;50;49;28;5;23;.821;3586000;0
2316;19640;41;79;30;2;28;.933;3600000;0
2316;23075;41;0;0;0;0;.00nan;0;0
2316;28772;53;58;33;4;29;.879;3574000;0
2316;31156;53;0;0;0;0;.00nan;0;0
2317;780;52;0;0;0;0;.00nan;0;0
2317;3847;38;0;0;0;0;.00nan;0;0
2317;31021;38;100;25;0;25;1.000;3600000;0
2317;32146;52;42;16;3;13;.813;3600000;0
2318;19640;41;0;0;0;0;.00nan;0;0
2318;23075;41;64;25;2;23;.920;3600000;0
2318;28772;53;63;8;0;8;1.000;606000;0
2318;31156;53;44;40;6;34;.850;2994000;0
2319;5137;58;0;0;0;0;.00nan;0;0
2319;6062;36;0;0;0;0;.00nan;0;0
2319;14874;36;56;29;4;25;.862;3900000;0
2319;15437;58;77;42;4;38;.905;3900000;0
2320;5298;55;49;15;2;13;.867;3554000;0
2320;6081;56;94;35;1;34;.971;3600000;0
2320;14061;56;0;0;0;0;.00nan;0;0
2320;34770;55;0;0;0;0;.00nan;0;0
2321;1953;39;0;0;0;0;.00nan;0;0
2321;23493;51;64;30;3;27;.900;3600000;0
2321;31035;51;0;0;0;0;.00nan;0;0
2321;31126;39;94;18;0;18;1.000;3600000;0
2322;351;65;79;25;1;24;.960;3600000;0
2322;2824;65;0;0;0;0;.00nan;0;0
2322;26865;57;57;27;3;24;.889;3525000;0
2322;27474;57;0;0;0;0;.00nan;0;0
2323;2296;37;0;0;0;0;.00nan;0;0
2323;4447;54;0;0;0;0;.00nan;0;0
2323;5883;37;66;21;2;19;.905;3544000;0
2323;31643;54;81;28;1;27;.964;3600000;0
2324;4716;4619;0;0;0;0;.00nan;0;0
2324;7049;47;0;0;0;0;.00nan;0;0
2324;17360;4619;60;22;2;20;.909;3600000;0
2324;33654;47;61;48;6;42;.875;3600000;0
2325;2152;49;0;0;0;0;.00nan;0;0
2325;4435;49;93;32;1;31;.969;3900000;0
2325;14351;40;0;0;0;0;.00nan;0;0
2325;26840;40;89;32;1;31;.969;3900000;0
2326;2016;61;0;0;0;0;.00nan;0;0
2326;6572;62;50;37;6;31;.838;3600000;0
2326;26919;62;0;0;0;0;.00nan;0;0
2326;30971;61;50;19;3;16;.842;3600000;0
2327;37;46;26;21;6;15;.714;2037000;0
2327;2553;46;59;13;1;12;.923;1474000;0
2327;26967;63;0;0;0;0;.00nan;0;0
2327;34814;63;49;31;5;26;.839;3600000;0
2328;5298;55;56;5;0;5;1.000;422000;0
2328;23493;51;0;0;0;0;.00nan;0;0
2328;31035;51;38;31;5;26;.839;3600000;0
2328;34770;55;32;34;6;28;.824;3146000;0
2329;351;65;45;26;5;21;.808;3600000;0
2329;2824;65;0;0;0;0;.00nan;0;0
2329;5137;58;74;32;3;29;.906;3209000;0
2329;15437;58;23;4;3;1;.250;391000;0
2330;2796;59;0;0;0;0;.00nan;0;0
2330;6062;36;71;23;2;21;.913;3575000;0
2330;14874;36;0;0;0;0;.00nan;0;0
2330;34639;59;90;31;1;30;.968;3600000;0
2331;1953;39;0;0;0;0;.00nan;0;0
2331;6081;56;0;0;0;0;.00nan;0;0
2331;14061;56;60;39;5;34;.872;3566000;0
2331;31126;39;71;30;3;27;.900;3600000;0
2332;1486;43;41;23;4;19;.826;3600000;0
2332;3625;43;0;0;0;0;.00nan;0;0
2332;4447;54;100;28;0;28;1.000;3600000;0
2332;31643;54;0;0;0;0;.00nan;0;0
2333;1051;44;64;17;1;16;.941;3600000;0
2333;3281;44;0;0;0;0;.00nan;0;0
2333;34788;42;0;0;0;0;.00nan;0;0
2333;37416;42;82;34;2;32;.941;3573000;0
2334;780;52;89;47;3;44;.936;3519000;0
2334;3847;38;0;0;0;0;.00nan;0;0
2334;31021;38;90;34;1;33;.971;3600000;0
2334;32146;52;0;0;0;0;.00nan;0;0
2335;751;64;0;0;0;0;.00nan;0;0
2335;2296;37;0;0;0;0;.00nan;0;0
2335;5146;64;87;30;1;29;.967;3600000;0
2335;5883;37;46;21;3;18;.857;3582000;0
2336;3;50;0;0;0;0;.00nan;0;0
2336;376;45;58;15;1;14;.933;3600000;0
2336;2198;45;0;0;0;0;.00nan;0;0
2336;5048;50;56;36;4;32;.889;3600000;0
2337;4716;4619;58;23;3;20;.870;3600000;0
2337;7049;47;100;42;2;40;.952;3600000;0
2337;17360;4619;0;0;0;0;.00nan;0;0
2337;33654;47;0;0;0;0;.00nan;0;0
2338;3626;48;29;29;5;24;.828;3600000;0
2338;20717;60;68;21;2;19;.905;3600000;0
2338;35536;60;0;0;0;0;.00nan;0;0
2338;38547;48;0;0;0;0;.00nan;0;0
2339;2016;61;90;30;1;29;.967;3600000;0
2339;6572;62;0;0;0;0;.00nan;0;0
2339;26919;62;71;33;3;30;.909;3511000;0
2339;30971;61;0;0;0;0;.00nan;0;0
2340;19640;41;0;0;0;0;.00nan;0;0
2340;23075;41;67;27;3;24;.889;3900000;0
2340;28772;53;74;34;3;31;.912;3900000;0
2340;31156;53;0;0;0;0;.00nan;0;0
2341;780;52;0;0;0;0;.00nan;0;0
2341;26865;57;100;25;0;25;1.000;3600000;0
2341;27474;57;0;0;0;0;.00nan;0;0
2341;32146;52;73;29;3;26;.897;3600000;0
2342;37;46;0;0;0;0;.00nan;0;0
2342;2553;46;62;29;3;26;.897;3900000;0
2342;26967;63;76;32;3;29;.906;3900000;0
2342;34814;63;0;0;0;0;.00nan;0;0
2343;751;64;95;34;1;33;.971;3600000;0
2343;1486;43;55;22;2;20;.909;3591000;0
2343;3625;43;0;0;0;0;.00nan;0;0
2343;5146;64;0;0;0;0;.00nan;0;0
2344;351;65;0;0;0;0;.00nan;0;0
2344;2824;65;60;26;3;23;.885;3600000;0
2344;5137;58;0;0;0;0;.00nan;0;0
2344;15437;58;38;19;4;15;.789;3571000;0
2345;1051;44;0;0;0;0;.00nan;0;0
2345;3281;44;83;23;1;22;.957;3600000;0
2345;34788;42;73;28;2;26;.929;3562000;0
2345;37416;42;0;0;0;0;.00nan;0;0
2346;3;50;59;37;4;33;.892;3600000;0
2346;376;45;0;0;0;0;.00nan;0;0
2346;2198;45;88;31;1;30;.968;3600000;0
2346;5048;50;0;0;0;0;.00nan;0;0
2347;2152;49;0;0;0;0;.00nan;0;0
2347;4435;49;72;20;1;19;.950;3600000;0
2347;14351;40;0;0;0;0;.00nan;0;0
2347;26840;40;73;49;4;45;.918;3600000;0
2348;3626;48;0;0;0;0;.00nan;0;0
2348;20717;60;49;28;4;24;.857;3600000;0
2348;35536;60;0;0;0;0;.00nan;0;0
2348;38547;48;100;35;0;35;1.000;3600000;0
2349;6081;56;74;24;3;21;.875;3900000;0
2349;14061;56;0;0;0;0;.00nan;0;0
2349;28772;53;0;0;0;0;.00nan;0;0
2349;31156;53;77;36;3;33;.917;3900000;0
2350;37;46;66;15;1;14;.933;3600000;0
2350;1486;43;81;35;2;33;.943;3562000;0
2350;2553;46;0;0;0;0;.00nan;0;0
2350;3625;43;0;0;0;0;.00nan;0;0
2351;351;65;41;22;4;18;.818;3720000;0
2351;2824;65;0;0;0;0;.00nan;0;0
2351;26865;57;78;37;3;34;.919;3720000;0
2351;27474;57;0;0;0;0;.00nan;0;0
2352;5137;58;0;0;0;0;.00nan;0;0
2352;6062;36;0;0;0;0;.00nan;0;0
2352;14874;36;91;32;1;31;.969;3600000;0
2352;15437;58;48;27;4;23;.852;3600000;0
2353;1953;39;0;0;0;0;.00nan;0;0
2353;23493;51;54;33;5;28;.848;3600000;0
2353;31035;51;0;0;0;0;.00nan;0;0
2353;31126;39;95;35;1;34;.971;3600000;0
2354;376;45;61;29;3;26;.897;3783000;0
2354;751;64;0;0;0;0;.00nan;0;0
2354;2198;45;0;0;0;0;.00nan;0;0
2354;5146;64;67;26;2;24;.923;3783000;0
2355;3;50;0;0;0;0;.00nan;0;0
2355;4447;54;72;21;1;20;.952;3600000;0
2355;5048;50;71;48;5;43;.896;3600000;0
2355;31643;54;0;0;0;0;.00nan;0;0
2356;7049;47;74;33;3;30;.909;3717000;0
2356;20717;60;62;30;4;26;.867;3717000;0
2356;33654;47;0;0;0;0;.00nan;0;0
2356;35536;60;0;0;0;0;.00nan;0;0
2357;3626;48;0;0;0;0;.00nan;0;0
2357;14351;40;0;0;0;0;.00nan;0;0
2357;26840;40;88;42;1;41;.976;3559000;0
2357;38547;48;79;14;0;14;1.000;3600000;0
2358;2296;37;0;0;0;0;.00nan;0;0
2358;5883;37;57;34;5;29;.853;3600000;0
2358;34788;42;0;0;0;0;.00nan;0;0
2358;37416;42;78;31;3;28;.903;3600000;0
2359;26967;63;0;0;0;0;.00nan;0;0
2359;28772;53;32;24;5;19;.792;2393000;0
2359;31156;53;55;13;1;12;.923;1183000;0
2359;34814;63;42;28;5;23;.821;3600000;0
2360;159;43;0;0;0;0;.00nan;0;0
2360;1486;43;55;19;2;17;.895;3600000;0
2360;23493;51;0;0;0;0;.00nan;0;0
2360;31035;51;47;29;4;25;.862;3555000;0
2361;5298;55;22;5;3;2;.400;431000;0
2361;6062;36;0;0;0;0;.00nan;0;0
2361;14874;36;62;31;4;27;.871;3600000;0
2361;34770;55;29;19;5;14;.737;3169000;0
2362;3;50;0;0;0;0;.00nan;0;0
2362;37;46;0;0;0;0;.00nan;0;0
2362;2553;46;85;24;1;23;.958;3900000;0
2362;5048;50;92;30;1;29;.967;3900000;0
2363;6847;52;52;3;0;3;1.000;264000;0
2363;26865;57;53;24;3;21;.875;3600000;0
2363;27474;57;0;0;0;0;.00nan;0;0
2363;32146;52;49;37;6;31;.838;3336000;0
2364;351;65;91;31;1;30;.968;3900000;0
2364;2796;59;0;0;0;0;.00nan;0;0
2364;2824;65;0;0;0;0;.00nan;0;0
2364;34639;59;87;23;1;22;.957;3900000;0
2365;5137;58;0;0;0;0;.00nan;0;0
2365;15437;58;69;34;3;31;.912;3576000;0
2365;19640;41;85;26;1;25;.962;3600000;0
2365;23075;41;0;0;0;0;.00nan;0;0
2366;376;45;100;24;0;24;1.000;3600000;0
2366;751;64;0;0;0;0;.00nan;0;0
2366;2198;45;0;0;0;0;.00nan;0;0
2366;5146;64;84;31;2;29;.935;3538000;0
2367;2152;49;44;30;5;25;.833;3900000;0
2367;4435;49;0;0;0;0;.00nan;0;0
2367;6572;62;78;48;5;43;.896;3900000;0
2367;26919;62;0;0;0;0;.00nan;0;0
2368;2016;61;0;0;0;0;.00nan;0;0
2368;20717;60;92;31;1;30;.968;3547000;0
2368;30971;61;100;21;0;21;1.000;3600000;0
2368;35536;60;0;0;0;0;.00nan;0;0
2369;1051;44;72;41;3;38;.927;3600000;0
2369;3281;44;0;0;0;0;.00nan;0;0
2369;4716;4619;0;0;0;0;.00nan;0;0
2369;17360;4619;86;22;0;22;1.000;3600000;0
2370;3626;48;0;0;0;0;.00nan;0;0
2370;14351;40;0;0;0;0;.00nan;0;0
2370;26840;40;91;37;2;35;.946;3600000;0
2370;38547;48;61;33;4;29;.879;3579000;0
2371;2296;37;56;25;4;21;.840;3578000;0
2371;5883;37;0;0;0;0;.00nan;0;0
2371;34788;42;79;29;2;27;.931;3600000;0
2371;37416;42;0;0;0;0;.00nan;0;0
2372;2796;59;50;31;4;27;.871;3573000;0
2372;6847;52;86;42;3;39;.929;3600000;0
2372;32146;52;0;0;0;0;.00nan;0;0
2372;34639;59;0;0;0;0;.00nan;0;0
2373;5137;58;85;28;1;27;.964;3600000;0
2373;15437;58;0;0;0;0;.00nan;0;0
2373;19640;41;75;32;3;29;.906;3512000;0
2373;23075;41;0;0;0;0;.00nan;0;0
2374;6062;36;79;31;2;29;.935;3600000;0
2374;14874;36;0;0;0;0;.00nan;0;0
2374;26967;63;65;30;3;27;.900;3549000;0
2374;34814;63;0;0;0;0;.00nan;0;0
2375;159;43;0;0;0;0;.00nan;0;0
2375;1486;43;70;39;4;35;.897;3600000;0
2375;23493;51;68;30;3;27;.900;3600000;0
2375;31035;51;0;0;0;0;.00nan;0;0
2376;5298;55;43;31;5;26;.839;3561000;0
2376;6081;56;0;0;0;0;.00nan;0;0
2376;14061;56;58;31;4;27;.871;3600000;0
2376;34770;55;0;0;0;0;.00nan;0;0
2377;3;50;82;45;3;42;.933;3600000;0
2377;4447;54;0;0;0;0;.00nan;0;0
2377;5048;50;0;0;0;0;.00nan;0;0
2377;31643;54;96;18;0;18;1.000;3600000;0
2378;3847;38;0;0;0;0;.00nan;0;0
2378;26865;57;61;32;4;28;.875;3515000;0
2378;27474;57;0;0;0;0;.00nan;0;0
2378;31021;38;66;26;2;24;.923;3600000;0
2379;1953;39;0;0;0;0;.00nan;0;0
2379;28772;53;0;0;0;0;.00nan;0;0
2379;31126;39;79;21;1;20;.952;3600000;0
2379;31156;53;67;27;2;25;.926;3580000;0
2380;376;45;56;23;3;20;.870;3568000;0
2380;751;64;0;0;0;0;.00nan;0;0
2380;2198;45;0;0;0;0;.00nan;0;0
2380;5146;64;95;36;2;34;.944;3600000;0
2381;2016;61;53;3;0;3;1.000;251000;0
2381;7049;47;0;0;0;0;.00nan;0;0
2381;30971;61;35;29;6;23;.793;3349000;0
2381;33654;47;39;22;5;17;.773;3600000;0
2382;2152;49;0;0;0;0;.00nan;0;0
2382;4435;49;74;11;0;11;1.000;3600000;0
2382;6572;62;0;0;0;0;.00nan;0;0
2382;26919;62;84;58;5;53;.914;3600000;0
2383;1051;44;0;0;0;0;.00nan;0;0
2383;3281;44;40;21;4;17;.810;3551000;0
2383;4716;4619;0;0;0;0;.00nan;0;0
2383;17360;4619;48;19;3;16;.842;3600000;0
2384;3626;48;92;27;1;26;.963;3600000;0
2384;14351;40;54;45;6;39;.867;3600000;0
2384;26840;40;0;0;0;0;.00nan;0;0
2384;38547;48;0;0;0;0;.00nan;0;0
2385;351;65;51;30;5;25;.833;3592000;0
2385;2824;65;0;0;0;0;.00nan;0;0
2385;3847;38;58;34;4;30;.882;3600000;0
2385;31021;38;0;0;0;0;.00nan;0;0
2386;159;43;0;0;0;0;.00nan;0;0
2386;1486;43;100;27;0;27;1.000;3600000;0
2386;5298;55;61;27;3;24;.889;3600000;0
2386;34770;55;0;0;0;0;.00nan;0;0
2387;3;50;0;0;0;0;.00nan;0;0
2387;37;46;41;22;4;18;.818;2482000;0
2387;2553;46;27;12;4;8;.667;1118000;0
2387;5048;50;71;24;1;23;.958;3600000;0
2388;159;43;0;0;0;0;.00nan;0;0
2388;1486;43;70;31;3;28;.903;3521000;0
2388;5298;55;0;0;0;0;.00nan;0;0
2388;34770;55;73;23;1;22;.957;3600000;0
2389;6081;56;64;28;3;25;.893;3556000;0
2389;14061;56;0;0;0;0;.00nan;0;0
2389;26967;63;0;0;0;0;.00nan;0;0
2389;34814;63;86;27;1;26;.963;3600000;0
2390;376;45;98;51;3;48;.941;3583000;0
2390;2198;45;0;0;0;0;.00nan;0;0
2390;4447;54;0;0;0;0;.00nan;0;0
2390;31643;54;88;23;1;22;.957;3600000;0
2391;37;46;0;0;0;0;.00nan;0;0
2391;2553;46;47;37;5;32;.865;3600000;0
2391;34788;42;50;1;0;1;1.000;199000;0
2391;37416;42;25;26;7;19;.731;3332000;0
2392;2152;49;0;0;0;0;.00nan;0;0
2392;4435;49;70;33;3;30;.909;3600000;0
2392;4716;4619;0;0;0;0;.00nan;0;0
2392;17360;4619;69;36;4;32;.889;3542000;0
2393;7049;47;61;22;2;20;.909;3600000;0
2393;20717;60;79;35;3;32;.914;3567000;0
2393;33654;47;0;0;0;0;.00nan;0;0
2393;35536;60;0;0;0;0;.00nan;0;0
2394;1051;44;96;37;1;36;.973;3900000;0
2394;3281;44;0;0;0;0;.00nan;0;0
2394;14351;40;0;0;0;0;.00nan;0;0
2394;26840;40;82;24;1;23;.958;3900000;0
2395;2016;61;0;0;0;0;.00nan;0;0
2395;6572;62;68;26;2;24;.923;3600000;0
2395;26919;62;0;0;0;0;.00nan;0;0
2395;30971;61;39;24;4;20;.833;3589000;0
2396;19640;41;53;22;3;19;.864;2772000;0
2396;23075;41;22;9;4;5;.556;828000;0
2396;28772;53;0;0;0;0;.00nan;0;0
2396;31156;53;85;41;3;38;.927;3600000;0
2397;5137;58;0;0;0;0;.00nan;0;0
2397;6847;52;92;33;2;31;.939;3600000;0
2397;15437;58;39;28;5;23;.821;3600000;0
2397;32146;52;0;0;0;0;.00nan;0;0
2398;6062;36;0;0;0;0;.00nan;0;0
2398;6081;56;55;36;4;32;.889;3600000;0
2398;14061;56;0;0;0;0;.00nan;0;0
2398;14874;36;92;33;1;32;.970;3600000;0
2399;1953;39;0;0;0;0;.00nan;0;0
2399;5298;55;87;35;2;33;.943;3580000;0
2399;31126;39;75;18;1;17;.944;3600000;0
2399;34770;55;0;0;0;0;.00nan;0;0
2400;23493;51;70;21;2;19;.905;3600000;0
2400;26967;63;0;0;0;0;.00nan;0;0
2400;31035;51;0;0;0;0;.00nan;0;0
2400;34814;63;55;42;5;37;.881;3600000;0
2401;37;46;53;39;5;34;.872;3552000;0
2401;751;64;0;0;0;0;.00nan;0;0
2401;2553;46;0;0;0;0;.00nan;0;0
2401;5146;64;69;33;4;29;.879;3600000;0
2402;2796;59;0;0;0;0;.00nan;0;0
2402;3847;38;0;0;0;0;.00nan;0;0
2402;31021;38;59;41;5;36;.878;3771000;0
2402;34639;59;39;32;6;26;.813;3771000;0
2403;351;65;73;22;1;21;.955;3600000;0
2403;2824;65;0;0;0;0;.00nan;0;0
2403;26865;57;98;53;2;51;.962;3600000;0
2403;27474;57;0;0;0;0;.00nan;0;0
2404;3;50;0;0;0;0;.00nan;0;0
2404;376;45;49;34;5;29;.853;3600000;0
2404;2198;45;0;0;0;0;.00nan;0;0
2404;5048;50;68;26;2;24;.923;3600000;0
2405;2152;49;0;0;0;0;.00nan;0;0
2405;4435;49;31;15;4;11;.733;3600000;0
2405;4716;4619;67;10;0;10;1.000;1039000;0
2405;17360;4619;51;44;6;38;.864;2530000;0
2406;1051;44;81;33;2;31;.939;3600000;0
2406;3281;44;0;0;0;0;.00nan;0;0
2406;7049;47;0;0;0;0;.00nan;0;0
2406;33654;47;44;19;3;16;.842;3553000;0
2407;2016;61;0;0;0;0;.00nan;0;0
2407;14351;40;0;0;0;0;.00nan;0;0
2407;26840;40;66;40;4;36;.900;3697000;0
2407;30971;61;47;30;5;25;.833;3697000;0
2408;2796;59;54;23;3;20;.870;3900000;0
2408;5137;58;0;0;0;0;.00nan;0;0
2408;15437;58;72;36;3;33;.917;3900000;0
2408;34639;59;0;0;0;0;.00nan;0;0
2409;6847;52;50;1;0;1;1.000;266000;0
2409;28772;53;94;37;2;35;.946;3600000;0
2409;31156;53;0;0;0;0;.00nan;0;0
2409;32146;52;40;35;6;29;.829;3334000;0
2410;351;65;87;28;1;27;.964;3600000;0
2410;2824;65;0;0;0;0;.00nan;0;0
2410;26865;57;0;0;0;0;.00nan;0;0
2410;27474;57;67;32;3;29;.906;3560000;0
2411;6062;36;71;26;2;24;.923;3900000;0
2411;14874;36;0;0;0;0;.00nan;0;0
2411;23493;51;0;0;0;0;.00nan;0;0
2411;31035;51;86;37;2;35;.946;3900000;0
2412;2296;37;0;0;0;0;.00nan;0;0
2412;5883;37;69;23;2;21;.913;3600000;0
2412;34788;42;0;0;0;0;.00nan;0;0
2412;37416;42;65;31;3;28;.903;3547000;0
2413;3;50;53;28;3;25;.893;3574000;0
2413;376;45;0;0;0;0;.00nan;0;0
2413;2198;45;74;21;2;19;.905;3600000;0
2413;5048;50;0;0;0;0;.00nan;0;0
2414;3847;38;58;28;3;25;.893;3600000;0
2414;19640;41;0;0;0;0;.00nan;0;0
2414;23075;41;74;26;2;24;.923;3600000;0
2414;31021;38;0;0;0;0;.00nan;0;0
2415;159;43;0;0;0;0;.00nan;0;0
2415;1486;43;100;42;2;40;.952;3900000;0
2415;1953;39;64;27;2;25;.926;3900000;0
2415;31126;39;0;0;0;0;.00nan;0;0
2416;751;64;100;28;0;28;1.000;3600000;0
2416;4447;54;0;0;0;0;.00nan;0;0
2416;5146;64;0;0;0;0;.00nan;0;0
2416;31643;54;56;23;3;20;.870;3600000;0
2417;2152;49;54;23;3;20;.870;3870000;0
2417;4435;49;0;0;0;0;.00nan;0;0
2417;4716;4619;0;0;0;0;.00nan;0;0
2417;17360;4619;92;55;4;51;.927;3870000;0
2418;7049;47;52;25;3;22;.880;3600000;0
2418;14351;40;69;39;5;34;.872;3514000;0
2418;26840;40;0;0;0;0;.00nan;0;0
2418;33654;47;0;0;0;0;.00nan;0;0
2419;1051;44;0;0;0;0;.00nan;0;0
2419;3281;44;92;30;1;29;.967;3572000;0
2419;6572;62;100;24;0;24;1.000;3600000;0
2419;26919;62;0;0;0;0;.00nan;0;0
2420;3626;48;0;0;0;0;.00nan;0;0
2420;20717;60;56;39;5;34;.872;3552000;0
2420;35536;60;0;0;0;0;.00nan;0;0
2420;38547;48;66;27;3;24;.889;3600000;0
2421;3847;38;0;0;0;0;.00nan;0;0
2421;5137;58;48;27;4;23;.852;3600000;0
2421;15437;58;0;0;0;0;.00nan;0;0
2421;31021;38;78;24;1;23;.958;3600000;0
2422;2796;59;0;0;0;0;.00nan;0;0
2422;28772;53;55;4;0;4;1.000;241000;0
2422;31156;53;60;38;6;32;.842;3359000;0
2422;34639;59;72;27;2;25;.926;3600000;0
2423;1486;43;0;0;0;0;.00nan;0;0
2423;1953;39;0;0;0;0;.00nan;0;0
2423;3625;43;92;39;2;37;.949;3548000;0
2423;31126;39;80;27;1;26;.963;3600000;0
2424;6081;56;100;33;0;33;1.000;3600000;0
2424;14061;56;0;0;0;0;.00nan;0;0
2424;26967;63;0;0;0;0;.00nan;0;0
2424;34814;63;80;44;4;40;.909;3600000;0
2425;2296;37;0;0;0;0;.00nan;0;0
2425;4447;54;0;0;0;0;.00nan;0;0
2425;5883;37;73;24;1;23;.958;3600000;0
2425;31643;54;62;30;3;27;.900;3555000;0
2426;37;46;63;39;5;34;.872;3600000;0
2426;751;64;28;14;4;10;.714;2044000;0
2426;2553;46;0;0;0;0;.00nan;0;0
2426;5146;64;63;8;0;8;1.000;1556000;0
2427;351;65;0;0;0;0;.00nan;0;0
2427;2824;65;40;28;5;23;.821;3543000;0
2427;6062;36;0;0;0;0;.00nan;0;0
2427;14874;36;70;39;4;35;.897;3600000;0
2428;3;50;0;0;0;0;.00nan;0;0
2428;5048;50;100;43;2;41;.953;3900000;0
2428;34788;42;70;23;2;21;.913;3900000;0
2428;37416;42;0;0;0;0;.00nan;0;0
2429;3626;48;81;37;4;33;.892;3600000;0
2429;20717;60;56;12;1;11;.917;1556000;0
2429;35536;60;25;13;4;9;.692;2043000;0
2429;38547;48;0;0;0;0;.00nan;0;0
2925;3;50;100;31;0;31;1.000;3600000;0
2925;5048;50;0;0;0;0;.00nan;0;0
2925;5137;58;0;0;0;0;.00nan;0;0
2925;14321;58;63;32;3;29;.906;3600000;0
2927;1486;43;0;0;0;0;.00nan;0;0
2927;3625;43;78;24;1;23;.958;3600000;0
2927;7049;47;0;0;0;0;.00nan;0;0
2927;33654;47;70;29;2;27;.931;3600000;0
2929;2016;61;0;0;0;0;.00nan;0;0
2929;2296;37;48;0;0;0;.00nan;254000;0
2929;5883;37;32;30;6;24;.800;3276000;0
2929;30971;61;49;33;4;29;.879;3600000;0
2931;5298;55;0;0;0;0;.00nan;0;0
2931;6081;56;89;39;2;37;.949;3600000;0
2931;26824;56;0;0;0;0;.00nan;0;0
2931;34770;55;65;32;3;29;.906;3550000;0
2933;2900;36;0;0;0;0;.00nan;0;0
2933;14874;36;88;42;3;39;.929;3600000;0
2933;20717;60;0;0;0;0;.00nan;0;0
2933;35536;60;43;24;4;20;.833;3569000;0
2935;780;52;0;0;0;0;.00nan;0;0
2935;3847;38;0;0;0;0;.00nan;0;0
2935;23255;52;69;23;2;21;.913;3538000;0
2935;31021;38;100;37;0;37;1.000;3600000;0
2937;37;46;83;27;1;26;.963;3560000;0
2937;2553;46;0;0;0;0;.00nan;0;0
2937;2824;65;0;0;0;0;.00nan;0;0
2937;4987;65;100;32;0;32;1.000;3600000;0
2939;28772;53;71;25;2;23;.920;3600000;0
2939;31156;53;0;0;0;0;.00nan;0;0
2939;34788;42;0;0;0;0;.00nan;0;0
2939;37416;42;55;29;4;25;.862;3559000;0
2941;5146;64;79;33;3;30;.909;3900000;0
2941;19640;41;73;31;3;28;.903;3900000;0
2941;23075;41;0;0;0;0;.00nan;0;0
2941;28845;64;0;0;0;0;.00nan;0;0
2943;376;45;84;24;1;23;.958;3600000;0
2943;1051;44;62;43;4;39;.907;3600000;0
2943;2198;45;0;0;0;0;.00nan;0;0
2943;3281;44;0;0;0;0;.00nan;0;0
2945;907;39;0;0;0;0;.00nan;0;0
2945;1592;63;56;31;5;26;.839;3535000;0
2945;2163;39;62;28;3;25;.893;3600000;0
2945;26967;63;0;0;0;0;.00nan;0;0
2947;2152;49;0;0;0;0;.00nan;0;0
2947;4435;49;92;36;2;34;.944;3779000;0
2947;4447;54;78;28;1;27;.964;3779000;0
2947;31643;54;0;0;0;0;.00nan;0;0
2949;6572;62;0;0;0;0;.00nan;0;0
2949;8046;57;0;0;0;0;.00nan;0;0
2949;26919;62;73;28;2;26;.929;3600000;0
2949;27474;57;68;28;3;25;.893;3593000;0
2951;3626;48;0;0;0;0;.00nan;0;0
2951;14351;40;0;0;0;0;.00nan;0;0
2951;26840;40;81;32;2;30;.938;3600000;0
2951;38547;48;76;34;3;31;.912;3544000;0
2953;2796;59;0;0;0;0;.00nan;0;0
2953;23493;51;97;40;2;38;.950;3600000;0
2953;31822;51;0;0;0;0;.00nan;0;0
2953;31858;59;55;24;3;21;.875;3576000;0
2955;907;39;0;0;0;0;.00nan;0;0
2955;2163;39;65;25;2;23;.920;3719000;0
2955;5146;64;0;0;0;0;.00nan;0;0
2955;28845;64;83;40;3;37;.925;3767000;0
2957;2152;49;0;0;0;0;.00nan;0;0
2957;4435;49;78;34;2;32;.941;3600000;0
2957;6572;62;54;22;3;19;.864;3600000;0
2957;26919;62;0;0;0;0;.00nan;0;0
2959;3626;48;29;16;4;12;.750;3587000;0
2959;34788;42;0;0;0;0;.00nan;0;0
2959;37416;42;70;34;3;31;.912;3600000;0
2959;38547;48;0;0;0;0;.00nan;0;0
2961;4447;54;78;27;2;25;.926;3600000;0
2961;28772;53;64;25;3;22;.880;3582000;0
2961;31156;53;0;0;0;0;.00nan;0;0
2961;31643;54;0;0;0;0;.00nan;0;0
2963;37;46;0;0;0;0;.00nan;0;0
2963;2553;46;51;22;3;19;.864;3600000;0
2963;5137;58;0;0;0;0;.00nan;0;0
2963;14321;58;58;32;4;28;.875;3542000;0
2965;8046;57;0;0;0;0;.00nan;0;0
2965;20717;60;0;0;0;0;.00nan;0;0
2965;27474;57;35;25;5;20;.800;3890000;0
2965;35536;60;63;29;4;25;.862;3890000;0
2967;3;50;70;31;3;28;.903;3900000;0
2967;5048;50;0;0;0;0;.00nan;0;0
2967;23493;51;89;46;3;43;.935;3900000;0
2967;31822;51;0;0;0;0;.00nan;0;0
2969;1592;63;83;37;2;35;.946;3900000;0
2969;14351;40;90;40;2;38;.950;3900000;0
2969;26840;40;0;0;0;0;.00nan;0;0
2969;26967;63;0;0;0;0;.00nan;0;0
2971;376;45;51;27;4;23;.852;3585000;0
2971;2198;45;0;0;0;0;.00nan;0;0
2971;7049;47;69;33;3;30;.909;3600000;0
2971;33654;47;0;0;0;0;.00nan;0;0
2973;780;52;0;0;0;0;.00nan;0;0
2973;6081;56;59;33;4;29;.879;3600000;0
2973;23255;52;42;36;6;30;.833;3534000;0
2973;26824;56;0;0;0;0;.00nan;0;0
2975;2296;37;0;0;0;0;.00nan;0;0
2975;5298;55;82;28;2;26;.929;3900000;0
2975;5883;37;86;32;2;30;.938;3900000;0
2975;34770;55;0;0;0;0;.00nan;0;0
2977;1486;43;95;31;1;30;.968;3600000;0
2977;3625;43;0;0;0;0;.00nan;0;0
2977;4716;4619;63;20;2;18;.900;3600000;0
2977;35210;4619;0;0;0;0;.00nan;0;0
2979;3847;38;0;0;0;0;.00nan;0;0
2979;19640;41;70;43;5;38;.884;3600000;0
2979;23075;41;0;0;0;0;.00nan;0;0
2979;31021;38;100;24;0;24;1.000;3600000;0
2981;1051;44;0;0;0;0;.00nan;0;0
2981;2824;65;0;0;0;0;.00nan;0;0
2981;3281;44;63;23;2;21;.913;3600000;0
2981;4987;65;68;31;4;27;.871;3529000;0
2983;2016;61;0;0;0;0;.00nan;0;0
2983;2900;36;25;25;6;19;.760;2977000;0
2983;14874;36;54;4;0;4;1.000;623000;0
2983;30971;61;100;34;1;33;.971;3600000;0
2985;376;45;0;0;0;0;.00nan;0;0
2985;2198;45;53;24;3;21;.875;3600000;0
2985;2796;59;0;0;0;0;.00nan;0;0
2985;31858;59;42;27;5;22;.815;3568000;0
2987;1486;43;0;0;0;0;.00nan;0;0
2987;3625;43;100;33;1;32;.970;3600000;0
2987;34788;42;69;31;2;29;.935;3545000;0
2987;37416;42;0;0;0;0;.00nan;0;0
2989;3847;38;0;0;0;0;.00nan;0;0
2989;6081;56;0;0;0;0;.00nan;0;0
2989;26824;56;60;19;3;16;.842;3791000;0
2989;31021;38;92;41;2;39;.951;3791000;0
2991;780;52;98;24;0;24;1.000;3600000;0
2991;20717;60;50;31;4;27;.871;3600000;0
2991;23255;52;0;0;0;0;.00nan;0;0
2991;35536;60;0;0;0;0;.00nan;0;0
2993;3;50;0;0;0;0;.00nan;0;0
2993;1051;44;78;32;2;30;.938;3600000;0
2993;3281;44;0;0;0;0;.00nan;0;0
2993;5048;50;53;28;4;24;.857;3553000;0
2995;907;39;53;41;5;36;.878;3572000;0
2995;2163;39;0;0;0;0;.00nan;0;0
2995;4447;54;0;0;0;0;.00nan;0;0
2995;31643;54;77;34;3;31;.912;3600000;0
2997;2152;49;39;27;5;22;.815;3568000;0
2997;2296;37;72;36;4;32;.889;3600000;0
2997;4435;49;0;0;0;0;.00nan;0;0
2997;5883;37;0;0;0;0;.00nan;0;0
2999;2824;65;26;13;4;9;.692;1177000;0
2999;4987;65;89;29;1;28;.966;2423000;0
2999;5298;55;0;0;0;0;.00nan;0;0
2999;34770;55;75;27;1;26;.963;3600000;0
3001;37;46;85;22;1;21;.955;3900000;0
3001;2553;46;0;0;0;0;.00nan;0;0
3001;3626;48;0;0;0;0;.00nan;0;0
3001;38547;48;93;38;1;37;.974;3900000;0
3003;14351;40;0;0;0;0;.00nan;0;0
3003;26840;40;84;36;2;34;.944;3600000;0
3003;28772;53;0;0;0;0;.00nan;0;0
3003;31156;53;64;26;3;23;.885;3570000;0
3005;4716;4619;0;0;0;0;.00nan;0;0
3005;8046;57;52;33;5;28;.848;3600000;0
3005;27474;57;0;0;0;0;.00nan;0;0
3005;35210;4619;50;14;2;12;.857;3600000;0
3007;1592;63;0;0;0;0;.00nan;0;0
3007;19640;41;0;0;0;0;.00nan;0;0
3007;23075;41;68;20;2;18;.900;3600000;0
3007;26967;63;81;42;4;38;.905;3531000;0
3009;5146;64;60;23;3;20;.870;3773000;0
3009;7049;47;0;0;0;0;.00nan;0;0
3009;28845;64;0;0;0;0;.00nan;0;0
3009;33654;47;90;38;2;36;.947;3773000;0
3011;2900;36;0;0;0;0;.00nan;0;0
3011;5137;58;77;40;3;37;.925;3562000;0
3011;14321;58;0;0;0;0;.00nan;0;0
3011;14874;36;69;22;1;21;.955;3600000;0
3013;6572;62;0;0;0;0;.00nan;0;0
3013;23493;51;0;0;0;0;.00nan;0;0
3013;26919;62;77;23;1;22;.957;3600000;0
3013;31822;51;74;35;3;32;.914;3535000;0
3015;780;52;70;35;3;32;.914;3900000;0
3015;5298;55;0;0;0;0;.00nan;0;0
3015;23255;52;0;0;0;0;.00nan;0;0
3015;34770;55;82;41;3;38;.927;3900000;0
3017;1592;63;45;33;5;28;.848;3555000;0
3017;26967;63;0;0;0;0;.00nan;0;0
3017;34788;42;0;0;0;0;.00nan;0;0
3017;37416;42;83;38;3;35;.921;3600000;0
3019;376;45;70;18;1;17;.944;3600000;0
3019;2198;45;0;0;0;0;.00nan;0;0
3019;4447;54;51;34;5;29;.853;3600000;0
3019;31643;54;0;0;0;0;.00nan;0;0
3021;3626;48;0;0;0;0;.00nan;0;0
3021;5137;58;50;28;4;24;.857;3600000;0
3021;14321;58;0;0;0;0;.00nan;0;0
3021;38547;48;72;30;2;28;.933;3600000;0
3023;2796;59;0;0;0;0;.00nan;0;0
3023;7049;47;95;22;0;22;1.000;3600000;0
3023;31858;59;83;34;3;31;.912;3600000;0
3023;33654;47;0;0;0;0;.00nan;0;0
3025;4716;4619;80;39;3;36;.923;3600000;0
3025;6081;56;59;40;5;35;.875;3519000;0
3025;26824;56;0;0;0;0;.00nan;0;0
3025;35210;4619;0;0;0;0;.00nan;0;0
3027;5146;64;52;2;0;2;1.000;374000;0
3027;19640;41;57;25;3;22;.880;3600000;0
3027;23075;41;0;0;0;0;.00nan;0;0
3027;28845;64;49;42;6;36;.857;3226000;0
3029;37;46;0;0;0;0;.00nan;0;0
3029;2553;46;73;24;2;22;.917;3542000;0
3029;23493;51;71;22;1;21;.955;3600000;0
3029;31822;51;0;0;0;0;.00nan;0;0
3031;3847;38;66;32;3;29;.906;3600000;0
3031;14351;40;69;36;4;32;.889;3584000;0
3031;26840;40;0;0;0;0;.00nan;0;0
3031;31021;38;0;0;0;0;.00nan;0;0
3033;1051;44;0;0;0;0;.00nan;0;0
3033;2824;65;0;0;0;0;.00nan;0;0
3033;3281;44;83;36;2;34;.944;3600000;0
3033;4987;65;92;30;1;29;.967;3600000;0
3035;2016;61;72;22;1;21;.955;3600000;0
3035;6572;62;0;0;0;0;.00nan;0;0
3035;26919;62;83;39;3;36;.923;3575000;0
3035;30971;61;0;0;0;0;.00nan;0;0
3037;2900;36;0;0;0;0;.00nan;0;0
3037;8046;57;0;0;0;0;.00nan;0;0
3037;14874;36;60;27;4;23;.852;3600000;0
3037;27474;57;94;32;1;31;.969;3600000;0
3039;20717;60;87;26;1;25;.962;3600000;0
3039;28772;53;0;0;0;0;.00nan;0;0
3039;31156;53;79;39;3;36;.923;3513000;0
3039;35536;60;0;0;0;0;.00nan;0;0
3041;3;50;73;25;2;23;.920;3600000;0
3041;2296;37;0;0;0;0;.00nan;0;0
3041;5048;50;0;0;0;0;.00nan;0;0
3041;5883;37;58;34;4;30;.882;3514000;0
3043;907;39;0;0;0;0;.00nan;0;0
3043;1486;43;48;28;4;24;.857;3554000;0
3043;2163;39;92;47;3;44;.936;3600000;0
3043;3625;43;0;0;0;0;.00nan;0;0
3045;37;46;57;25;2;23;.920;3555000;0
3045;2553;46;0;0;0;0;.00nan;0;0
3045;2796;59;91;32;1;31;.969;3600000;0
3045;31858;59;0;0;0;0;.00nan;0;0
3047;1592;63;70;24;1;23;.958;2558000;0
3047;4447;54;0;0;0;0;.00nan;0;0
3047;26967;63;17;9;4;5;.556;981000;0
3047;31643;54;64;30;3;27;.900;3600000;0
3049;3847;38;57;6;0;6;1.000;705000;0
3049;6572;62;58;26;4;22;.846;3900000;0
3049;26919;62;0;0;0;0;.00nan;0;0
3049;31021;38;50;27;4;23;.852;3195000;0
3051;2824;65;82;26;1;25;.962;3600000;0
3051;4716;4619;0;0;0;0;.00nan;0;0
3051;4987;65;0;0;0;0;.00nan;0;0
3051;35210;4619;46;19;3;16;.842;3561000;0
3053;1486;43;0;0;0;0;.00nan;0;0
3053;3625;43;59;25;4;21;.840;3600000;0
3053;7049;47;94;33;1;32;.970;3600000;0
3053;33654;47;0;0;0;0;.00nan;0;0
3055;5146;64;80;29;2;27;.931;3600000;0
3055;19640;41;0;0;0;0;.00nan;0;0
3055;23075;41;49;24;3;21;.875;3555000;0
3055;28845;64;0;0;0;0;.00nan;0;0
3057;780;52;0;0;0;0;.00nan;0;0
3057;8046;57;71;38;3;35;.921;3687000;0
3057;23255;52;43;24;4;20;.833;3687000;0
3057;27474;57;0;0;0;0;.00nan;0;0
3059;2296;37;90;32;1;31;.969;3600000;0
3059;5883;37;0;0;0;0;.00nan;0;0
3059;34788;42;34;22;4;18;.818;3600000;0
3059;37416;42;0;0;0;0;.00nan;0;0
3061;1051;44;43;29;5;24;.828;3600000;0
3061;3281;44;0;0;0;0;.00nan;0;0
3061;6081;56;0;0;0;0;.00nan;0;0
3061;26824;56;79;35;2;33;.943;3600000;0
3063;376;45;0;0;0;0;.00nan;0;0
3063;2198;45;100;34;0;34;1.000;3600000;0
3063;5298;55;75;23;1;22;.957;3590000;0
3063;34770;55;0;0;0;0;.00nan;0;0
3065;907;39;91;28;1;27;.964;3600000;0
3065;2016;61;0;0;0;0;.00nan;0;0
3065;2163;39;0;0;0;0;.00nan;0;0
3065;30971;61;58;32;4;28;.875;3600000;0
3067;2900;36;58;24;4;20;.833;3528000;0
3067;5137;58;0;0;0;0;.00nan;0;0
3067;14321;58;81;32;2;30;.938;3600000;0
3067;14874;36;0;0;0;0;.00nan;0;0
3069;14351;40;0;0;0;0;.00nan;0;0
3069;20717;60;0;0;0;0;.00nan;0;0
3069;26840;40;75;24;1;23;.958;3600000;0
3069;35536;60;84;34;2;32;.941;3544000;0
3071;3626;48;52;31;4;27;.871;3600000;0
3071;23493;51;0;0;0;0;.00nan;0;0
3071;31822;51;52;18;3;15;.833;3600000;0
3071;38547;48;0;0;0;0;.00nan;0;0
3073;3;50;0;0;0;0;.00nan;0;0
3073;5048;50;89;39;2;37;.949;3600000;0
3073;28772;53;73;30;3;27;.900;3542000;0
3073;31156;53;0;0;0;0;.00nan;0;0
3075;1051;44;0;0;0;0;.00nan;0;0
3075;3281;44;99;47;1;46;.979;3600000;0
3075;5137;58;0;0;0;0;.00nan;0;0
3075;14321;58;96;39;2;37;.949;3544000;0
3077;2296;37;0;0;0;0;.00nan;0;0
3077;5883;37;85;25;1;24;.960;3600000;0
3077;23493;51;25;24;6;18;.750;2332000;0
3077;31822;51;65;11;0;11;1.000;1268000;0
3079;6572;62;71;35;3;32;.914;3600000;0
3079;20717;60;100;27;0;27;1.000;3600000;0
3079;26919;62;0;0;0;0;.00nan;0;0
3079;35536;60;0;0;0;0;.00nan;0;0
3081;376;45;0;0;0;0;.00nan;0;0
3081;2198;45;43;27;5;22;.815;3556000;0
3081;4716;4619;52;32;4;28;.875;3600000;0
3081;35210;4619;0;0;0;0;.00nan;0;0
3083;907;39;52;21;3;18;.857;3900000;0
3083;2163;39;0;0;0;0;.00nan;0;0
3083;3847;38;0;0;0;0;.00nan;0;0
3083;31021;38;76;39;3;36;.923;3900000;0
3085;780;52;0;0;0;0;.00nan;0;0
3085;2900;36;0;0;0;0;.00nan;0;0
3085;14874;36;90;36;2;34;.944;3900000;0
3085;23255;52;65;20;2;18;.900;3900000;0
3087;2016;61;81;24;1;23;.958;3600000;0
3087;7049;47;53;28;4;24;.857;3600000;0
3087;30971;61;0;0;0;0;.00nan;0;0
3087;33654;47;0;0;0;0;.00nan;0;0
3089;3;50;58;32;3;29;.906;3782000;0
3089;1592;63;71;41;4;37;.902;3782000;0
3089;5048;50;0;0;0;0;.00nan;0;0
3089;26967;63;0;0;0;0;.00nan;0;0
3091;2796;59;0;0;0;0;.00nan;0;0
3091;5298;55;0;0;0;0;.00nan;0;0
3091;31858;59;79;28;2;26;.929;3900000;0
3091;34770;55;73;31;2;29;.935;3900000;0
3093;4447;54;0;0;0;0;.00nan;0;0
3093;31643;54;85;28;2;26;.929;3600000;0
3093;34788;42;63;39;6;33;.846;3600000;0
3093;37416;42;0;0;0;0;.00nan;0;0
3095;2152;49;0;0;0;0;.00nan;0;0
3095;4435;49;39;24;4;20;.833;3600000;0
3095;19640;41;0;0;0;0;.00nan;0;0
3095;23075;41;100;25;0;25;1.000;3600000;0
3097;3626;48;0;0;0;0;.00nan;0;0
3097;6081;56;75;22;1;21;.955;3600000;0
3097;26824;56;0;0;0;0;.00nan;0;0
3097;38547;48;58;28;4;24;.857;3600000;0
3099;37;46;0;0;0;0;.00nan;0;0
3099;2553;46;63;34;4;30;.882;3600000;0
3099;28772;53;95;33;1;32;.970;3600000;0
3099;31156;53;0;0;0;0;.00nan;0;0
3101;5146;64;0;0;0;0;.00nan;0;0
3101;8046;57;0;0;0;0;.00nan;0;0
3101;27474;57;82;49;3;46;.939;3600000;0
3101;28845;64;87;19;0;19;1.000;3600000;0
3103;2824;65;0;0;0;0;.00nan;0;0
3103;4987;65;73;37;4;33;.892;3600000;0
3103;14351;40;97;39;1;38;.974;3600000;0
3103;26840;40;0;0;0;0;.00nan;0;0
3105;14321;58;72;24;2;22;.917;3600000;0
3105;34815;45;0;0;0;0;.00nan;0;0
3105;35538;58;0;0;0;0;.00nan;0;0
3105;36703;45;86;42;3;39;.929;3539000;0
3107;21469;39;0;0;0;0;.00nan;0;0
3107;23075;41;61;34;4;30;.882;3561000;0
3107;31126;39;56;20;3;17;.850;3600000;0
3107;51213;41;0;0;0;0;.00nan;0;0
3109;3281;44;0;0;0;0;.00nan;0;0
3109;26967;63;100;42;0;42;1.000;3600000;0
3109;31433;63;0;0;0;0;.00nan;0;0
3109;31545;44;81;35;3;32;.914;3600000;0
3111;3626;48;72;28;3;25;.893;3600000;0
3111;7523;40;0;0;0;0;.00nan;0;0
3111;14351;40;42;25;4;21;.840;3558000;0
3111;38547;48;0;0;0;0;.00nan;0;0
3113;4435;49;0;0;0;0;.00nan;0;0
3113;4447;54;54;35;5;30;.857;3600000;0
3113;35595;54;0;0;0;0;.00nan;0;0
3113;38817;49;69;24;2;22;.917;3600000;0
3115;3;50;65;18;2;16;.889;3600000;0
3115;5571;50;0;0;0;0;.00nan;0;0
3115;8046;57;75;35;3;32;.914;3600000;0
3115;26865;57;0;0;0;0;.00nan;0;0
3117;714;51;0;0;0;0;.00nan;0;0
3117;5298;55;20;23;6;17;.739;3577000;0
3117;31822;51;90;53;4;49;.925;3600000;0
3117;34770;55;0;0;0;0;.00nan;0;0
3119;22970;38;72;24;1;23;.958;3600000;0
3119;23255;52;0;0;0;0;.00nan;0;0
3119;31021;38;0;0;0;0;.00nan;0;0
3119;31408;52;44;35;6;29;.829;3600000;0
3121;37;46;80;36;3;33;.917;3600000;0
3121;4716;4619;0;0;0;0;.00nan;0;0
3121;26929;46;0;0;0;0;.00nan;0;0
3121;35210;4619;38;22;4;18;.818;3584000;0
3123;20717;60;62;28;2;26;.929;3550000;0
3123;30971;61;100;32;0;32;1.000;3600000;0
3123;35536;60;0;0;0;0;.00nan;0;0
3123;40296;61;0;0;0;0;.00nan;0;0
3125;7049;47;0;0;0;0;.00nan;0;0
3125;28845;64;0;0;0;0;.00nan;0;0
3125;32826;64;86;30;1;29;.967;3600000;0
3125;33654;47;77;31;2;29;.935;3578000;0
3127;3625;43;69;26;2;24;.923;3600000;0
3127;14874;36;71;36;3;33;.917;3568000;0
3127;36324;43;0;0;0;0;.00nan;0;0
3127;42825;36;0;0;0;0;.00nan;0;0
3129;5883;37;49;37;6;31;.838;3600000;0
3129;23043;37;0;0;0;0;.00nan;0;0
3129;31858;59;0;0;0;0;.00nan;0;0
3129;34819;59;87;38;2;36;.947;3600000;0
3131;351;65;100;42;0;42;1.000;3600000;0
3131;6081;56;0;0;0;0;.00nan;0;0
3131;26622;65;0;0;0;0;.00nan;0;0
3131;26824;56;52;21;3;18;.857;3600000;0
3133;6572;62;0;0;0;0;.00nan;0;0
3133;26919;62;70;35;4;31;.886;3595000;0
3133;28772;53;0;0;0;0;.00nan;0;0
3133;31156;53;74;26;2;24;.923;3600000;0
