Game Id;PlayerId;TeamId;Game Rating;SA;GA;SV;SV%;TOI;PIM
0;233;29;0;0;0;0;.00nan;0;0
0;2423;15;91;38;2;36;.947;3600000;0
0;4106;15;0;0;0;0;.00nan;0;0
0;18351;29;78;41;4;37;.902;3561000;0
1;500;4182;83;34;2;32;.941;3900000;0
1;1572;4838;93;28;2;26;.929;3900000;0
1;2328;4838;0;0;0;0;.00nan;0;0
1;25521;4182;0;0;0;0;.00nan;0;0
2;1074;0;68;44;5;39;.886;3600000;0
2;1821;3;0;0;0;0;.00nan;0;0
2;2054;3;82;11;0;11;1.000;3600000;0
2;31035;0;0;0;0;0;.00nan;0;0
3;18104;10;0;0;0;0;.00nan;0;0
3;27488;10;57;39;5;34;.872;3515000;0
3;27739;22;0;0;0;0;.00nan;0;0
3;28026;22;76;32;3;29;.906;3600000;0
4;1614;25;25;30;6;24;.800;2187000;0
4;5182;25;58;6;0;6;1.000;1413000;0
4;15505;8;57;42;5;37;.881;3600000;0
4;25076;8;0;0;0;0;.00nan;0;0
5;335;18;100;28;0;28;1.000;3600000;0
5;823;23;97;45;2;43;.956;3571000;0
5;5001;18;0;0;0;0;.00nan;0;0
5;10274;23;0;0;0;0;.00nan;0;0
6;1074;0;83;26;2;24;.923;3900000;0
6;5385;17;0;0;0;0;.00nan;0;0
6;31035;0;0;0;0;0;.00nan;0;0
6;34006;17;95;35;2;33;.943;3900000;0
7;1821;3;0;0;0;0;.00nan;0;0
7;2054;3;94;21;0;21;1.000;3600000;0
7;2058;28;75;37;3;34;.919;3600000;0
7;14061;28;0;0;0;0;.00nan;0;0
8;233;29;74;36;3;33;.917;3600000;0
8;323;9;92;32;1;31;.969;3600000;0
8;18351;29;0;0;0;0;.00nan;0;0
8;20853;9;0;0;0;0;.00nan;0;0
9;61;31;0;0;0;0;.00nan;0;0
9;2423;15;60;40;5;35;.875;3600000;0
9;4106;15;0;0;0;0;.00nan;0;0
9;34797;31;99;33;1;32;.970;3600000;0
10;445;12;0;0;0;0;.00nan;0;0
10;18104;10;58;20;3;17;.850;3552000;0
10;27488;10;0;0;0;0;.00nan;0;0
10;34786;12;99;46;2;44;.957;3600000;0
11;10103;24;79;14;0;14;1.000;1232000;0
11;13979;24;25;25;6;19;.760;2368000;0
11;16006;20;0;0;0;0;.00nan;0;0
11;18078;20;100;35;0;35;1.000;3600000;0
12;13842;34;97;36;1;35;.972;3600000;0
12;15502;34;0;0;0;0;.00nan;0;0
12;22601;26;0;0;0;0;.00nan;0;0
12;32754;26;83;38;3;35;.921;3580000;0
13;1572;4838;0;0;0;0;.00nan;0;0
13;2328;4838;94;35;2;33;.943;3600000;0
13;15464;32;49;21;3;18;.857;3597000;0
13;31643;32;0;0;0;0;.00nan;0;0
14;1913;30;0;0;0;0;.00nan;0;0
14;4506;33;87;36;2;34;.944;3900000;0
14;4826;30;82;37;2;35;.946;3900000;0
14;34740;33;0;0;0;0;.00nan;0;0
15;500;4182;0;0;0;0;.00nan;0;0
15;724;11;0;0;0;0;.00nan;0;0
15;4435;11;73;42;4;38;.905;3774000;0
15;25521;4182;67;30;3;27;.900;3774000;0
16;51;21;54;23;3;20;.870;3560000;0
16;15505;8;0;0;0;0;.00nan;0;0
16;25076;8;81;39;2;37;.949;3600000;0
16;25843;21;0;0;0;0;.00nan;0;0
17;335;18;88;33;1;32;.970;3900000;0
17;1251;14;81;26;1;25;.962;3900000;0
17;5001;18;0;0;0;0;.00nan;0;0
17;25584;14;0;0;0;0;.00nan;0;0
18;262;35;0;0;0;0;.00nan;0;0
18;1430;35;65;23;2;21;.913;3600000;0
18;1913;30;19;19;5;14;.737;1008000;0
18;4826;30;28;16;4;12;.750;2592000;0
19;445;12;0;0;0;0;.00nan;0;0
19;4450;5;100;25;0;25;1.000;3600000;0
19;19823;5;0;0;0;0;.00nan;0;0
19;34786;12;85;42;3;39;.929;3600000;0
20;5385;17;0;0;0;0;.00nan;0;0
20;22601;26;64;31;3;28;.903;3600000;0
20;32754;26;0;0;0;0;.00nan;0;0
20;34006;17;51;25;4;21;.840;3557000;0
21;1821;3;0;0;0;0;.00nan;0;0
21;2054;3;80;38;3;35;.921;3777000;0
21;2058;28;90;37;2;35;.946;3777000;0
21;14061;28;0;0;0;0;.00nan;0;0
22;1074;0;98;38;2;36;.947;2344000;0
22;18104;10;0;0;0;0;.00nan;0;0
22;27488;10;51;20;2;18;.900;3600000;0
22;31035;0;12;17;6;11;.647;1256000;0
23;323;9;69;41;4;37;.902;3586000;0
23;335;18;0;0;0;0;.00nan;0;0
23;5001;18;72;24;2;22;.917;3600000;0
23;20853;9;0;0;0;0;.00nan;0;0
24;61;31;75;33;3;30;.909;3900000;0
24;16006;20;0;0;0;0;.00nan;0;0
24;18078;20;66;35;3;32;.914;3900000;0
24;34797;31;0;0;0;0;.00nan;0;0
25;2423;15;0;0;0;0;.00nan;0;0
25;4106;15;72;35;3;32;.914;3900000;0
25;15505;8;68;36;3;33;.917;3900000;0
25;25076;8;0;0;0;0;.00nan;0;0
26;233;29;0;0;0;0;.00nan;0;0
26;18351;29;76;31;2;29;.935;3900000;0
26;27739;22;80;29;2;27;.931;3900000;0
26;28026;22;0;0;0;0;.00nan;0;0
27;1572;4838;58;26;3;23;.885;3600000;0
27;2328;4838;0;0;0;0;.00nan;0;0
27;13842;34;0;0;0;0;.00nan;0;0
27;15502;34;36;19;4;15;.789;3564000;0
28;10103;24;78;45;5;40;.889;3550000;0
28;13979;24;0;0;0;0;.00nan;0;0
28;15464;32;47;18;4;14;.778;3162000;0
28;31643;32;64;9;0;9;1.000;438000;0
29;1614;25;70;20;1;19;.950;3600000;0
29;1796;16;39;32;6;26;.813;3600000;0
29;5182;25;0;0;0;0;.00nan;0;0
29;15437;16;0;0;0;0;.00nan;0;0
30;544;19;0;0;0;0;.00nan;0;0
30;823;23;0;0;0;0;.00nan;0;0
30;10274;23;77;38;3;35;.921;3600000;0
30;31124;19;51;25;4;21;.840;3600000;0
31;262;35;100;43;1;42;.977;3600000;0
31;724;11;0;0;0;0;.00nan;0;0
31;1430;35;0;0;0;0;.00nan;0;0
31;21522;11;57;22;3;19;.864;3515000;0
32;738;27;0;0;0;0;.00nan;0;0
32;4506;33;39;24;4;20;.833;3600000;0
32;26623;27;100;29;0;29;1.000;3600000;0
32;34740;33;0;0;0;0;.00nan;0;0
33;445;12;0;0;0;0;.00nan;0;0
33;2058;28;0;0;0;0;.00nan;0;0
33;14061;28;57;27;4;23;.852;3600000;0
33;34786;12;63;43;5;38;.884;3565000;0
34;1821;3;0;0;0;0;.00nan;0;0
34;2054;3;58;28;4;24;.857;3871000;0
34;18104;10;62;41;5;36;.878;3871000;0
34;27488;10;0;0;0;0;.00nan;0;0
35;1251;14;93;18;0;18;1.000;3600000;0
35;1572;4838;96;42;2;40;.952;3577000;0
35;2328;4838;0;0;0;0;.00nan;0;0
35;25584;14;0;0;0;0;.00nan;0;0
36;544;19;59;22;3;19;.864;3684000;0
36;1913;30;87;38;2;36;.947;3684000;0
36;4826;30;0;0;0;0;.00nan;0;0
36;31124;19;0;0;0;0;.00nan;0;0
37;1796;16;82;21;1;20;.952;3600000;0
37;15437;16;0;0;0;0;.00nan;0;0
37;22601;26;0;0;0;0;.00nan;0;0
37;32754;26;89;40;2;38;.950;3600000;0
38;335;18;75;28;2;26;.929;3891000;0
38;5001;18;0;0;0;0;.00nan;0;0
38;5385;17;0;0;0;0;.00nan;0;0
38;34006;17;77;31;3;28;.903;3891000;0
39;738;27;0;0;0;0;.00nan;0;0
39;1074;0;51;42;6;36;.857;3600000;0
39;26623;27;65;19;2;17;.895;3600000;0
39;31035;0;0;0;0;0;.00nan;0;0
40;323;9;61;28;3;25;.893;3556000;0
40;13842;34;0;0;0;0;.00nan;0;0
40;15502;34;92;39;2;37;.949;3600000;0
40;20853;9;0;0;0;0;.00nan;0;0
41;61;31;78;35;2;33;.943;3557000;0
41;233;29;0;0;0;0;.00nan;0;0
41;18351;29;96;17;0;17;1.000;3600000;0
41;34797;31;0;0;0;0;.00nan;0;0
42;51;21;0;0;0;0;.00nan;0;0
42;1572;4838;0;0;0;0;.00nan;0;0
42;2328;4838;83;39;3;36;.923;3600000;0
42;25843;21;100;27;0;27;1.000;3600000;0
43;445;12;56;41;5;36;.878;2386000;0
43;2423;15;100;33;1;32;.970;3600000;0
43;4106;15;0;0;0;0;.00nan;0;0
43;34786;12;69;11;0;11;1.000;1214000;0
44;1614;25;77;25;1;24;.960;3900000;0
44;5182;25;0;0;0;0;.00nan;0;0
44;27739;22;0;0;0;0;.00nan;0;0
44;28026;22;99;46;1;45;.978;3900000;0
45;15505;8;93;45;2;43;.956;3580000;0
45;16006;20;0;0;0;0;.00nan;0;0
45;18078;20;100;21;0;21;1.000;3600000;0
45;25076;8;0;0;0;0;.00nan;0;0
46;724;11;0;0;0;0;.00nan;0;0
46;15464;32;85;25;1;24;.960;3600000;0
46;21522;11;71;27;3;24;.889;3515000;0
46;31643;32;0;0;0;0;.00nan;0;0
47;262;35;0;0;0;0;.00nan;0;0
47;1430;35;79;41;4;37;.902;3600000;0
47;4506;33;84;22;1;21;.955;3600000;0
47;34740;33;0;0;0;0;.00nan;0;0
48;823;23;67;30;2;28;.933;3600000;0
48;1913;30;0;0;0;0;.00nan;0;0
48;4826;30;77;36;4;32;.889;3546000;0
48;10274;23;0;0;0;0;.00nan;0;0
49;1251;14;99;47;2;45;.957;3803000;0
49;4450;5;74;31;3;28;.903;3803000;0
49;19823;5;0;0;0;0;.00nan;0;0
49;25584;14;0;0;0;0;.00nan;0;0
50;500;4182;86;44;3;41;.932;3572000;0
50;1796;16;61;20;2;18;.900;3600000;0
50;15437;16;0;0;0;0;.00nan;0;0
50;25521;4182;0;0;0;0;.00nan;0;0
51;1074;0;97;46;3;43;.935;3513000;0
51;10103;24;74;19;1;18;.947;3600000;0
51;13979;24;0;0;0;0;.00nan;0;0
51;31035;0;0;0;0;0;.00nan;0;0
52;738;27;0;0;0;0;.00nan;0;0
52;2058;28;50;28;4;24;.857;3617000;0
52;14061;28;0;0;0;0;.00nan;0;0
52;26623;27;55;40;5;35;.875;3617000;0
53;323;9;90;44;2;42;.955;3600000;0
53;544;19;0;0;0;0;.00nan;0;0
53;20853;9;0;0;0;0;.00nan;0;0
53;31124;19;94;23;0;23;1.000;3600000;0
54;61;31;60;19;2;17;.895;3600000;0
54;1614;25;40;26;5;21;.808;3600000;0
54;5182;25;0;0;0;0;.00nan;0;0
54;34797;31;0;0;0;0;.00nan;0;0
55;51;21;0;0;0;0;.00nan;0;0
55;25843;21;52;25;3;22;.880;3600000;0
55;27739;22;41;33;6;27;.818;3600000;0
55;28026;22;0;0;0;0;.00nan;0;0
56;13842;34;79;30;2;28;.933;3600000;0
56;15502;34;0;0;0;0;.00nan;0;0
56;16006;20;0;0;0;0;.00nan;0;0
56;18078;20;59;35;4;31;.886;3526000;0
57;335;18;78;44;4;40;.909;3600000;0
57;5001;18;0;0;0;0;.00nan;0;0
57;15505;8;54;29;4;25;.862;2468000;0
57;25076;8;26;13;4;9;.692;1132000;0
58;15464;32;82;40;4;36;.900;3900000;0
58;18104;10;0;0;0;0;.00nan;0;0
58;27488;10;65;42;4;38;.905;3900000;0
58;31643;32;0;0;0;0;.00nan;0;0
59;1913;30;0;0;0;0;.00nan;0;0
59;4506;33;56;27;4;23;.852;3600000;0
59;4826;30;60;40;5;35;.875;3600000;0
59;34740;33;0;0;0;0;.00nan;0;0
60;823;23;0;0;0;0;.00nan;0;0
60;10274;23;46;32;5;27;.844;3600000;0
60;22601;26;0;0;0;0;.00nan;0;0
60;32754;26;88;39;2;37;.949;3600000;0
61;4450;5;97;30;1;29;.967;3600000;0
61;5385;17;63;22;1;21;.955;1366000;0
61;19823;5;0;0;0;0;.00nan;0;0
61;34006;17;35;25;5;20;.800;2234000;0
62;738;27;64;36;4;32;.889;3600000;0
62;1821;3;0;0;0;0;.00nan;0;0
62;2054;3;88;23;1;22;.957;3600000;0
62;26623;27;0;0;0;0;.00nan;0;0
63;445;12;0;0;0;0;.00nan;0;0
63;724;11;76;39;4;35;.897;3588000;0
63;21522;11;0;0;0;0;.00nan;0;0
63;34786;12;63;26;3;23;.885;3600000;0
64;500;4182;75;26;1;25;.962;3600000;0
64;823;23;67;27;2;25;.926;3552000;0
64;10274;23;0;0;0;0;.00nan;0;0
64;25521;4182;0;0;0;0;.00nan;0;0
65;323;9;100;30;0;30;1.000;3600000;0
65;1074;0;77;25;1;24;.960;3600000;0
65;20853;9;0;0;0;0;.00nan;0;0
65;31035;0;0;0;0;0;.00nan;0;0
66;2058;28;56;30;4;26;.867;3611000;0
66;14061;28;0;0;0;0;.00nan;0;0
66;18104;10;0;0;0;0;.00nan;0;0
66;27488;10;40;27;5;22;.815;3611000;0
67;233;29;0;0;0;0;.00nan;0;0
67;1614;25;50;2;0;2;1.000;162000;0
67;5182;25;33;31;6;25;.806;3360000;0
67;18351;29;48;25;4;21;.840;3600000;0
68;51;21;0;0;0;0;.00nan;0;0
68;5385;17;0;0;0;0;.00nan;0;0
68;25843;21;74;23;1;22;.957;3600000;0
68;34006;17;67;39;4;35;.897;3600000;0
69;61;31;82;36;2;34;.944;3600000;0
69;1251;14;72;29;3;26;.897;3567000;0
69;25584;14;0;0;0;0;.00nan;0;0
69;34797;31;0;0;0;0;.00nan;0;0
70;1821;3;69;16;1;15;.938;3600000;0
70;2054;3;0;0;0;0;.00nan;0;0
70;2423;15;0;0;0;0;.00nan;0;0
70;4106;15;92;56;4;52;.929;3600000;0
71;544;19;0;0;0;0;.00nan;0;0
71;27739;22;52;25;3;22;.880;3600000;0
71;28026;22;0;0;0;0;.00nan;0;0
71;31124;19;99;27;0;27;1.000;3600000;0
72;10103;24;87;33;2;31;.939;3514000;0
72;13842;34;0;0;0;0;.00nan;0;0
72;13979;24;0;0;0;0;.00nan;0;0
72;15502;34;100;54;0;54;1.000;3600000;0
73;724;11;0;0;0;0;.00nan;0;0
73;1796;16;53;23;3;20;.870;3600000;0
73;15437;16;0;0;0;0;.00nan;0;0
73;21522;11;30;45;8;37;.822;3600000;0
74;262;35;0;0;0;0;.00nan;0;0
74;1430;35;66;33;4;29;.879;3600000;0
74;1913;30;32;42;7;35;.833;2806000;0
74;4826;30;51;9;1;8;.889;794000;0
75;4506;33;0;0;0;0;.00nan;0;0
75;15464;32;46;32;5;27;.844;3600000;0
75;31643;32;0;0;0;0;.00nan;0;0
75;34740;33;66;21;2;19;.905;3600000;0
76;16006;20;0;0;0;0;.00nan;0;0
76;18078;20;75;13;0;13;1.000;3600000;0
76;22601;26;0;0;0;0;.00nan;0;0
76;32754;26;68;42;4;38;.905;3600000;0
77;335;18;56;22;2;20;.909;3513000;0
77;1572;4838;88;21;0;21;1.000;3600000;0
77;2328;4838;0;0;0;0;.00nan;0;0
77;5001;18;0;0;0;0;.00nan;0;0
78;738;27;0;0;0;0;.00nan;0;0
78;4450;5;83;29;1;28;.966;3600000;0
78;19823;5;0;0;0;0;.00nan;0;0
78;26623;27;33;31;6;25;.806;3600000;0
79;323;9;100;43;1;42;.977;3600000;0
79;15505;8;54;27;3;24;.889;3542000;0
79;20853;9;0;0;0;0;.00nan;0;0
79;25076;8;0;0;0;0;.00nan;0;0
80;262;35;84;32;2;30;.938;3564000;0
80;1430;35;0;0;0;0;.00nan;0;0
80;15464;32;0;0;0;0;.00nan;0;0
80;31643;32;68;19;1;18;.947;3600000;0
81;500;4182;71;26;2;24;.923;3900000;0
81;16006;20;0;0;0;0;.00nan;0;0
81;18078;20;99;37;2;35;.946;3900000;0
81;25521;4182;0;0;0;0;.00nan;0;0
82;233;29;69;29;3;26;.897;3600000;0
82;5385;17;0;0;0;0;.00nan;0;0
82;18351;29;0;0;0;0;.00nan;0;0
82;34006;17;69;51;6;45;.882;3600000;0
83;2058;28;30;28;6;22;.786;2965000;0
83;14061;28;60;5;0;5;1.000;635000;0
83;27739;22;100;32;0;32;1.000;3600000;0
83;28026;22;0;0;0;0;.00nan;0;0
84;61;31;0;0;0;0;.00nan;0;0
84;22601;26;69;47;4;43;.915;3587000;0
84;32754;26;0;0;0;0;.00nan;0;0
84;34797;31;65;27;2;25;.926;3600000;0
85;544;19;0;0;0;0;.00nan;0;0
85;18104;10;0;0;0;0;.00nan;0;0
85;27488;10;89;31;1;30;.968;3600000;0
85;31124;19;49;31;5;26;.839;3600000;0
86;1821;3;0;0;0;0;.00nan;0;0
86;2054;3;78;43;4;39;.907;3599000;0
86;10103;24;0;0;0;0;.00nan;0;0
86;13979;24;68;30;3;27;.900;3600000;0
87;445;12;0;0;0;0;.00nan;0;0
87;13842;34;39;19;4;15;.789;1676000;0
87;15502;34;48;28;4;24;.857;1924000;0
87;34786;12;100;32;0;32;1.000;3600000;0
88;724;11;84;35;2;33;.943;3900000;0
88;1796;16;77;28;2;26;.929;3900000;0
88;15437;16;0;0;0;0;.00nan;0;0
88;21522;11;0;0;0;0;.00nan;0;0
89;51;21;89;27;1;26;.963;3600000;0
89;544;19;42;32;5;27;.844;3600000;0
89;25843;21;0;0;0;0;.00nan;0;0
89;31124;19;0;0;0;0;.00nan;0;0
90;233;29;0;0;0;0;.00nan;0;0
90;2423;15;0;0;0;0;.00nan;0;0
90;4106;15;100;26;0;26;1.000;3600000;0
90;18351;29;59;24;3;21;.875;3600000;0
91;738;27;0;0;0;0;.00nan;0;0
91;15464;32;72;41;4;37;.902;3573000;0
91;26623;27;77;28;2;26;.929;3600000;0
91;31643;32;0;0;0;0;.00nan;0;0
92;500;4182;79;28;3;25;.893;3828000;0
92;1614;25;78;51;4;47;.922;3828000;0
92;5182;25;0;0;0;0;.00nan;0;0
92;25521;4182;0;0;0;0;.00nan;0;0
93;262;35;0;0;0;0;.00nan;0;0
93;335;18;0;0;0;0;.00nan;0;0
93;1430;35;60;39;5;34;.872;3600000;0
93;5001;18;84;15;0;15;1.000;3600000;0
94;1913;30;0;0;0;0;.00nan;0;0
94;4506;33;52;36;5;31;.861;3600000;0
94;4826;30;82;27;1;26;.963;3600000;0
94;34740;33;0;0;0;0;.00nan;0;0
95;1074;0;78;31;2;29;.935;3600000;0
95;1572;4838;74;27;3;24;.889;3560000;0
95;2328;4838;0;0;0;0;.00nan;0;0
95;31035;0;0;0;0;0;.00nan;0;0
96;61;31;97;33;1;32;.970;3600000;0
96;4450;5;53;24;3;21;.875;3532000;0
96;19823;5;0;0;0;0;.00nan;0;0
96;34797;31;0;0;0;0;.00nan;0;0
97;323;9;66;31;3;28;.903;3600000;0
97;20853;9;0;0;0;0;.00nan;0;0
97;27739;22;43;34;6;28;.824;3356000;0
97;28026;22;48;0;0;0;.00nan;244000;0
98;1821;3;0;0;0;0;.00nan;0;0
98;2054;3;85;27;1;26;.963;3600000;0
98;15505;8;68;32;3;29;.906;3517000;0
98;25076;8;0;0;0;0;.00nan;0;0
99;445;12;0;0;0;0;.00nan;0;0
99;500;4182;0;0;0;0;.00nan;0;0
99;25521;4182;62;29;3;26;.897;3600000;0
99;34786;12;79;42;4;38;.905;3571000;0
100;823;23;0;0;0;0;.00nan;0;0
100;1251;14;70;32;3;29;.906;3600000;0
100;10274;23;59;31;4;27;.871;3578000;0
100;25584;14;0;0;0;0;.00nan;0;0
101;233;29;0;0;0;0;.00nan;0;0
101;18351;29;51;24;3;21;.875;3600000;0
101;22601;26;0;0;0;0;.00nan;0;0
101;32754;26;82;42;4;38;.905;3554000;0
102;544;19;0;0;0;0;.00nan;0;0
102;2423;15;58;6;0;6;1.000;1014000;0
102;4106;15;43;38;6;32;.842;2586000;0
102;31124;19;77;33;2;31;.939;3600000;0
103;4450;5;0;0;0;0;.00nan;0;0
103;10103;24;76;32;3;29;.906;3600000;0
103;13979;24;0;0;0;0;.00nan;0;0
103;19823;5;34;31;6;25;.806;3600000;0
104;1614;25;0;0;0;0;.00nan;0;0
104;1796;16;57;18;2;16;.889;3600000;0
104;5182;25;51;31;4;27;.871;3562000;0
104;15437;16;0;0;0;0;.00nan;0;0
105;335;18;0;0;0;0;.00nan;0;0
105;1251;14;0;0;0;0;.00nan;0;0
105;5001;18;48;38;6;32;.842;3600000;0
105;25584;14;43;32;5;27;.844;3600000;0
106;1913;30;39;26;5;21;.808;3900000;0
106;4826;30;0;0;0;0;.00nan;0;0
106;5385;17;0;0;0;0;.00nan;0;0
106;34006;17;60;38;5;33;.868;3900000;0
107;724;11;72;29;2;27;.931;3600000;0
107;4506;33;39;24;5;19;.792;3600000;0
107;21522;11;0;0;0;0;.00nan;0;0
107;34740;33;0;0;0;0;.00nan;0;0
108;738;27;62;22;2;20;.909;3600000;0
108;1074;0;50;40;6;34;.850;3600000;0
108;26623;27;0;0;0;0;.00nan;0;0
108;31035;0;0;0;0;0;.00nan;0;0
109;262;35;73;19;1;18;.947;3600000;0
109;1430;35;0;0;0;0;.00nan;0;0
109;1572;4838;61;19;2;17;.895;3573000;0
109;2328;4838;0;0;0;0;.00nan;0;0
110;61;31;0;0;0;0;.00nan;0;0
110;323;9;92;46;3;43;.935;3600000;0
110;20853;9;0;0;0;0;.00nan;0;0
110;34797;31;47;24;4;20;.833;3546000;0
111;13842;34;60;40;5;35;.875;3600000;0
111;15502;34;0;0;0;0;.00nan;0;0
111;18104;10;0;0;0;0;.00nan;0;0
111;27488;10;35;33;6;27;.818;3600000;0
112;22601;26;71;32;3;29;.906;3571000;0
112;27739;22;0;0;0;0;.00nan;0;0
112;28026;22;67;23;2;21;.913;3600000;0
112;32754;26;0;0;0;0;.00nan;0;0
113;10103;24;0;0;0;0;.00nan;0;0
113;13979;24;67;21;1;20;.952;3600000;0
113;15505;8;0;0;0;0;.00nan;0;0
113;25076;8;89;34;2;32;.941;3542000;0
114;445;12;0;0;0;0;.00nan;0;0
114;2058;28;85;34;2;32;.941;3900000;0
114;14061;28;0;0;0;0;.00nan;0;0
114;34786;12;60;21;2;19;.905;3900000;0
115;500;4182;59;24;3;21;.875;3600000;0
115;1913;30;0;0;0;0;.00nan;0;0
115;4826;30;53;42;5;37;.881;3596000;0
115;25521;4182;0;0;0;0;.00nan;0;0
116;61;31;68;45;4;41;.911;3600000;0
116;4450;5;0;0;0;0;.00nan;0;0
116;19823;5;80;20;1;19;.950;3600000;0
116;34797;31;0;0;0;0;.00nan;0;0
117;323;9;0;0;0;0;.00nan;0;0
117;1821;3;0;0;0;0;.00nan;0;0
117;2054;3;72;32;3;29;.906;3600000;0
117;20853;9;58;36;5;31;.861;3589000;0
118;51;21;0;0;0;0;.00nan;0;0
118;2423;15;0;0;0;0;.00nan;0;0
118;4106;15;84;27;1;26;.963;3600000;0
118;25843;21;41;25;4;21;.840;3600000;0
119;1796;16;100;20;0;20;1.000;3600000;0
119;15437;16;0;0;0;0;.00nan;0;0
119;15505;8;90;40;3;37;.925;3600000;0
119;25076;8;0;0;0;0;.00nan;0;0
120;15464;32;0;0;0;0;.00nan;0;0
120;16006;20;64;16;1;15;.938;3600000;0
120;18078;20;0;0;0;0;.00nan;0;0
120;31643;32;51;46;7;39;.848;3600000;0
121;262;35;40;35;6;29;.829;3202000;0
121;1430;35;41;2;1;1;.500;398000;0
121;1614;25;63;31;4;27;.871;3600000;0
121;5182;25;0;0;0;0;.00nan;0;0
122;544;19;0;0;0;0;.00nan;0;0
122;1251;14;77;34;2;32;.941;3600000;0
122;25584;14;0;0;0;0;.00nan;0;0
122;31124;19;70;35;3;32;.914;3597000;0
123;335;18;87;39;3;36;.923;3900000;0
123;823;23;0;0;0;0;.00nan;0;0
123;5001;18;0;0;0;0;.00nan;0;0
123;10274;23;59;24;3;21;.875;3900000;0
124;724;11;82;30;1;29;.967;3900000;0
124;1074;0;86;28;1;27;.964;3900000;0
124;21522;11;0;0;0;0;.00nan;0;0
124;31035;0;0;0;0;0;.00nan;0;0
125;738;27;0;0;0;0;.00nan;0;0
125;4506;33;64;29;3;26;.897;3600000;0
125;26623;27;51;29;4;25;.862;3554000;0
125;34740;33;0;0;0;0;.00nan;0;0
126;51;21;81;40;4;36;.900;3577000;0
126;13842;34;0;0;0;0;.00nan;0;0
126;15502;34;69;30;2;28;.933;3600000;0
126;25843;21;0;0;0;0;.00nan;0;0
127;10103;24;70;33;4;29;.879;3688000;0
127;13979;24;0;0;0;0;.00nan;0;0
127;22601;26;0;0;0;0;.00nan;0;0
127;32754;26;79;40;3;37;.925;3677000;0
128;1074;0;85;37;2;35;.946;3600000;0
128;1913;30;34;30;6;24;.800;3030000;0
128;4826;30;63;11;0;11;1.000;570000;0
128;31035;0;0;0;0;0;.00nan;0;0
129;724;11;0;0;0;0;.00nan;0;0
129;5385;17;0;0;0;0;.00nan;0;0
129;21522;11;49;36;5;31;.861;3579000;0
129;34006;17;48;21;3;18;.857;3600000;0
130;1572;4838;0;0;0;0;.00nan;0;0
130;2328;4838;74;37;4;33;.892;3579000;0
130;18104;10;0;0;0;0;.00nan;0;0
130;27488;10;60;25;3;22;.880;3600000;0
131;233;29;0;0;0;0;.00nan;0;0
131;18351;29;83;29;1;28;.966;3600000;0
131;27739;22;0;0;0;0;.00nan;0;0
131;28026;22;46;28;5;23;.821;3600000;0
132;2058;28;85;28;1;27;.964;3900000;0
132;14061;28;0;0;0;0;.00nan;0;0
132;15505;8;97;33;1;32;.970;3900000;0
132;16006;8;0;0;0;0;.00nan;0;0
133;823;23;100;30;0;30;1.000;3600000;0
133;1572;4838;52;41;6;35;.854;3600000;0
133;2328;4838;0;0;0;0;.00nan;0;0
133;10274;23;0;0;0;0;.00nan;0;0
134;500;4182;62;32;4;28;.875;3600000;0
134;1821;3;0;0;0;0;.00nan;0;0
134;2054;3;83;32;2;30;.938;3600000;0
134;25521;4182;0;0;0;0;.00nan;0;0
135;323;9;83;27;1;26;.963;3600000;0
135;1074;0;0;0;0;0;.00nan;0;0
135;20853;9;0;0;0;0;.00nan;0;0
135;31035;0;78;26;2;24;.923;3543000;0
136;1251;14;74;21;1;20;.952;3600000;0
136;22601;26;0;0;0;0;.00nan;0;0
136;25584;14;0;0;0;0;.00nan;0;0
136;32754;26;100;31;0;31;1.000;3600000;0
137;262;35;0;0;0;0;.00nan;0;0
137;1430;35;27;23;6;17;.739;3600000;0
137;2058;28;0;0;0;0;.00nan;0;0
137;14061;28;100;29;0;29;1.000;3600000;0
138;445;12;56;10;1;9;.900;1231000;0
138;4506;33;50;28;4;24;.857;3600000;0
138;34740;33;0;0;0;0;.00nan;0;0
138;34786;12;26;26;6;20;.769;2369000;0
139;544;19;0;0;0;0;.00nan;0;0
139;15464;32;31;9;3;6;.667;501000;0
139;31124;19;47;34;6;28;.824;3900000;0
139;31643;32;85;43;3;40;.930;3356000;0
140;335;18;0;0;0;0;.00nan;0;0
140;5001;18;23;25;6;19;.760;3600000;0
140;18104;10;0;0;0;0;.00nan;0;0
140;27488;10;10;24;7;17;.708;3551000;0
141;51;21;0;0;0;0;.00nan;0;0
141;1913;30;0;0;0;0;.00nan;0;0
141;4826;30;81;41;3;38;.927;3900000;0
141;25843;21;79;33;3;30;.909;3900000;0
142;738;27;100;33;1;32;.970;3600000;0
142;5385;17;89;37;2;35;.946;3600000;0
142;26623;27;0;0;0;0;.00nan;0;0
142;34006;17;0;0;0;0;.00nan;0;0
143;10103;24;66;17;1;16;.941;3600000;0
143;13979;24;0;0;0;0;.00nan;0;0
143;15505;8;0;0;0;0;.00nan;0;0
143;16006;8;80;37;3;34;.919;3600000;0
144;1614;25;81;33;2;31;.939;3600000;0
144;5182;25;0;0;0;0;.00nan;0;0
144;13842;34;0;0;0;0;.00nan;0;0
144;15502;34;45;36;5;31;.861;3600000;0
145;823;23;97;51;3;48;.941;3563000;0
145;10274;23;0;0;0;0;.00nan;0;0
145;15464;32;84;23;1;22;.957;3600000;0
145;31643;32;0;0;0;0;.00nan;0;0
146;724;11;0;0;0;0;.00nan;0;0
146;1796;16;99;32;1;31;.969;3600000;0
146;15437;16;0;0;0;0;.00nan;0;0
146;21522;11;53;25;4;21;.840;3600000;0
147;323;9;28;15;4;11;.733;1155000;0
147;4450;5;96;28;0;28;1.000;3600000;0
147;19823;5;0;0;0;0;.00nan;0;0
147;20853;9;84;30;1;29;.967;2445000;0
148;233;29;0;0;0;0;.00nan;0;0
148;1821;3;0;0;0;0;.00nan;0;0
148;2054;3;72;39;4;35;.897;3551000;0
148;18351;29;49;19;3;16;.842;3600000;0
149;1074;0;100;37;1;36;.973;3600000;0
149;18078;20;64;26;3;23;.885;3580000;0
149;31035;0;0;0;0;0;.00nan;0;0
149;32146;20;0;0;0;0;.00nan;0;0
150;500;4182;63;33;4;29;.879;3600000;0
150;2058;28;0;0;0;0;.00nan;0;0
150;14061;28;91;38;2;36;.947;3600000;0
150;25521;4182;0;0;0;0;.00nan;0;0
151;61;31;70;41;4;37;.902;3546000;0
151;27739;22;89;34;3;31;.912;3600000;0
151;28026;22;0;0;0;0;.00nan;0;0
151;34797;31;0;0;0;0;.00nan;0;0
152;1251;14;71;28;2;26;.929;3600000;0
152;2423;15;0;0;0;0;.00nan;0;0
152;4106;15;56;23;3;20;.870;3543000;0
152;25584;14;0;0;0;0;.00nan;0;0
153;445;12;0;0;0;0;.00nan;0;0
153;544;19;0;0;0;0;.00nan;0;0
153;31124;19;100;28;0;28;1.000;3600000;0
153;34786;12;90;26;1;25;.962;3557000;0
154;738;27;90;52;3;49;.942;3600000;0
154;1796;16;66;21;2;19;.905;3600000;0
154;14321;16;0;0;0;0;.00nan;0;0
154;26623;27;0;0;0;0;.00nan;0;0
155;1572;4838;34;36;7;29;.806;3600000;0
155;2328;4838;0;0;0;0;.00nan;0;0
155;5385;17;0;0;0;0;.00nan;0;0
155;34006;17;69;20;1;19;.950;3600000;0
156;4506;33;76;22;1;21;.955;3550000;0
156;15505;8;0;0;0;0;.00nan;0;0
156;16006;8;100;40;0;40;1.000;3600000;0
156;34740;33;0;0;0;0;.00nan;0;0
157;823;23;92;34;2;32;.941;3600000;0
157;10274;23;0;0;0;0;.00nan;0;0
157;18104;10;0;0;0;0;.00nan;0;0
157;27488;10;23;22;6;16;.727;3600000;0
158;335;18;82;24;1;23;.958;3600000;0
158;5001;18;0;0;0;0;.00nan;0;0
158;15464;32;86;45;4;41;.911;3600000;0
158;31643;32;0;0;0;0;.00nan;0;0
159;1913;30;0;0;0;0;.00nan;0;0
159;4826;30;85;30;1;29;.967;3900000;0
159;22601;26;0;0;0;0;.00nan;0;0
159;32754;26;88;25;1;24;.960;3900000;0
160;51;21;95;24;0;24;1.000;3600000;0
160;724;11;0;0;0;0;.00nan;0;0
160;21522;11;60;26;3;23;.885;3600000;0
160;25843;21;0;0;0;0;.00nan;0;0
161;323;9;100;38;2;36;.947;3713000;0
161;5385;17;0;0;0;0;.00nan;0;0
161;20853;9;0;0;0;0;.00nan;0;0
161;34006;17;59;24;3;21;.875;3713000;0
162;1821;3;0;0;0;0;.00nan;0;0
162;2054;3;85;27;1;26;.963;3600000;0
162;4450;5;63;29;3;26;.897;3529000;0
162;19823;5;0;0;0;0;.00nan;0;0
163;500;4182;45;18;3;15;.833;3575000;0
163;1074;0;79;34;2;32;.941;3600000;0
163;25521;4182;0;0;0;0;.00nan;0;0
163;31035;0;0;0;0;0;.00nan;0;0
164;233;29;0;0;0;0;.00nan;0;0
164;2058;28;0;0;0;0;.00nan;0;0
164;14061;28;100;41;0;41;1.000;3600000;0
164;18351;29;68;19;1;18;.947;3567000;0
165;61;31;87;27;3;24;.889;3600000;0
165;10103;24;69;33;4;29;.879;3581000;0
165;13979;24;0;0;0;0;.00nan;0;0
165;34797;31;0;0;0;0;.00nan;0;0
166;262;35;46;25;4;21;.840;3600000;0
166;1430;35;0;0;0;0;.00nan;0;0
166;2423;15;0;0;0;0;.00nan;0;0
166;4106;15;82;30;1;29;.967;3600000;0
167;1251;14;86;48;4;44;.917;3562000;0
167;25584;14;0;0;0;0;.00nan;0;0
167;27739;22;91;33;2;31;.939;3600000;0
167;28026;22;0;0;0;0;.00nan;0;0
168;1614;25;96;35;1;34;.971;3600000;0
168;5182;25;0;0;0;0;.00nan;0;0
168;13842;34;0;0;0;0;.00nan;0;0
168;15502;34;63;40;5;35;.875;3600000;0
169;4506;33;0;0;0;0;.00nan;0;0
169;18078;20;91;40;2;38;.950;3887000;0
169;32146;20;0;0;0;0;.00nan;0;0
169;34740;33;96;31;2;29;.935;3900000;0
170;544;19;0;0;0;0;.00nan;0;0
170;18104;10;51;22;3;19;.864;3600000;0
170;27488;10;0;0;0;0;.00nan;0;0
170;31124;19;80;32;2;30;.938;3600000;0
171;1572;4838;63;16;2;14;.875;3600000;0
171;2328;4838;0;0;0;0;.00nan;0;0
171;22601;26;60;26;3;23;.885;3548000;0
171;32754;26;0;0;0;0;.00nan;0;0
172;51;21;86;34;2;32;.941;3600000;0
172;738;27;68;24;1;23;.958;3600000;0
172;25843;21;0;0;0;0;.00nan;0;0
172;26623;27;0;0;0;0;.00nan;0;0
173;323;9;0;0;0;0;.00nan;0;0
173;500;4182;62;21;2;19;.905;3579000;0
173;20853;9;100;39;1;38;.974;3600000;0
173;25521;4182;0;0;0;0;.00nan;0;0
174;15464;32;48;28;4;24;.857;3542000;0
174;15505;8;0;0;0;0;.00nan;0;0
174;16006;8;90;45;3;42;.933;3600000;0
174;31643;32;0;0;0;0;.00nan;0;0
175;262;35;0;0;0;0;.00nan;0;0
175;928;20;71;33;3;30;.909;3600000;0
175;1430;35;67;40;5;35;.875;3515000;0
175;18078;20;0;0;0;0;.00nan;0;0
176;335;18;82;24;1;23;.958;3600000;0
176;445;12;0;0;0;0;.00nan;0;0
176;5001;18;0;0;0;0;.00nan;0;0
176;34786;12;53;26;4;22;.846;3600000;0
177;1796;16;62;18;2;16;.889;3900000;0
177;1913;30;97;50;2;48;.960;3900000;0
177;4826;30;0;0;0;0;.00nan;0;0
177;14321;16;0;0;0;0;.00nan;0;0
178;724;11;58;30;4;26;.867;3600000;0
178;1821;3;0;0;0;0;.00nan;0;0
178;2054;3;76;32;3;29;.906;3600000;0
178;21522;11;0;0;0;0;.00nan;0;0
179;61;31;72;35;4;31;.886;3600000;0
179;18104;10;66;29;3;26;.897;3600000;0
179;27488;10;0;0;0;0;.00nan;0;0
179;34797;31;0;0;0;0;.00nan;0;0
180;5385;17;77;36;3;33;.917;3900000;0
180;27739;22;54;22;3;19;.864;3900000;0
180;28026;22;0;0;0;0;.00nan;0;0
180;34006;17;0;0;0;0;.00nan;0;0
181;2058;28;0;0;0;0;.00nan;0;0
181;4450;5;0;0;0;0;.00nan;0;0
181;14061;28;99;35;1;34;.971;3600000;0
181;19823;5;57;16;2;14;.875;3543000;0
182;724;11;0;0;0;0;.00nan;0;0
182;1074;0;0;0;0;0;.00nan;0;0
182;21522;11;71;18;1;17;.944;3600000;0
182;31035;0;67;35;5;30;.857;3600000;0
183;323;9;82;28;1;27;.964;3600000;0
183;823;23;79;34;3;31;.912;3570000;0
183;10274;23;0;0;0;0;.00nan;0;0
183;20853;9;0;0;0;0;.00nan;0;0
184;233;29;82;28;2;26;.929;3900000;0
184;10103;24;72;30;2;28;.933;3900000;0
184;13979;24;0;0;0;0;.00nan;0;0
184;18351;29;0;0;0;0;.00nan;0;0
185;51;21;91;24;1;23;.958;3600000;0
185;61;31;75;32;3;29;.906;3548000;0
185;25843;21;0;0;0;0;.00nan;0;0
185;34797;31;0;0;0;0;.00nan;0;0
186;2423;15;0;0;0;0;.00nan;0;0
186;4106;15;76;26;2;24;.923;3600000;0
186;15505;8;0;0;0;0;.00nan;0;0
186;16006;8;80;38;3;35;.921;3580000;0
187;1796;16;53;23;2;21;.913;3513000;0
187;4506;33;100;29;0;29;1.000;3600000;0
187;14321;16;0;0;0;0;.00nan;0;0
187;34740;33;0;0;0;0;.00nan;0;0
188;544;19;74;24;1;23;.958;3600000;0
188;738;27;0;0;0;0;.00nan;0;0
188;26623;27;69;32;2;30;.938;3551000;0
188;31124;19;0;0;0;0;.00nan;0;0
189;335;18;76;20;2;18;.900;3900000;0
189;1913;30;97;55;2;53;.964;3900000;0
189;4826;30;0;0;0;0;.00nan;0;0
189;5001;18;0;0;0;0;.00nan;0;0
190;500;4182;77;29;2;27;.931;3600000;0
190;1572;4838;0;0;0;0;.00nan;0;0
190;2328;4838;67;29;3;26;.897;3598000;0
190;25521;4182;0;0;0;0;.00nan;0;0
191;1251;14;67;24;2;22;.917;3600000;0
191;1821;3;53;3;0;3;1.000;275000;0
191;2054;3;61;42;6;36;.857;3325000;0
191;25584;14;0;0;0;0;.00nan;0;0
192;445;12;0;0;0;0;.00nan;0;0
192;15464;32;65;26;2;24;.923;3600000;0
192;31643;32;0;0;0;0;.00nan;0;0
192;34786;12;80;38;3;35;.921;3574000;0
193;262;35;0;0;0;0;.00nan;0;0
193;1430;35;90;26;2;24;.923;3600000;0
193;22601;26;0;0;0;0;.00nan;0;0
193;32754;26;97;45;3;42;.933;3556000;0
194;823;23;94;49;4;45;.918;3551000;0
194;4450;5;0;0;0;0;.00nan;0;0
194;10274;23;0;0;0;0;.00nan;0;0
194;19823;5;95;31;2;29;.935;3600000;0
195;544;19;0;0;0;0;.00nan;0;0
195;1074;0;82;47;4;43;.915;3600000;0
195;31035;0;0;0;0;0;.00nan;0;0
195;31124;19;47;33;5;28;.848;3600000;0
196;724;11;55;19;2;17;.895;3557000;0
196;2058;28;0;0;0;0;.00nan;0;0
196;14061;28;76;21;1;20;.952;3600000;0
196;21522;11;0;0;0;0;.00nan;0;0
197;323;9;33;16;4;12;.750;1046000;0
197;20853;9;71;23;1;22;.957;2532000;0
197;27739;22;64;27;3;24;.889;3600000;0
197;28026;22;0;0;0;0;.00nan;0;0
198;51;21;23;24;6;18;.750;3600000;0
198;928;20;0;0;0;0;.00nan;0;0
198;18078;20;91;37;1;36;.973;3600000;0
198;25843;21;0;0;0;0;.00nan;0;0
199;61;31;100;51;0;51;1.000;3600000;0
199;2423;15;0;0;0;0;.00nan;0;0
199;4106;15;64;28;3;25;.893;3600000;0
199;34797;31;0;0;0;0;.00nan;0;0
200;1796;16;83;33;3;30;.909;3600000;0
200;14321;16;0;0;0;0;.00nan;0;0
200;15464;32;0;0;0;0;.00nan;0;0
200;31643;32;62;34;4;30;.882;3541000;0
201;738;27;28;20;4;16;.800;3900000;0
201;4506;33;96;53;4;49;.925;3900000;0
201;26623;27;0;0;0;0;.00nan;0;0
201;34740;33;0;0;0;0;.00nan;0;0
202;335;18;51;26;3;23;.885;3600000;0
202;1614;25;0;0;0;0;.00nan;0;0
202;5001;18;0;0;0;0;.00nan;0;0
202;5182;25;80;28;2;26;.929;3600000;0
203;262;35;87;31;2;29;.935;3600000;0
203;500;4182;0;0;0;0;.00nan;0;0
203;1430;35;0;0;0;0;.00nan;0;0
203;25521;4182;83;17;0;17;1.000;3600000;0
204;1572;4838;94;34;1;33;.971;3900000;0
204;1913;30;89;28;1;27;.964;3900000;0
204;2328;4838;0;0;0;0;.00nan;0;0
204;4826;30;0;0;0;0;.00nan;0;0
205;823;23;85;33;2;31;.939;3584000;0
205;5385;17;0;0;0;0;.00nan;0;0
205;10274;23;0;0;0;0;.00nan;0;0
205;34006;17;83;27;1;26;.963;3600000;0
206;544;19;0;0;0;0;.00nan;0;0
206;1821;3;0;0;0;0;.00nan;0;0
206;2054;3;55;14;2;12;.857;3544000;0
206;31124;19;69;21;1;20;.952;3600000;0
207;1251;14;64;22;3;19;.864;3900000;0
207;10103;24;0;0;0;0;.00nan;0;0
207;13979;24;67;31;3;28;.903;3900000;0
207;25584;14;0;0;0;0;.00nan;0;0
208;13842;34;85;32;1;31;.969;3600000;0
208;15502;34;0;0;0;0;.00nan;0;0
208;27739;22;0;0;0;0;.00nan;0;0
208;28026;22;27;34;7;27;.794;3600000;0
209;15505;8;0;0;0;0;.00nan;0;0
209;16006;8;100;27;0;27;1.000;3600000;0
209;22601;26;70;13;0;13;1.000;705000;0
209;32754;26;49;37;6;31;.838;2895000;0
210;1821;3;0;0;0;0;.00nan;0;0
210;2054;3;18;25;7;18;.720;3600000;0
210;5385;17;35;17;4;13;.765;1173000;0
210;34006;17;56;30;4;26;.867;2424000;0
211;2058;28;0;0;0;0;.00nan;0;0
211;2423;15;0;0;0;0;.00nan;0;0
211;4106;15;57;28;4;24;.857;3600000;0
211;14061;28;66;40;5;35;.875;3588000;0
212;323;9;68;34;3;31;.912;3752000;0
212;1074;0;56;27;4;23;.852;3752000;0
212;20853;9;0;0;0;0;.00nan;0;0
212;31035;0;0;0;0;0;.00nan;0;0
213;61;31;100;23;0;23;1.000;3600000;0
213;233;29;79;19;0;19;1.000;1786000;0
213;18351;29;11;18;6;12;.667;1814000;0
213;34797;31;0;0;0;0;.00nan;0;0
214;51;21;34;13;3;10;.769;550000;0
214;4450;5;42;27;5;22;.815;3600000;0
214;19823;5;0;0;0;0;.00nan;0;0
214;25843;21;65;26;3;23;.885;3023000;0
215;1796;16;82;24;1;23;.958;3600000;0
215;10103;24;0;0;0;0;.00nan;0;0
215;13979;24;53;45;6;39;.867;3600000;0
215;14321;16;0;0;0;0;.00nan;0;0
216;13842;34;0;0;0;0;.00nan;0;0
216;15502;34;66;31;3;28;.903;3600000;0
216;18104;10;47;27;4;23;.852;3567000;0
216;27488;10;0;0;0;0;.00nan;0;0
217;15464;32;37;24;4;20;.833;3545000;0
217;22601;26;0;0;0;0;.00nan;0;0
217;31643;32;0;0;0;0;.00nan;0;0
217;32754;26;76;35;3;32;.914;3600000;0
218;445;12;0;0;0;0;.00nan;0;0
218;1251;14;0;0;0;0;.00nan;0;0
218;25584;14;82;34;3;31;.912;3600000;0
218;34786;12;100;30;0;30;1.000;3600000;0
219;724;11;50;39;5;34;.872;3514000;0
219;4506;33;78;33;3;30;.909;3600000;0
219;21522;11;0;0;0;0;.00nan;0;0
219;34740;33;0;0;0;0;.00nan;0;0
220;738;27;0;0;0;0;.00nan;0;0
220;1614;25;76;37;3;34;.919;3520000;0
220;5182;25;0;0;0;0;.00nan;0;0
220;26623;27;100;49;1;48;.980;3600000;0
221;335;18;53;30;4;26;.867;3600000;0
221;500;4182;0;0;0;0;.00nan;0;0
221;5001;18;0;0;0;0;.00nan;0;0
221;25521;4182;99;36;1;35;.972;3600000;0
222;262;35;90;28;1;27;.964;3600000;0
222;1430;35;0;0;0;0;.00nan;0;0
222;1572;4838;0;0;0;0;.00nan;0;0
222;2328;4838;65;34;4;30;.882;3600000;0
223;1074;0;42;18;3;15;.833;786000;0
223;4450;5;0;0;0;0;.00nan;0;0
223;19823;5;43;16;3;13;.813;3600000;0
223;31035;0;17;33;8;25;.758;2814000;0
224;544;19;0;0;0;0;.00nan;0;0
224;2058;28;73;34;4;30;.882;3600000;0
224;14061;28;0;0;0;0;.00nan;0;0
224;31124;19;49;23;3;20;.870;3600000;0
225;51;21;88;42;2;40;.952;3900000;0
225;18104;10;0;0;0;0;.00nan;0;0
225;25843;21;0;0;0;0;.00nan;0;0
225;27488;10;85;35;2;33;.943;3900000;0
226;2423;15;66;24;2;22;.917;3522000;0
226;4106;15;0;0;0;0;.00nan;0;0
226;27739;22;100;31;0;31;1.000;3600000;0
226;28026;22;0;0;0;0;.00nan;0;0
227;823;23;82;35;3;32;.914;3576000;0
227;1796;16;86;37;2;35;.946;3600000;0
227;10274;23;0;0;0;0;.00nan;0;0
227;14321;16;0;0;0;0;.00nan;0;0
228;335;18;0;0;0;0;.00nan;0;0
228;1913;30;75;40;4;36;.900;3535000;0
228;4826;30;0;0;0;0;.00nan;0;0
228;5001;18;68;25;2;23;.920;3600000;0
229;233;29;0;0;0;0;.00nan;0;0
229;928;20;64;30;3;27;.900;3600000;0
229;18078;20;0;0;0;0;.00nan;0;0
229;18351;29;43;20;4;16;.800;3573000;0
230;323;9;88;34;2;32;.941;3805000;0
230;13842;34;69;28;3;25;.893;3805000;0
230;15502;34;0;0;0;0;.00nan;0;0
230;20853;9;0;0;0;0;.00nan;0;0
231;1821;3;0;0;0;0;.00nan;0;0
231;2054;3;81;22;1;21;.955;3600000;0
231;15464;32;86;44;3;41;.932;3597000;0
231;31643;32;0;0;0;0;.00nan;0;0
232;61;31;19;21;6;15;.714;2506000;0
232;928;20;0;0;0;0;.00nan;0;0
232;18078;20;68;47;6;41;.872;3900000;0
232;34797;31;67;11;0;11;1.000;1394000;0
233;51;21;58;12;1;11;.917;3600000;0
233;2058;28;0;0;0;0;.00nan;0;0
233;14061;28;75;40;4;36;.900;3600000;0
233;25843;21;0;0;0;0;.00nan;0;0
234;1074;0;86;51;4;47;.922;3600000;0
234;18104;10;0;0;0;0;.00nan;0;0
234;27488;10;94;18;0;18;1.000;3600000;0
234;31035;0;0;0;0;0;.00nan;0;0
235;544;19;0;0;0;0;.00nan;0;0
235;1251;14;44;33;6;27;.818;3600000;0
235;25584;14;0;0;0;0;.00nan;0;0
235;31124;19;95;38;1;37;.974;3600000;0
236;2423;15;0;0;0;0;.00nan;0;0
236;4106;15;61;20;2;18;.900;3600000;0
236;5385;17;0;0;0;0;.00nan;0;0
236;34006;17;57;32;4;28;.875;3519000;0
237;1796;16;70;23;2;21;.913;3688000;0
237;14321;16;0;0;0;0;.00nan;0;0
237;22601;26;0;0;0;0;.00nan;0;0
237;32754;26;93;46;3;43;.935;3702000;0
238;323;9;0;0;0;0;.00nan;0;0
238;445;12;0;0;0;0;.00nan;0;0
238;20853;9;99;46;3;43;.935;3900000;0
238;34786;12;71;33;3;30;.909;3900000;0
239;262;35;0;0;0;0;.00nan;0;0
239;738;27;91;35;1;34;.971;3600000;0
239;1430;35;88;43;3;40;.930;3580000;0
239;26623;27;0;0;0;0;.00nan;0;0
240;823;23;58;27;3;24;.889;3600000;0
240;4506;33;100;32;0;32;1.000;3600000;0
240;10274;23;0;0;0;0;.00nan;0;0
240;34740;33;0;0;0;0;.00nan;0;0
241;500;4182;0;0;0;0;.00nan;0;0
241;10103;24;64;37;4;33;.892;3600000;0
241;13979;24;0;0;0;0;.00nan;0;0
241;25521;4182;44;36;6;30;.833;3560000;0
242;1913;30;58;26;4;22;.846;3581000;0
242;4826;30;0;0;0;0;.00nan;0;0
242;27739;22;89;23;0;23;1.000;3051000;0
242;28026;22;32;11;3;8;.727;549000;0
243;335;18;0;0;0;0;.00nan;0;0
243;1614;25;86;30;2;28;.933;3600000;0
243;5001;18;63;40;5;35;.875;3600000;0
243;5182;25;0;0;0;0;.00nan;0;0
244;724;11;77;31;3;28;.903;3600000;0
244;21522;11;0;0;0;0;.00nan;0;0
244;27739;22;83;49;4;45;.918;3600000;0
244;28026;22;0;0;0;0;.00nan;0;0
245;1572;4838;90;31;1;30;.968;3600000;0
245;2328;4838;0;0;0;0;.00nan;0;0
245;15505;8;0;0;0;0;.00nan;0;0
245;16006;8;69;25;2;23;.920;3583000;0
246;544;19;0;0;0;0;.00nan;0;0
246;5385;17;0;0;0;0;.00nan;0;0
246;31124;19;89;25;1;24;.960;3600000;0
246;34006;17;73;38;3;35;.921;3590000;0
247;1821;3;0;0;0;0;.00nan;0;0
247;2054;3;68;40;4;36;.900;3525000;0
247;18104;10;0;0;0;0;.00nan;0;0
247;27488;10;67;24;2;22;.917;3600000;0
248;1074;0;84;41;4;37;.902;3589000;0
248;2423;15;0;0;0;0;.00nan;0;0
248;4106;15;89;32;2;30;.938;3600000;0
248;31035;0;0;0;0;0;.00nan;0;0
249;2058;28;0;0;0;0;.00nan;0;0
249;14061;28;64;33;4;29;.879;3600000;0
249;15464;32;77;24;1;23;.958;3600000;0
249;31643;32;0;0;0;0;.00nan;0;0
250;51;21;57;45;5;40;.889;3589000;0
250;61;31;50;21;3;18;.857;3600000;0
250;25843;21;0;0;0;0;.00nan;0;0
250;34797;31;0;0;0;0;.00nan;0;0
251;233;29;0;0;0;0;.00nan;0;0
251;1251;14;74;40;4;36;.900;3600000;0
251;18351;29;100;34;0;34;1.000;3600000;0
251;25584;14;0;0;0;0;.00nan;0;0
252;738;27;66;17;1;16;.941;1240000;0
252;1796;16;44;23;4;19;.826;3600000;0
252;14321;16;0;0;0;0;.00nan;0;0
252;26623;27;37;30;6;24;.800;2360000;0
253;262;35;0;0;0;0;.00nan;0;0
253;445;12;0;0;0;0;.00nan;0;0
253;1430;35;79;39;4;35;.897;3579000;0
253;34786;12;74;29;3;26;.897;3600000;0
254;823;23;68;34;4;30;.882;3534000;0
254;4506;33;65;23;2;21;.913;3600000;0
254;10274;23;0;0;0;0;.00nan;0;0
254;34740;33;0;0;0;0;.00nan;0;0
255;13842;34;39;19;4;15;.789;3569000;0
255;15502;34;0;0;0;0;.00nan;0;0
255;22601;26;0;0;0;0;.00nan;0;0
255;32754;26;73;36;3;33;.917;3600000;0
256;323;9;85;39;3;36;.923;3574000;0
256;500;4182;93;33;1;32;.970;3600000;0
256;20853;9;0;0;0;0;.00nan;0;0
256;25521;4182;0;0;0;0;.00nan;0;0
257;1913;30;75;30;2;28;.933;3900000;0
257;4826;30;0;0;0;0;.00nan;0;0
257;10103;24;88;39;2;37;.949;3900000;0
257;13979;24;0;0;0;0;.00nan;0;0
258;335;18;0;0;0;0;.00nan;0;0
258;4506;33;67;36;4;32;.889;3797000;0
258;5001;18;23;20;5;15;.750;3780000;0
258;34740;33;0;0;0;0;.00nan;0;0
259;1614;25;60;18;2;16;.889;3600000;0
259;2328;4838;68;40;4;36;.900;3552000;0
259;5182;25;0;0;0;0;.00nan;0;0
259;23075;4838;0;0;0;0;.00nan;0;0
260;1821;3;0;0;0;0;.00nan;0;0
260;2054;3;100;29;0;29;1.000;3600000;0
260;2423;15;52;24;3;21;.875;3290000;0
260;4106;15;42;14;3;11;.786;310000;0
261;15464;32;87;25;1;24;.960;3600000;0
261;23493;0;76;33;3;30;.909;3556000;0
261;31035;0;0;0;0;0;.00nan;0;0
261;31643;32;0;0;0;0;.00nan;0;0
262;2058;28;0;0;0;0;.00nan;0;0
262;14061;28;93;39;2;37;.949;3600000;0
262;18104;10;0;0;0;0;.00nan;0;0
262;27488;10;50;25;3;22;.880;3589000;0
263;51;21;100;44;1;43;.977;3900000;0
263;233;29;0;0;0;0;.00nan;0;0
263;18351;29;90;26;1;25;.962;3900000;0
263;25843;21;0;0;0;0;.00nan;0;0
264;61;31;0;0;0;0;.00nan;0;0
264;262;35;0;0;0;0;.00nan;0;0
264;1430;35;97;22;0;22;1.000;3600000;0
264;34797;31;83;28;1;27;.964;3595000;0
265;544;19;0;0;0;0;.00nan;0;0
265;928;20;0;0;0;0;.00nan;0;0
265;18078;20;100;44;1;43;.977;3600000;0
265;31124;19;81;39;3;36;.923;3513000;0
266;1251;14;99;44;2;42;.955;3900000;0
266;4450;5;0;0;0;0;.00nan;0;0
266;19823;5;71;28;2;26;.929;3900000;0
266;25584;14;0;0;0;0;.00nan;0;0
267;445;12;0;0;0;0;.00nan;0;0
267;1796;16;67;31;3;28;.903;3569000;0
267;14321;16;0;0;0;0;.00nan;0;0
267;34786;12;66;23;2;21;.913;3600000;0
268;823;23;67;18;1;17;.944;3600000;0
268;10274;23;0;0;0;0;.00nan;0;0
268;15505;8;0;0;0;0;.00nan;0;0
268;16006;8;79;35;3;32;.914;3587000;0
269;323;9;85;41;3;38;.927;3767000;0
269;20853;9;0;0;0;0;.00nan;0;0
269;22601;26;0;0;0;0;.00nan;0;0
269;32754;26;72;27;2;25;.926;3767000;0
270;500;4182;0;0;0;0;.00nan;0;0
270;13842;34;0;0;0;0;.00nan;0;0
270;15502;34;41;25;5;20;.800;3600000;0
270;25521;4182;85;33;2;31;.939;3600000;0
271;724;11;97;33;1;32;.970;3600000;0
271;10103;24;58;25;3;22;.880;3569000;0
271;13979;24;0;0;0;0;.00nan;0;0
271;21522;11;0;0;0;0;.00nan;0;0
272;738;27;76;30;2;28;.933;3900000;0
272;26623;27;0;0;0;0;.00nan;0;0
272;27739;22;96;39;2;37;.949;3900000;0
272;28026;22;0;0;0;0;.00nan;0;0
273;544;19;0;0;0;0;.00nan;0;0
273;4450;5;58;24;3;21;.875;3600000;0
273;19823;5;0;0;0;0;.00nan;0;0
273;31124;19;43;35;6;29;.829;3600000;0
274;233;29;57;22;2;20;.909;3900000;0
274;262;35;0;0;0;0;.00nan;0;0
274;1430;35;91;31;2;29;.935;3900000;0
274;18351;29;0;0;0;0;.00nan;0;0
275;928;20;76;31;2;29;.935;3600000;0
275;1821;3;0;0;0;0;.00nan;0;0
275;2054;3;71;30;3;27;.900;3578000;0
275;18078;20;0;0;0;0;.00nan;0;0
276;5385;17;72;33;3;30;.909;3600000;0
276;18104;10;100;30;0;30;1.000;3600000;0
276;27488;10;0;0;0;0;.00nan;0;0
276;34006;17;0;0;0;0;.00nan;0;0
277;335;18;0;0;0;0;.00nan;0;0
277;5001;18;84;30;2;28;.933;3600000;0
277;15505;8;79;41;4;37;.902;3584000;0
277;16006;8;0;0;0;0;.00nan;0;0
278;724;11;0;0;0;0;.00nan;0;0
278;21522;11;54;32;5;27;.844;3600000;0
278;22601;26;73;31;2;29;.935;3600000;0
278;32754;26;0;0;0;0;.00nan;0;0
279;2328;4838;0;0;0;0;.00nan;0;0
279;23075;4838;47;27;4;23;.852;3900000;0
279;27739;22;0;0;0;0;.00nan;0;0
279;28026;22;59;33;4;29;.879;3900000;0
280;5385;17;0;0;0;0;.00nan;0;0
280;13842;34;0;0;0;0;.00nan;0;0
280;15502;34;49;20;3;17;.850;3588000;0
280;34006;17;88;35;2;33;.943;3600000;0
281;500;4182;0;0;0;0;.00nan;0;0
281;1796;16;46;4;1;3;.750;663000;0
281;14321;16;28;30;6;24;.800;2937000;0
281;25521;4182;61;19;2;17;.895;3600000;0
282;1913;30;90;36;1;35;.972;3600000;0
282;4826;30;0;0;0;0;.00nan;0;0
282;15464;32;0;0;0;0;.00nan;0;0
282;31643;32;89;44;4;40;.909;3600000;0
283;2423;15;0;0;0;0;.00nan;0;0
283;4106;15;74;26;2;24;.923;3844000;0
283;4506;33;92;30;1;29;.967;3844000;0
283;34740;33;0;0;0;0;.00nan;0;0
284;1614;25;0;0;0;0;.00nan;0;0
284;2058;28;0;0;0;0;.00nan;0;0
284;5182;25;66;33;4;29;.879;3542000;0
284;14061;28;85;39;3;36;.923;3600000;0
285;738;27;0;0;0;0;.00nan;0;0
285;10103;24;61;22;2;20;.909;3600000;0
285;13979;24;0;0;0;0;.00nan;0;0
285;26623;27;79;32;3;29;.906;3570000;0
286;233;29;0;0;0;0;.00nan;0;0
286;1251;14;0;0;0;0;.00nan;0;0
286;18351;29;73;26;2;24;.923;3600000;0
286;25584;14;49;21;3;18;.857;3551000;0
287;445;12;91;37;2;35;.946;3600000;0
287;823;23;67;29;3;26;.897;3586000;0
287;10274;23;0;0;0;0;.00nan;0;0
287;34786;12;0;0;0;0;.00nan;0;0
288;544;19;0;0;0;0;.00nan;0;0
288;15505;8;0;0;0;0;.00nan;0;0
288;16006;8;100;47;2;45;.957;3900000;0
288;31124;19;68;29;2;27;.931;3900000;0
289;4450;5;0;0;0;0;.00nan;0;0
289;5385;17;21;10;4;6;.600;771000;0
289;19823;5;38;15;3;12;.800;3600000;0
289;34006;17;78;43;4;39;.907;2829000;0
290;323;9;58;51;6;45;.882;3600000;0
290;1796;16;97;20;0;20;1.000;3600000;0
290;14321;16;0;0;0;0;.00nan;0;0
290;20853;9;0;0;0;0;.00nan;0;0
291;61;31;94;33;2;31;.939;3900000;0
291;1251;14;83;31;2;29;.935;3900000;0
291;25584;14;0;0;0;0;.00nan;0;0
291;34797;31;0;0;0;0;.00nan;0;0
292;51;21;82;40;3;37;.925;3600000;0
292;262;35;0;0;0;0;.00nan;0;0
292;1430;35;46;32;5;27;.844;3530000;0
292;25843;21;0;0;0;0;.00nan;0;0
293;928;20;0;0;0;0;.00nan;0;0
293;18078;20;85;27;1;26;.963;3872000;0
293;18104;10;92;36;1;35;.972;3900000;0
293;27488;10;0;0;0;0;.00nan;0;0
294;335;18;0;0;0;0;.00nan;0;0
294;2423;15;0;0;0;0;.00nan;0;0
294;4106;15;90;37;2;35;.946;3559000;0
294;5001;18;73;26;1;25;.962;3600000;0
295;23493;0;54;35;5;30;.857;3539000;0
295;27739;22;0;0;0;0;.00nan;0;0
295;28026;22;67;27;3;24;.889;3600000;0
295;31035;0;0;0;0;0;.00nan;0;0
296;4506;33;100;36;1;35;.972;3600000;0
296;13842;34;0;0;0;0;.00nan;0;0
296;15502;34;50;19;3;16;.842;3538000;0
296;34740;33;0;0;0;0;.00nan;0;0
297;500;4182;50;26;4;22;.846;3547000;0
297;15464;32;85;34;2;32;.941;3600000;0
297;25521;4182;0;0;0;0;.00nan;0;0
297;31643;32;0;0;0;0;.00nan;0;0
298;1614;25;100;31;0;31;1.000;3600000;0
298;1913;30;44;44;7;37;.841;3600000;0
298;4826;30;0;0;0;0;.00nan;0;0
298;5182;25;0;0;0;0;.00nan;0;0
299;823;23;100;30;0;30;1.000;3600000;0
299;10274;23;0;0;0;0;.00nan;0;0
299;22601;26;0;0;0;0;.00nan;0;0
299;32754;26;77;32;2;30;.938;3514000;0
300;724;11;87;18;0;18;1.000;3600000;0
300;1821;3;0;0;0;0;.00nan;0;0
300;2054;3;70;33;3;30;.909;3600000;0
300;21522;11;0;0;0;0;.00nan;0;0
301;738;27;0;0;0;0;.00nan;0;0
301;2058;28;0;0;0;0;.00nan;0;0
301;14061;28;62;32;4;28;.875;3600000;0
301;26623;27;100;24;0;24;1.000;3600000;0
302;2328;4838;87;49;4;45;.918;3600000;0
302;10103;24;50;18;3;15;.833;3600000;0
302;13979;24;0;0;0;0;.00nan;0;0
302;23075;4838;0;0;0;0;.00nan;0;0
303;4450;5;0;0;0;0;.00nan;0;0
303;18104;10;69;33;3;30;.909;3515000;0
303;19823;5;80;24;1;23;.958;3600000;0
303;27488;10;0;0;0;0;.00nan;0;0
304;5385;17;0;0;0;0;.00nan;0;0
304;23493;0;94;38;2;36;.947;3600000;0
304;31035;0;0;0;0;0;.00nan;0;0
304;34006;17;54;28;4;24;.857;3584000;0
305;233;29;0;0;0;0;.00nan;0;0
305;2328;4838;68;36;4;32;.889;3693000;0
305;18351;29;64;26;3;23;.885;3693000;0
305;23075;4838;0;0;0;0;.00nan;0;0
306;928;20;0;0;0;0;.00nan;0;0
306;2423;15;69;41;5;36;.878;3600000;0
306;4106;15;0;0;0;0;.00nan;0;0
306;18078;20;44;22;4;18;.818;3600000;0
307;1251;14;50;27;4;23;.852;3600000;0
307;10103;24;75;33;3;30;.909;3600000;0
307;13979;24;0;0;0;0;.00nan;0;0
307;25584;14;0;0;0;0;.00nan;0;0
308;61;31;23;31;7;24;.774;3600000;0
308;27739;22;71;46;4;42;.913;3600000;0
308;28026;22;0;0;0;0;.00nan;0;0
308;34797;31;0;0;0;0;.00nan;0;0
309;335;18;83;33;2;31;.939;3900000;0
309;5001;18;0;0;0;0;.00nan;0;0
309;13842;34;96;36;2;34;.944;3900000;0
309;15502;34;0;0;0;0;.00nan;0;0
310;1796;16;73;27;2;25;.926;3600000;0
310;14321;16;0;0;0;0;.00nan;0;0
310;15505;8;92;45;3;42;.933;3541000;0
310;16006;8;0;0;0;0;.00nan;0;0
311;51;21;0;0;0;0;.00nan;0;0
311;15464;32;0;0;0;0;.00nan;0;0
311;25843;21;58;23;4;19;.826;3536000;0
311;31643;32;67;24;2;22;.917;3600000;0
312;445;12;0;0;0;0;.00nan;0;0
312;1614;25;95;22;0;22;1.000;3600000;0
312;5182;25;0;0;0;0;.00nan;0;0
312;34786;12;87;33;2;31;.939;3600000;0
313;262;35;51;8;1;7;.875;415000;0
313;1430;35;53;35;6;29;.829;3185000;0
313;4506;33;76;28;2;26;.929;3600000;0
313;34740;33;0;0;0;0;.00nan;0;0
314;1913;30;84;29;2;27;.931;3900000;0
314;2058;28;0;0;0;0;.00nan;0;0
314;4826;30;0;0;0;0;.00nan;0;0
314;14061;28;80;30;2;28;.933;3900000;0
315;738;27;0;0;0;0;.00nan;0;0
315;1821;3;0;0;0;0;.00nan;0;0
315;2054;3;93;32;2;30;.938;3593000;0
315;26623;27;100;40;0;40;1.000;3600000;0
316;323;9;100;25;0;25;1.000;3600000;0
316;5385;17;84;25;1;24;.960;3600000;0
316;20853;9;0;0;0;0;.00nan;0;0
316;34006;17;0;0;0;0;.00nan;0;0
317;61;31;0;0;0;0;.00nan;0;0
317;2328;4838;0;0;0;0;.00nan;0;0
317;23075;4838;55;33;4;29;.879;3541000;0
317;34797;31;65;25;2;23;.920;3600000;0
318;1074;0;0;0;0;0;.00nan;0;0
318;2423;15;0;0;0;0;.00nan;0;0
318;4106;15;63;25;3;22;.880;3600000;0
318;31035;0;67;36;4;32;.889;3600000;0
319;1796;16;82;32;2;30;.938;3578000;0
319;13842;34;0;0;0;0;.00nan;0;0
319;14321;16;0;0;0;0;.00nan;0;0
319;15502;34;100;32;0;32;1.000;3600000;0
320;1614;25;90;18;0;18;1.000;3600000;0
320;5182;25;0;0;0;0;.00nan;0;0
320;15464;32;24;36;6;30;.833;3600000;0
320;31643;32;0;0;0;0;.00nan;0;0
321;544;19;0;0;0;0;.00nan;0;0
321;4506;33;79;43;4;39;.907;3575000;0
321;31124;19;58;23;3;20;.870;3600000;0
321;34740;33;0;0;0;0;.00nan;0;0
322;445;12;77;22;1;21;.955;3600000;0
322;22601;26;0;0;0;0;.00nan;0;0
322;32754;26;57;39;4;35;.897;3600000;0
322;34786;12;0;0;0;0;.00nan;0;0
323;500;4182;0;0;0;0;.00nan;0;0
323;823;23;99;40;1;39;.975;3600000;0
323;10274;23;0;0;0;0;.00nan;0;0
323;25521;4182;89;50;3;47;.940;3512000;0
324;724;11;36;10;3;7;.700;3600000;0
324;2058;28;86;52;4;48;.923;3552000;0
324;14061;28;0;0;0;0;.00nan;0;0
324;21522;11;0;0;0;0;.00nan;0;0
325;335;18;0;0;0;0;.00nan;0;0
325;4450;5;0;0;0;0;.00nan;0;0
325;5001;18;99;44;1;43;.977;3600000;0
325;19823;5;69;43;5;38;.884;3600000;0
326;51;21;62;35;5;30;.857;3600000;0
326;1251;14;94;37;2;35;.946;3600000;0
326;25584;14;0;0;0;0;.00nan;0;0
326;25843;21;0;0;0;0;.00nan;0;0
327;928;20;0;0;0;0;.00nan;0;0
327;18078;20;86;43;4;39;.907;3600000;0
327;18104;10;0;0;0;0;.00nan;0;0
327;27488;10;82;15;0;15;1.000;3600000;0
328;10103;24;86;37;2;35;.946;3600000;0
328;13979;24;0;0;0;0;.00nan;0;0
328;27739;22;76;36;3;33;.917;3590000;0
328;28026;22;0;0;0;0;.00nan;0;0
329;738;27;0;0;0;0;.00nan;0;0
329;15505;8;0;0;0;0;.00nan;0;0
329;16006;8;85;29;2;27;.931;3600000;0
329;26623;27;53;25;3;22;.880;3592000;0
330;233;29;0;0;0;0;.00nan;0;0
330;262;35;0;0;0;0;.00nan;0;0
330;1430;35;97;45;3;42;.933;3544000;0
330;18351;29;74;22;2;20;.909;3600000;0
331;1821;3;0;0;0;0;.00nan;0;0
331;1913;30;90;38;3;35;.921;3638000;0
331;2054;3;74;24;2;22;.917;3638000;0
331;4826;30;0;0;0;0;.00nan;0;0
332;2328;4838;99;33;1;32;.970;3600000;0
332;5385;17;0;0;0;0;.00nan;0;0
332;23075;4838;0;0;0;0;.00nan;0;0
332;34006;17;62;27;3;24;.889;3563000;0
333;335;18;52;24;5;19;.792;3577000;0
333;1074;0;61;34;3;31;.912;3600000;0
333;5001;18;0;0;0;0;.00nan;0;0
333;31035;0;0;0;0;0;.00nan;0;0
334;4506;33;91;25;1;24;.960;3600000;0
334;22601;26;0;0;0;0;.00nan;0;0
334;32754;26;56;28;3;25;.893;3520000;0
334;34740;33;0;0;0;0;.00nan;0;0
335;544;19;0;0;0;0;.00nan;0;0
335;2423;15;0;0;0;0;.00nan;0;0
335;4106;15;62;29;3;26;.897;3900000;0
335;31124;19;81;39;3;36;.923;3900000;0
336;323;9;77;35;3;32;.914;3545000;0
336;4450;5;73;25;2;23;.920;3600000;0
336;19823;5;0;0;0;0;.00nan;0;0
336;20853;9;0;0;0;0;.00nan;0;0
337;61;31;90;45;4;41;.911;3537000;0
337;27739;22;0;0;0;0;.00nan;0;0
337;28026;22;71;28;2;26;.929;3600000;0
337;34797;31;0;0;0;0;.00nan;0;0
338;51;21;85;28;1;27;.964;3600000;0
338;738;27;73;33;3;30;.909;3521000;0
338;25843;21;0;0;0;0;.00nan;0;0
338;26623;27;0;0;0;0;.00nan;0;0
339;928;20;0;0;0;0;.00nan;0;0
339;1251;14;49;30;5;25;.833;3900000;0
339;18078;20;77;48;5;43;.896;3900000;0
339;25584;14;0;0;0;0;.00nan;0;0
340;233;29;0;0;0;0;.00nan;0;0
340;1796;16;99;34;1;33;.971;3600000;0
340;14321;16;0;0;0;0;.00nan;0;0
340;18351;29;62;23;2;21;.913;3583000;0
341;13842;34;0;0;0;0;.00nan;0;0
341;15464;32;77;39;3;36;.923;3900000;0
341;15502;34;69;28;3;25;.893;3900000;0
341;31643;32;0;0;0;0;.00nan;0;0
342;445;12;0;0;0;0;.00nan;0;0
342;10103;24;54;34;4;30;.882;3600000;0
342;13979;24;0;0;0;0;.00nan;0;0
342;34786;12;95;38;1;37;.974;3600000;0
343;262;35;0;0;0;0;.00nan;0;0
343;1430;35;96;32;1;31;.969;3600000;0
343;22601;26;69;31;3;28;.903;3571000;0
343;32754;26;0;0;0;0;.00nan;0;0
344;724;11;74;33;3;30;.909;3579000;0
344;1913;30;99;41;1;40;.976;3600000;0
344;4826;30;0;0;0;0;.00nan;0;0
344;21522;11;0;0;0;0;.00nan;0;0
345;1614;25;37;24;5;19;.792;3600000;0
345;1821;3;56;10;1;9;.900;1014000;0
345;2054;3;24;27;6;21;.778;2530000;0
345;5182;25;0;0;0;0;.00nan;0;0
346;335;18;0;0;0;0;.00nan;0;0
346;2058;28;0;0;0;0;.00nan;0;0
346;5001;18;82;24;1;23;.958;3600000;0
346;14061;28;98;44;2;42;.955;3600000;0
347;323;9;0;0;0;0;.00nan;0;0
347;2328;4838;87;33;2;31;.939;3900000;0
347;20853;9;81;38;2;36;.947;3900000;0
347;23075;4838;0;0;0;0;.00nan;0;0
348;1251;14;0;0;0;0;.00nan;0;0
348;18104;10;0;0;0;0;.00nan;0;0
348;25584;14;60;28;3;25;.893;3558000;0
348;27488;10;89;41;2;39;.951;3600000;0
349;823;23;0;0;0;0;.00nan;0;0
349;2423;15;84;33;2;31;.939;3600000;0
349;4106;15;0;0;0;0;.00nan;0;0
349;10274;23;59;31;4;27;.871;3513000;0
350;500;4182;67;25;3;22;.880;3600000;0
350;1913;30;0;0;0;0;.00nan;0;0
350;4826;30;96;53;4;49;.925;3600000;0
350;25521;4182;0;0;0;0;.00nan;0;0
351;1074;0;81;34;2;32;.941;3600000;0
351;1614;25;0;0;0;0;.00nan;0;0
351;5182;25;74;36;3;33;.917;3579000;0
351;31035;0;0;0;0;0;.00nan;0;0
352;233;29;0;0;0;0;.00nan;0;0
352;1796;16;94;36;2;34;.944;3600000;0
352;14321;16;0;0;0;0;.00nan;0;0
352;18351;29;74;32;3;29;.906;3569000;0
353;61;31;61;18;2;16;.889;3600000;0
353;5385;17;94;34;1;33;.971;2881000;0
353;34006;17;25;10;4;6;.600;719000;0
353;34797;31;0;0;0;0;.00nan;0;0
354;738;27;0;0;0;0;.00nan;0;0
354;928;20;0;0;0;0;.00nan;0;0
354;18078;20;75;27;2;25;.926;3600000;0
354;26623;27;56;39;5;34;.872;3600000;0
355;15505;8;0;0;0;0;.00nan;0;0
355;16006;8;79;37;4;33;.892;3552000;0
355;27739;22;65;22;2;20;.909;3600000;0
355;28026;22;0;0;0;0;.00nan;0;0
356;2058;28;75;47;5;42;.894;3532000;0
356;10103;24;0;0;0;0;.00nan;0;0
356;13979;24;54;19;3;16;.842;3600000;0
356;14061;28;0;0;0;0;.00nan;0;0
357;4450;5;0;0;0;0;.00nan;0;0
357;15464;32;0;0;0;0;.00nan;0;0
357;19823;5;70;19;1;18;.947;3600000;0
357;31643;32;91;41;3;38;.927;3584000;0
358;445;12;0;0;0;0;.00nan;0;0
358;13842;34;58;29;3;26;.897;3592000;0
358;15502;34;0;0;0;0;.00nan;0;0
358;34786;12;88;34;2;32;.941;3600000;0
359;51;21;0;0;0;0;.00nan;0;0
359;262;35;0;0;0;0;.00nan;0;0
359;1430;35;79;28;1;27;.964;3545000;0
359;25843;21;90;22;0;22;1.000;3600000;0
360;544;19;0;0;0;0;.00nan;0;0
360;724;11;85;28;1;27;.964;3600000;0
360;21522;11;0;0;0;0;.00nan;0;0
360;31124;19;78;31;2;29;.935;3543000;0
361;738;27;68;40;5;35;.875;3571000;0
361;18104;10;64;36;4;32;.889;3600000;0
361;26623;27;0;0;0;0;.00nan;0;0
361;27488;10;0;0;0;0;.00nan;0;0
362;51;21;0;0;0;0;.00nan;0;0
362;4506;33;0;0;0;0;.00nan;0;0
362;25843;21;76;28;2;26;.929;3900000;0
362;34740;33;60;24;2;22;.917;3900000;0
363;500;4182;89;28;1;27;.964;3611000;0
363;22601;26;0;0;0;0;.00nan;0;0
363;25521;4182;0;0;0;0;.00nan;0;0
363;32754;26;92;36;2;34;.944;3611000;0
364;544;19;62;32;4;28;.875;3892000;0
364;1913;30;0;0;0;0;.00nan;0;0
364;4826;30;53;24;3;21;.875;3861000;0
364;31124;19;0;0;0;0;.00nan;0;0
365;823;23;62;21;3;18;.857;3600000;0
365;1572;4838;79;47;4;43;.915;3564000;0
365;2328;4838;0;0;0;0;.00nan;0;0
365;10274;23;0;0;0;0;.00nan;0;0
366;233;29;0;0;0;0;.00nan;0;0
366;4450;5;0;0;0;0;.00nan;0;0
366;18351;29;73;36;3;33;.917;3574000;0
366;19823;5;67;23;2;21;.913;3600000;0
367;1614;25;88;29;1;28;.966;3600000;0
367;2058;28;0;0;0;0;.00nan;0;0
367;5182;25;0;0;0;0;.00nan;0;0
367;14061;28;75;43;4;39;.907;3600000;0
368;323;9;71;37;4;33;.892;3585000;0
368;928;20;0;0;0;0;.00nan;0;0
368;18078;20;59;23;3;20;.870;3600000;0
368;20853;9;0;0;0;0;.00nan;0;0
369;61;31;0;0;0;0;.00nan;0;0
369;1796;16;92;33;2;31;.939;3570000;0
369;14321;16;0;0;0;0;.00nan;0;0
369;34797;31;78;23;1;22;.957;3600000;0
370;15505;8;0;0;0;0;.00nan;0;0
370;16006;8;65;34;4;30;.882;3566000;0
370;18104;10;0;0;0;0;.00nan;0;0
370;27488;10;86;32;2;30;.938;3600000;0
371;13842;34;0;0;0;0;.00nan;0;0
371;15502;34;50;30;4;26;.867;3600000;0
371;27739;22;40;35;6;29;.829;2531000;0
371;28026;22;55;5;0;5;1.000;1053000;0
372;5385;17;62;39;4;35;.897;3600000;0
372;10103;24;100;24;0;24;1.000;3600000;0
372;13979;24;0;0;0;0;.00nan;0;0
372;34006;17;0;0;0;0;.00nan;0;0
373;1074;0;65;30;3;27;.900;3564000;0
373;15464;32;0;0;0;0;.00nan;0;0
373;31035;0;0;0;0;0;.00nan;0;0
373;31643;32;81;28;2;26;.929;3600000;0
374;262;35;0;0;0;0;.00nan;0;0
374;1430;35;68;26;2;24;.923;3600000;0
374;1821;3;49;1;0;1;1.000;384000;0
374;2054;3;31;30;6;24;.800;3216000;0
375;335;18;56;25;3;22;.880;3600000;0
375;2423;15;55;32;4;28;.875;3265000;0
375;4106;15;27;6;3;3;.500;335000;0
375;5001;18;0;0;0;0;.00nan;0;0
376;233;29;0;0;0;0;.00nan;0;0
376;1251;14;93;26;1;25;.962;3900000;0
376;18351;29;75;25;1;24;.960;3900000;0
376;25584;14;0;0;0;0;.00nan;0;0
377;738;27;0;0;0;0;.00nan;0;0
377;13842;34;0;0;0;0;.00nan;0;0
377;15502;34;53;37;5;32;.865;3600000;0
377;26623;27;85;35;2;33;.943;3600000;0
378;928;20;0;0;0;0;.00nan;0;0
378;15505;8;81;40;3;37;.925;3544000;0
378;16006;8;0;0;0;0;.00nan;0;0
378;18078;20;77;26;2;24;.923;3600000;0
379;1821;3;66;33;3;30;.909;3600000;0
379;2054;3;0;0;0;0;.00nan;0;0
379;4506;33;100;43;2;41;.953;3600000;0
379;34740;33;0;0;0;0;.00nan;0;0
380;724;11;100;45;2;43;.956;3600000;0
380;823;23;68;46;6;40;.870;3600000;0
380;10274;23;0;0;0;0;.00nan;0;0
380;21522;11;0;0;0;0;.00nan;0;0
381;500;4182;78;24;1;23;.958;3600000;0
381;544;19;55;35;4;31;.886;3600000;0
381;25521;4182;0;0;0;0;.00nan;0;0
381;31124;19;0;0;0;0;.00nan;0;0
382;1251;14;0;0;0;0;.00nan;0;0
382;1614;25;88;49;5;44;.898;3600000;0
382;5182;25;0;0;0;0;.00nan;0;0
382;25584;14;73;27;3;24;.889;3600000;0
383;1913;30;96;35;1;34;.971;3600000;0
383;4826;30;0;0;0;0;.00nan;0;0
383;27739;22;0;0;0;0;.00nan;0;0
383;28026;22;18;26;7;19;.731;3600000;0
384;445;12;0;0;0;0;.00nan;0;0
384;22601;26;0;0;0;0;.00nan;0;0
384;32754;26;74;33;3;30;.909;3600000;0
384;34786;12;41;20;4;16;.800;3561000;0
385;335;18;0;0;0;0;.00nan;0;0
385;724;11;0;0;0;0;.00nan;0;0
385;5001;18;41;21;4;17;.810;3600000;0
385;21522;11;46;31;5;26;.839;3561000;0
386;1572;4838;57;32;4;28;.875;3871000;0
386;2328;4838;0;0;0;0;.00nan;0;0
386;2423;15;64;28;3;25;.893;3871000;0
386;4106;15;0;0;0;0;.00nan;0;0
387;1913;30;0;0;0;0;.00nan;0;0
387;4826;30;84;23;1;22;.957;3600000;0
387;5385;17;0;0;0;0;.00nan;0;0
387;34006;17;75;43;4;39;.907;3600000;0
388;1821;3;65;55;6;49;.891;3600000;0
388;2054;3;0;0;0;0;.00nan;0;0
388;13842;34;0;0;0;0;.00nan;0;0
388;15502;34;100;23;0;23;1.000;3600000;0
389;233;29;0;0;0;0;.00nan;0;0
389;1074;0;0;0;0;0;.00nan;0;0
389;18351;29;67;26;3;23;.885;3600000;0
389;31035;0;89;52;4;48;.923;3567000;0
390;928;20;0;0;0;0;.00nan;0;0
390;2058;28;47;6;1;5;.833;603000;0
390;14061;28;34;30;6;24;.800;2997000;0
390;18078;20;66;16;1;15;.938;3600000;0
391;323;9;99;34;1;33;.971;3600000;0
391;15464;32;49;24;4;20;.833;3600000;0
391;20853;9;0;0;0;0;.00nan;0;0
391;31643;32;0;0;0;0;.00nan;0;0
392;15505;8;0;0;0;0;.00nan;0;0
392;16006;8;85;44;3;41;.932;3600000;0
392;18104;10;0;0;0;0;.00nan;0;0
392;27488;10;47;25;4;21;.840;3591000;0
393;61;31;71;33;3;30;.909;3591000;0
393;1796;16;77;35;2;33;.943;3600000;0
393;14321;16;0;0;0;0;.00nan;0;0
393;34797;31;0;0;0;0;.00nan;0;0
394;4506;33;83;30;2;28;.933;3900000;0
394;10103;24;89;33;2;31;.939;3900000;0
394;13979;24;0;0;0;0;.00nan;0;0
394;34740;33;0;0;0;0;.00nan;0;0
395;262;35;0;0;0;0;.00nan;0;0
395;823;23;87;46;4;42;.913;3515000;0
395;1430;35;88;32;2;30;.938;3600000;0
395;10274;23;0;0;0;0;.00nan;0;0
396;544;19;0;0;0;0;.00nan;0;0
396;738;27;0;0;0;0;.00nan;0;0
396;26623;27;87;18;0;18;1.000;3600000;0
396;31124;19;60;15;1;14;.933;3550000;0
397;51;21;78;24;1;23;.958;3600000;0
397;1251;14;68;29;2;27;.931;3556000;0
397;25584;14;0;0;0;0;.00nan;0;0
397;25843;21;0;0;0;0;.00nan;0;0
398;1614;25;52;25;3;22;.880;3600000;0
398;5182;25;0;0;0;0;.00nan;0;0
398;18104;10;75;40;4;36;.900;3600000;0
398;27488;10;0;0;0;0;.00nan;0;0
399;335;18;65;15;1;14;.933;2918000;0
399;4450;5;0;0;0;0;.00nan;0;0
399;5001;18;27;12;4;8;.667;646000;0
399;19823;5;70;29;3;26;.897;3600000;0
400;445;12;61;32;3;29;.906;3600000;0
400;500;4182;0;0;0;0;.00nan;0;0
400;25521;4182;47;30;5;25;.833;3588000;0
400;34786;12;0;0;0;0;.00nan;0;0
401;233;29;0;0;0;0;.00nan;0;0
401;1821;3;47;27;4;23;.852;3600000;0
401;2054;3;0;0;0;0;.00nan;0;0
401;18351;29;62;29;3;26;.897;3600000;0
402;1074;0;0;0;0;0;.00nan;0;0
402;15505;8;0;0;0;0;.00nan;0;0
402;16006;8;22;34;7;27;.794;3600000;0
402;31035;0;60;30;4;26;.867;3600000;0
403;928;20;0;0;0;0;.00nan;0;0
403;15464;32;0;0;0;0;.00nan;0;0
403;18078;20;64;33;4;29;.879;3520000;0
403;31643;32;88;29;2;27;.931;3600000;0
404;1913;30;91;37;2;35;.946;3600000;0
404;4826;30;0;0;0;0;.00nan;0;0
404;13842;34;0;0;0;0;.00nan;0;0
404;15502;34;46;25;4;21;.840;3526000;0
405;323;9;69;35;3;32;.914;3550000;0
405;1796;16;59;16;2;14;.875;3600000;0
405;14321;16;0;0;0;0;.00nan;0;0
405;20853;9;0;0;0;0;.00nan;0;0
406;544;19;0;0;0;0;.00nan;0;0
406;10103;24;98;32;1;31;.969;3600000;0
406;13979;24;0;0;0;0;.00nan;0;0
406;31124;19;82;31;2;29;.935;3600000;0
407;823;23;59;27;3;24;.889;3579000;0
407;4450;5;99;38;1;37;.974;3600000;0
407;10274;23;0;0;0;0;.00nan;0;0
407;19823;5;0;0;0;0;.00nan;0;0
408;445;12;0;0;0;0;.00nan;0;0
408;724;11;70;32;3;29;.906;3569000;0
408;21522;11;0;0;0;0;.00nan;0;0
408;34786;12;100;42;1;41;.976;3600000;0
409;262;35;0;0;0;0;.00nan;0;0
409;738;27;0;0;0;0;.00nan;0;0
409;1430;35;100;32;0;32;1.000;3600000;0
409;26623;27;86;52;5;47;.904;3600000;0
410;1572;4838;100;44;2;42;.955;3658000;0
410;2328;4838;0;0;0;0;.00nan;0;0
410;4506;33;66;25;3;22;.880;3663000;0
410;34740;33;0;0;0;0;.00nan;0;0
411;5385;17;0;0;0;0;.00nan;0;0
411;18104;10;0;0;0;0;.00nan;0;0
411;27488;10;45;29;5;24;.828;3545000;0
411;34006;17;57;31;4;27;.871;3600000;0
412;51;21;0;0;0;0;.00nan;0;0
412;15464;32;71;18;1;17;.944;3600000;0
412;25843;21;46;30;4;26;.867;3600000;0
412;31643;32;0;0;0;0;.00nan;0;0
413;2423;15;69;31;3;28;.903;3900000;0
413;4106;15;0;0;0;0;.00nan;0;0
413;27739;22;69;32;3;29;.906;3900000;0
413;28026;22;0;0;0;0;.00nan;0;0
414;323;9;90;42;3;39;.929;3545000;0
414;1614;25;87;31;2;29;.935;3600000;0
414;5182;25;0;0;0;0;.00nan;0;0
414;20853;9;0;0;0;0;.00nan;0;0
415;61;31;67;32;3;29;.906;3600000;0
415;22601;26;54;35;4;31;.886;3573000;0
415;32754;26;0;0;0;0;.00nan;0;0
415;34797;31;0;0;0;0;.00nan;0;0
416;335;18;0;0;0;0;.00nan;0;0
416;4506;33;0;0;0;0;.00nan;0;0
416;5001;18;90;18;0;18;1.000;3600000;0
416;34740;33;93;41;3;38;.927;3600000;0
417;500;4182;91;39;3;36;.923;3543000;0
417;1251;14;72;22;2;20;.909;3600000;0
417;25521;4182;0;0;0;0;.00nan;0;0
417;25584;14;0;0;0;0;.00nan;0;0
418;5385;17;30;27;6;21;.778;2245000;0
418;27739;22;0;0;0;0;.00nan;0;0
418;28026;22;58;21;3;18;.857;3600000;0
418;34006;17;75;20;1;19;.950;1355000;0
419;1821;3;76;30;3;27;.900;3699000;0
419;2054;3;0;0;0;0;.00nan;0;0
419;15505;8;0;0;0;0;.00nan;0;0
419;16006;8;91;48;4;44;.917;3699000;0
420;233;29;0;0;0;0;.00nan;0;0
420;14061;28;74;33;2;31;.939;3858000;0
420;18351;29;61;27;3;24;.889;3858000;0
420;26824;28;0;0;0;0;.00nan;0;0
421;51;21;62;31;3;28;.903;3600000;0
421;928;20;0;0;0;0;.00nan;0;0
421;18078;20;90;33;2;31;.939;3600000;0
421;25843;21;0;0;0;0;.00nan;0;0
422;1913;30;87;33;2;31;.939;3600000;0
422;2423;15;0;0;0;0;.00nan;0;0
422;4106;15;54;27;3;24;.889;3600000;0
422;4826;30;0;0;0;0;.00nan;0;0
423;1074;0;100;45;1;44;.978;3600000;0
423;1796;16;45;18;3;15;.833;3516000;0
423;14321;16;0;0;0;0;.00nan;0;0
423;31035;0;0;0;0;0;.00nan;0;0
424;544;19;0;0;0;0;.00nan;0;0
424;4450;5;0;0;0;0;.00nan;0;0
424;19823;5;99;35;2;33;.943;3600000;0
424;31124;19;67;25;3;22;.880;3573000;0
425;823;23;75;36;3;33;.917;3600000;0
425;10103;24;53;38;5;33;.868;3572000;0
425;10274;23;0;0;0;0;.00nan;0;0
425;13979;24;0;0;0;0;.00nan;0;0
426;1251;14;0;0;0;0;.00nan;0;0
426;22601;26;79;21;0;21;1.000;1693000;0
426;25584;14;71;23;2;21;.913;3600000;0
426;32754;26;26;30;7;23;.767;1907000;0
427;262;35;0;0;0;0;.00nan;0;0
427;724;11;91;18;0;18;1.000;3600000;0
427;1430;35;97;31;1;30;.968;3553000;0
427;21522;11;0;0;0;0;.00nan;0;0
428;445;12;54;27;4;23;.852;3600000;0
428;738;27;0;0;0;0;.00nan;0;0
428;26623;27;64;40;5;35;.875;3552000;0
428;34786;12;0;0;0;0;.00nan;0;0
429;1572;4838;96;47;3;44;.936;3900000;0
429;2328;4838;0;0;0;0;.00nan;0;0
429;13842;34;75;29;3;26;.897;3900000;0
429;15502;34;0;0;0;0;.00nan;0;0
430;15464;32;51;32;5;27;.844;3600000;0
430;18104;10;0;0;0;0;.00nan;0;0
430;27488;10;64;29;3;26;.897;3600000;0
430;31643;32;0;0;0;0;.00nan;0;0
431;1796;16;0;0;0;0;.00nan;0;0
431;1913;30;0;0;0;0;.00nan;0;0
431;4826;30;76;50;5;45;.900;3600000;0
431;14321;16;88;34;2;32;.941;3600000;0
432;61;31;85;37;3;34;.919;3900000;0
432;1614;25;54;24;3;21;.875;3900000;0
432;5182;25;0;0;0;0;.00nan;0;0
432;34797;31;0;0;0;0;.00nan;0;0
433;335;18;64;17;1;16;.941;3055000;0
433;5001;18;26;6;3;3;.500;545000;0
433;10103;24;83;38;3;35;.921;3600000;0
433;13979;24;0;0;0;0;.00nan;0;0
434;262;35;70;39;4;35;.897;3600000;0
434;500;4182;28;20;5;15;.750;3576000;0
434;1430;35;0;0;0;0;.00nan;0;0
434;25521;4182;0;0;0;0;.00nan;0;0
435;544;19;41;24;4;20;.833;3572000;0
435;15505;8;0;0;0;0;.00nan;0;0
435;16006;8;67;27;3;24;.889;3600000;0
435;31124;19;0;0;0;0;.00nan;0;0
436;500;4182;81;41;3;38;.927;3600000;0
436;4450;5;58;20;2;18;.900;3600000;0
436;19823;5;0;0;0;0;.00nan;0;0
436;25521;4182;0;0;0;0;.00nan;0;0
437;323;9;81;40;3;37;.925;3582000;0
437;928;20;0;0;0;0;.00nan;0;0
437;18078;20;65;12;1;11;.917;3600000;0
437;20853;9;0;0;0;0;.00nan;0;0
438;233;29;100;34;0;34;1.000;3600000;0
438;724;11;84;41;3;38;.927;3600000;0
438;18351;29;0;0;0;0;.00nan;0;0
438;21522;11;0;0;0;0;.00nan;0;0
439;61;31;31;21;5;16;.762;3600000;0
439;14061;28;91;35;2;33;.943;3600000;0
439;26824;28;0;0;0;0;.00nan;0;0
439;34797;31;0;0;0;0;.00nan;0;0
440;51;21;75;24;2;22;.917;3600000;0
440;1251;14;94;30;1;29;.967;3600000;0
440;25584;14;0;0;0;0;.00nan;0;0
440;25843;21;0;0;0;0;.00nan;0;0
441;1074;0;70;36;3;33;.917;3540000;0
441;2423;15;100;43;1;42;.977;3600000;0
441;4106;15;0;0;0;0;.00nan;0;0
441;31035;0;0;0;0;0;.00nan;0;0
442;544;19;0;0;0;0;.00nan;0;0
442;15464;32;64;10;0;10;1.000;1079000;0
442;31124;19;49;15;3;12;.800;3600000;0
442;31643;32;1;24;9;15;.625;2521000;0
443;445;12;0;0;0;0;.00nan;0;0
443;1796;16;94;18;0;18;1.000;3600000;0
443;14321;16;0;0;0;0;.00nan;0;0
443;34786;12;97;35;1;34;.971;3550000;0
444;262;35;0;0;0;0;.00nan;0;0
444;1430;35;93;34;1;33;.971;3600000;0
444;10103;24;85;32;2;30;.938;3545000;0
444;13979;24;0;0;0;0;.00nan;0;0
445;4506;33;66;23;2;21;.913;3600000;0
445;5385;17;97;43;3;40;.930;3600000;0
445;34006;17;0;0;0;0;.00nan;0;0
445;34740;33;0;0;0;0;.00nan;0;0
446;1614;25;0;0;0;0;.00nan;0;0
446;5182;25;52;37;6;31;.838;3898000;0
446;18104;10;0;0;0;0;.00nan;0;0
446;27488;10;61;42;6;36;.857;3900000;0
447;823;23;0;0;0;0;.00nan;0;0
447;1821;3;90;41;3;38;.927;3600000;0
447;2054;3;0;0;0;0;.00nan;0;0
447;10274;23;36;28;5;23;.821;3551000;0
448;335;18;0;0;0;0;.00nan;0;0
448;5001;18;74;26;2;24;.923;3600000;0
448;13842;34;0;0;0;0;.00nan;0;0
448;15502;34;33;22;4;18;.818;3545000;0
449;738;27;0;0;0;0;.00nan;0;0
449;1572;4838;90;32;1;31;.969;3600000;0
449;2328;4838;0;0;0;0;.00nan;0;0
449;26623;27;71;32;3;29;.906;3600000;0
450;15505;8;0;0;0;0;.00nan;0;0
450;16006;8;99;23;0;23;1.000;3600000;0
450;27739;22;82;29;1;28;.966;3564000;0
450;28026;22;0;0;0;0;.00nan;0;0
451;18104;10;52;35;5;30;.857;3550000;0
451;22601;26;0;0;0;0;.00nan;0;0
451;27488;10;0;0;0;0;.00nan;0;0
451;32754;26;81;48;4;44;.917;3600000;0
452;1572;4838;0;0;0;0;.00nan;0;0
452;1913;30;0;0;0;0;.00nan;0;0
452;2328;4838;64;29;3;26;.897;3900000;0
452;4826;30;94;44;3;41;.932;3900000;0
453;1074;0;0;0;0;0;.00nan;0;0
453;1251;14;0;0;0;0;.00nan;0;0
453;25584;14;77;27;2;25;.926;3600000;0
453;31035;0;54;24;3;21;.875;3575000;0
454;233;29;81;32;1;31;.969;3583000;0
454;14061;28;100;43;0;43;1.000;3600000;0
454;18351;29;0;0;0;0;.00nan;0;0
454;26824;28;0;0;0;0;.00nan;0;0
455;61;31;47;20;4;16;.800;3541000;0
455;724;11;83;40;3;37;.925;3600000;0
455;21522;11;0;0;0;0;.00nan;0;0
455;34797;31;0;0;0;0;.00nan;0;0
456;51;21;51;30;4;26;.867;3900000;0
456;500;4182;69;33;4;29;.879;3900000;0
456;25521;4182;0;0;0;0;.00nan;0;0
456;25843;21;0;0;0;0;.00nan;0;0
457;928;20;0;0;0;0;.00nan;0;0
457;4450;5;0;0;0;0;.00nan;0;0
457;18078;20;96;38;1;37;.974;3600000;0
457;19823;5;77;32;2;30;.938;3581000;0
458;323;9;82;27;1;26;.963;3600000;0
458;10103;24;89;37;2;35;.946;3546000;0
458;13979;24;0;0;0;0;.00nan;0;0
458;20853;9;0;0;0;0;.00nan;0;0
459;1614;25;77;20;1;19;.950;3600000;0
459;5182;25;0;0;0;0;.00nan;0;0
459;15464;32;0;0;0;0;.00nan;0;0
459;31643;32;67;39;4;35;.897;3600000;0
460;262;35;0;0;0;0;.00nan;0;0
460;1430;35;58;20;2;18;.900;3600000;0
460;5385;17;58;29;3;26;.897;3600000;0
460;34006;17;0;0;0;0;.00nan;0;0
461;544;19;0;0;0;0;.00nan;0;0
461;1821;3;61;28;3;25;.893;3545000;0
461;2054;3;0;0;0;0;.00nan;0;0
461;31124;19;70;29;2;27;.931;3600000;0
462;823;23;70;36;3;33;.917;3547000;0
462;10274;23;0;0;0;0;.00nan;0;0
462;13842;34;0;0;0;0;.00nan;0;0
462;15502;34;82;32;2;30;.938;3600000;0
463;335;18;0;0;0;0;.00nan;0;0
463;738;27;0;0;0;0;.00nan;0;0
463;5001;18;70;20;2;18;.900;3559000;0
463;26623;27;100;40;1;39;.975;3600000;0
464;500;4182;0;0;0;0;.00nan;0;0
464;18104;10;0;0;0;0;.00nan;0;0
464;25521;4182;72;41;4;37;.902;3600000;0
464;27488;10;100;33;0;33;1.000;3600000;0
465;2423;15;59;19;2;17;.895;3600000;0
465;4106;15;0;0;0;0;.00nan;0;0
465;5385;17;0;0;0;0;.00nan;0;0
465;34006;17;88;44;3;41;.932;3600000;0
466;15464;32;69;30;3;27;.900;3668000;0
466;15505;8;0;0;0;0;.00nan;0;0
466;16006;8;63;30;4;26;.867;3668000;0
466;31643;32;0;0;0;0;.00nan;0;0
467;445;12;91;36;1;35;.972;3600000;0
467;1796;16;66;23;2;21;.913;3573000;0
467;14321;16;0;0;0;0;.00nan;0;0
467;34786;12;0;0;0;0;.00nan;0;0
468;4506;33;97;39;2;37;.949;3600000;0
468;27739;22;78;36;3;33;.917;3600000;0
468;28026;22;0;0;0;0;.00nan;0;0
468;34740;33;0;0;0;0;.00nan;0;0
469;1913;30;88;31;1;30;.968;3600000;0
469;4826;30;0;0;0;0;.00nan;0;0
469;22601;26;0;0;0;0;.00nan;0;0
469;32754;26;66;32;4;28;.875;3600000;0
470;1074;0;0;0;0;0;.00nan;0;0
470;4450;5;0;0;0;0;.00nan;0;0
470;19823;5;66;19;1;18;.947;3600000;0
470;31035;0;56;38;5;33;.868;3600000;0
471;51;21;63;23;2;21;.913;3600000;0
471;323;9;31;27;6;21;.778;3600000;0
471;20853;9;0;0;0;0;.00nan;0;0
471;25843;21;0;0;0;0;.00nan;0;0
472;1251;14;59;28;4;24;.857;3581000;0
472;2058;28;0;0;0;0;.00nan;0;0
472;25584;14;0;0;0;0;.00nan;0;0
472;26824;28;60;31;3;28;.903;3600000;0
473;724;11;91;39;3;36;.923;3900000;0
473;10103;24;79;36;3;33;.917;3900000;0
473;13979;24;0;0;0;0;.00nan;0;0
473;21522;11;0;0;0;0;.00nan;0;0
474;445;12;0;0;0;0;.00nan;0;0
474;15505;8;68;35;3;32;.914;3555000;0
474;16006;8;0;0;0;0;.00nan;0;0
474;34786;12;71;27;2;25;.926;3600000;0
475;61;31;0;0;0;0;.00nan;0;0
475;262;35;0;0;0;0;.00nan;0;0
475;1430;35;71;23;2;21;.913;3600000;0
475;34797;31;71;36;3;33;.917;3546000;0
476;233;29;0;0;0;0;.00nan;0;0
476;1614;25;96;39;2;37;.949;3900000;0
476;5182;25;0;0;0;0;.00nan;0;0
476;18351;29;79;30;2;28;.933;3900000;0
477;544;19;0;0;0;0;.00nan;0;0
477;13842;34;0;0;0;0;.00nan;0;0
477;15502;34;77;25;2;23;.920;3600000;0
477;31124;19;91;29;1;28;.966;3600000;0
478;335;18;0;0;0;0;.00nan;0;0
478;1821;3;0;0;0;0;.00nan;0;0
478;2054;3;68;37;4;33;.892;3567000;0
478;5001;18;76;37;3;34;.919;3600000;0
479;823;23;55;32;4;28;.875;3600000;0
479;1572;4838;37;33;6;27;.818;2978000;0
479;2328;4838;51;2;0;2;1.000;548000;0
479;10274;23;0;0;0;0;.00nan;0;0
480;2058;28;61;48;6;42;.875;3600000;0
480;4450;5;69;20;1;19;.950;3600000;0
480;19823;5;0;0;0;0;.00nan;0;0
480;26824;28;0;0;0;0;.00nan;0;0
481;51;21;0;0;0;0;.00nan;0;0
481;2423;15;75;50;5;45;.900;3511000;0
481;4106;15;0;0;0;0;.00nan;0;0
481;25843;21;69;28;3;25;.893;3600000;0
482;500;4182;24;33;7;26;.788;3600000;0
482;928;20;0;0;0;0;.00nan;0;0
482;18078;20;66;24;2;22;.917;3600000;0
482;25521;4182;0;0;0;0;.00nan;0;0
483;724;11;0;0;0;0;.00nan;0;0
483;21522;11;63;33;4;29;.879;3891000;0
483;27739;22;0;0;0;0;.00nan;0;0
483;28026;22;82;39;4;35;.897;3900000;0
484;10103;24;0;0;0;0;.00nan;0;0
484;13979;24;82;34;3;31;.912;3900000;0
484;15464;32;89;37;3;34;.919;3900000;0
484;31643;32;0;0;0;0;.00nan;0;0
485;1796;16;63;27;3;24;.889;3900000;0
485;4506;33;75;42;3;39;.929;3900000;0
485;14321;16;0;0;0;0;.00nan;0;0
485;34740;33;0;0;0;0;.00nan;0;0
486;335;18;94;39;2;37;.949;3600000;0
486;5001;18;0;0;0;0;.00nan;0;0
486;22601;26;58;46;6;40;.870;3600000;0
486;32754;26;0;0;0;0;.00nan;0;0
487;1572;4838;0;0;0;0;.00nan;0;0
487;1821;3;56;18;2;16;.889;3600000;0
487;2054;3;0;0;0;0;.00nan;0;0
487;2328;4838;65;31;3;28;.903;3555000;0
488;2163;17;0;0;0;0;.00nan;0;0
488;13842;34;0;0;0;0;.00nan;0;0
488;15502;34;100;26;0;26;1.000;3600000;0
488;34006;17;74;23;1;22;.957;3578000;0
489;323;9;44;33;6;27;.818;3572000;0
489;1614;25;70;30;4;26;.867;3600000;0
489;5182;25;0;0;0;0;.00nan;0;0
489;20853;9;0;0;0;0;.00nan;0;0
490;928;20;82;27;1;26;.963;3600000;0
490;1074;0;0;0;0;0;.00nan;0;0
490;18078;20;0;0;0;0;.00nan;0;0
490;31035;0;81;43;5;38;.884;3600000;0
491;262;35;0;0;0;0;.00nan;0;0
491;445;12;62;29;3;26;.897;3526000;0
491;1430;35;91;36;1;35;.972;3600000;0
491;34786;12;0;0;0;0;.00nan;0;0
492;823;23;87;31;1;30;.968;3600000;0
492;1913;30;80;41;4;37;.902;3600000;0
492;4826;30;0;0;0;0;.00nan;0;0
492;10274;23;0;0;0;0;.00nan;0;0
493;4450;5;54;20;2;18;.900;3900000;0
493;10103;24;100;56;2;54;.964;3900000;0
493;13979;24;0;0;0;0;.00nan;0;0
493;19823;5;0;0;0;0;.00nan;0;0
494;1796;16;85;29;2;27;.931;3600000;0
494;2058;28;66;19;1;18;.947;1788000;0
494;14321;16;0;0;0;0;.00nan;0;0
494;26824;28;30;22;5;17;.773;1812000;0
495;1251;14;60;26;3;23;.885;3600000;0
495;25584;14;0;0;0;0;.00nan;0;0
495;27739;22;31;26;6;20;.769;3057000;0
495;28026;22;50;1;0;1;1.000;543000;0
496;51;21;0;0;0;0;.00nan;0;0
496;2423;15;0;0;0;0;.00nan;0;0
496;4106;15;79;26;1;25;.962;3600000;0
496;25843;21;81;40;2;38;.950;3571000;0
497;61;31;81;33;2;31;.939;3900000;0
497;15505;8;0;0;0;0;.00nan;0;0
497;16006;8;100;47;2;45;.957;3900000;0
497;34797;31;0;0;0;0;.00nan;0;0
498;4506;33;0;0;0;0;.00nan;0;0
498;15464;32;0;0;0;0;.00nan;0;0
498;31643;32;69;25;2;23;.920;3587000;0
498;34740;33;73;22;1;21;.955;3600000;0
499;544;19;0;0;0;0;.00nan;0;0
499;1913;30;58;4;0;4;1.000;696000;0
499;4826;30;35;30;6;24;.800;2904000;0
499;31124;19;99;44;3;41;.932;3600000;0
500;233;29;0;0;0;0;.00nan;0;0
500;500;4182;86;34;2;32;.941;3600000;0
500;18351;29;30;21;5;16;.762;3600000;0
500;25521;4182;0;0;0;0;.00nan;0;0
501;335;18;0;0;0;0;.00nan;0;0
501;738;27;45;13;2;11;.846;1070000;0
501;5001;18;25;20;5;15;.750;3600000;0
501;26623;27;30;29;6;23;.793;2530000;0
502;1572;4838;88;38;2;36;.947;3554000;0
502;2328;4838;0;0;0;0;.00nan;0;0
502;22601;26;0;0;0;0;.00nan;0;0
502;32754;26;94;32;1;31;.969;3600000;0
503;1614;25;71;28;2;26;.929;3600000;0
503;2163;17;0;0;0;0;.00nan;0;0
503;5182;25;0;0;0;0;.00nan;0;0
503;34006;17;99;41;1;40;.976;3600000;0
504;1074;0;65;42;5;37;.881;3264000;0
504;18104;10;0;0;0;0;.00nan;0;0
504;27488;10;58;33;5;28;.848;3600000;0
504;31035;0;47;6;1;5;.833;294000;0
505;445;12;31;28;6;22;.786;3275000;0
505;4506;33;91;38;2;36;.947;3600000;0
505;34740;33;0;0;0;0;.00nan;0;0
505;34786;12;56;6;0;6;1.000;325000;0
506;724;11;91;34;2;32;.941;3600000;0
506;823;23;57;28;4;24;.857;3600000;0
506;10274;23;0;0;0;0;.00nan;0;0
506;21522;11;0;0;0;0;.00nan;0;0
507;1614;25;0;0;0;0;.00nan;0;0
507;4450;5;0;0;0;0;.00nan;0;0
507;5182;25;62;23;2;21;.913;3530000;0
507;19823;5;93;22;0;22;1.000;3600000;0
508;1796;16;66;28;4;24;.857;3600000;0
508;1821;3;0;0;0;0;.00nan;0;0
508;2054;3;70;44;5;39;.886;3600000;0
508;14321;16;0;0;0;0;.00nan;0;0
509;2058;28;49;31;5;26;.839;3900000;0
509;10103;24;50;32;5;27;.844;3900000;0
509;13979;24;0;0;0;0;.00nan;0;0
509;26824;28;0;0;0;0;.00nan;0;0
510;61;31;0;0;0;0;.00nan;0;0
510;15464;32;0;0;0;0;.00nan;0;0
510;31643;32;83;41;4;37;.902;3586000;0
510;34797;31;77;30;2;28;.933;3600000;0
511;51;21;89;29;1;28;.966;3600000;0
511;1074;0;0;0;0;0;.00nan;0;0
511;25843;21;0;0;0;0;.00nan;0;0
511;31035;0;75;30;2;28;.933;3600000;0
512;928;20;0;0;0;0;.00nan;0;0
512;18078;20;88;40;2;38;.950;3600000;0
512;27739;22;55;33;4;29;.879;3512000;0
512;28026;22;0;0;0;0;.00nan;0;0
513;1251;14;0;0;0;0;.00nan;0;0
513;2423;15;76;19;1;18;.947;3600000;0
513;4106;15;0;0;0;0;.00nan;0;0
513;25584;14;53;28;4;24;.857;3600000;0
514;2163;17;45;39;6;33;.846;1991000;0
514;13842;34;0;0;0;0;.00nan;0;0
514;15502;34;66;19;2;17;.895;3600000;0
514;34006;17;45;16;3;13;.813;1609000;0
515;445;12;0;0;0;0;.00nan;0;0
515;15505;8;0;0;0;0;.00nan;0;0
515;16006;8;61;32;4;28;.875;3600000;0
515;34786;12;37;34;7;27;.794;3600000;0
516;262;35;0;0;0;0;.00nan;0;0
516;323;9;99;38;1;37;.974;3600000;0
516;1430;35;67;22;2;20;.909;3571000;0
516;20853;9;0;0;0;0;.00nan;0;0
517;544;19;0;0;0;0;.00nan;0;0
517;1572;4838;59;19;2;17;.895;3600000;0
517;2328;4838;0;0;0;0;.00nan;0;0
517;31124;19;74;35;3;32;.914;3581000;0
518;233;29;0;0;0;0;.00nan;0;0
518;18351;29;95;23;0;23;1.000;3600000;0
518;22601;26;0;0;0;0;.00nan;0;0
518;32754;26;95;35;1;34;.971;3593000;0
519;335;18;60;14;1;13;.929;3600000;0
519;1913;30;0;0;0;0;.00nan;0;0
519;4826;30;59;46;6;40;.870;3600000;0
519;5001;18;0;0;0;0;.00nan;0;0
520;500;4182;70;21;2;19;.905;3600000;0
520;724;11;64;32;3;29;.906;3575000;0
520;21522;11;0;0;0;0;.00nan;0;0
520;25521;4182;0;0;0;0;.00nan;0;0
521;738;27;94;28;1;27;.964;3612000;0
521;823;23;0;0;0;0;.00nan;0;0
521;10274;23;62;18;2;16;.889;3612000;0
521;26623;27;0;0;0;0;.00nan;0;0
522;2423;15;86;40;2;38;.950;3855000;0
522;4106;15;0;0;0;0;.00nan;0;0
522;4450;5;0;0;0;0;.00nan;0;0
522;19823;5;77;20;1;19;.950;3855000;0
523;928;20;0;0;0;0;.00nan;0;0
523;2163;17;51;2;0;2;1.000;277000;0
523;18078;20;71;21;2;19;.905;3600000;0
523;34006;17;48;44;7;37;.841;3323000;0
524;323;9;95;34;1;33;.971;3600000;0
524;18104;10;0;0;0;0;.00nan;0;0
524;20853;9;0;0;0;0;.00nan;0;0
524;27488;10;76;31;2;29;.935;3544000;0
525;2058;28;0;0;0;0;.00nan;0;0
525;26824;28;94;32;1;31;.969;3600000;0
525;27739;22;0;0;0;0;.00nan;0;0
525;28026;22;73;27;2;25;.926;3546000;0
526;61;31;100;25;0;25;1.000;3600000;0
526;10103;24;88;36;2;34;.944;3524000;0
526;13979;24;0;0;0;0;.00nan;0;0
526;34797;31;0;0;0;0;.00nan;0;0
527;1821;3;53;34;4;30;.882;3581000;0
527;2054;3;0;0;0;0;.00nan;0;0
527;13842;34;0;0;0;0;.00nan;0;0
527;15502;34;79;31;3;28;.903;3600000;0
528;51;21;75;40;4;36;.900;3595000;0
528;1796;16;55;23;3;20;.870;3600000;0
528;14321;16;0;0;0;0;.00nan;0;0
528;25843;21;0;0;0;0;.00nan;0;0
529;445;12;0;0;0;0;.00nan;0;0
529;15464;32;42;24;4;20;.833;3600000;0
529;31643;32;0;0;0;0;.00nan;0;0
529;34786;12;98;26;0;26;1.000;3600000;0
530;262;35;0;0;0;0;.00nan;0;0
530;1430;35;69;23;2;21;.913;3614000;0
530;4506;33;78;29;3;26;.897;3614000;0
530;34740;33;0;0;0;0;.00nan;0;0
531;544;19;0;0;0;0;.00nan;0;0
531;823;23;100;23;0;23;1.000;3600000;0
531;10274;23;0;0;0;0;.00nan;0;0
531;31124;19;81;37;2;35;.946;3590000;0
532;724;11;58;45;6;39;.867;3600000;0
532;21522;11;0;0;0;0;.00nan;0;0
532;22601;26;0;0;0;0;.00nan;0;0
532;32754;26;68;21;2;19;.905;3600000;0
533;335;18;0;0;0;0;.00nan;0;0
533;1572;4838;55;31;5;26;.839;3600000;0
533;2328;4838;0;0;0;0;.00nan;0;0
533;5001;18;82;32;2;30;.938;3600000;0
534;500;4182;0;0;0;0;.00nan;0;0
534;1614;25;68;31;3;28;.903;3558000;0
534;5182;25;0;0;0;0;.00nan;0;0
534;25521;4182;68;22;2;20;.909;3600000;0
535;738;27;0;0;0;0;.00nan;0;0
535;1913;30;0;0;0;0;.00nan;0;0
535;4826;30;79;33;2;31;.939;3900000;0
535;26623;27;100;46;2;44;.957;3900000;0
536;233;29;0;0;0;0;.00nan;0;0
536;1074;0;0;0;0;0;.00nan;0;0
536;18351;29;94;30;1;29;.967;3600000;0
536;31035;0;60;40;5;35;.875;3600000;0
537;13842;34;59;25;3;22;.880;3600000;0
537;15502;34;0;0;0;0;.00nan;0;0
537;15505;8;0;0;0;0;.00nan;0;0
537;16006;8;70;36;4;32;.889;3569000;0
538;500;4182;27;31;6;25;.806;2911000;0
538;724;11;0;0;0;0;.00nan;0;0
538;21522;11;76;26;2;24;.923;3600000;0
538;25521;4182;46;6;1;5;.833;689000;0
539;738;27;57;25;3;22;.880;3616000;0
539;22601;26;63;35;4;31;.886;3616000;0
539;26623;27;0;0;0;0;.00nan;0;0
539;32754;26;0;0;0;0;.00nan;0;0
540;51;21;0;0;0;0;.00nan;0;0
540;5385;17;0;0;0;0;.00nan;0;0
540;25843;21;100;23;0;23;1.000;3600000;0
540;34006;17;60;38;4;34;.895;3600000;0
541;1821;3;71;31;3;28;.903;3612000;0
541;2054;3;0;0;0;0;.00nan;0;0
541;2423;15;82;29;2;27;.931;3612000;0
541;4106;15;0;0;0;0;.00nan;0;0
542;2058;28;64;27;2;25;.926;3600000;0
542;4450;5;0;0;0;0;.00nan;0;0
542;19823;5;51;22;3;19;.864;3570000;0
542;26824;28;0;0;0;0;.00nan;0;0
543;61;31;85;28;1;27;.964;3600000;0
543;18104;10;0;0;0;0;.00nan;0;0
543;27488;10;47;35;6;29;.829;3600000;0
543;34797;31;0;0;0;0;.00nan;0;0
544;323;9;61;29;3;26;.897;3600000;0
544;928;20;0;0;0;0;.00nan;0;0
544;18078;20;100;24;0;24;1.000;3600000;0
544;20853;9;0;0;0;0;.00nan;0;0
545;15464;32;0;0;0;0;.00nan;0;0
545;27739;22;60;23;3;20;.870;3600000;0
545;28026;22;0;0;0;0;.00nan;0;0
545;31643;32;41;21;4;17;.810;3580000;0
546;823;23;77;35;3;32;.914;3548000;0
546;1796;16;69;25;2;23;.920;3600000;0
546;10274;23;0;0;0;0;.00nan;0;0
546;14321;16;0;0;0;0;.00nan;0;0
547;4506;33;71;25;2;23;.920;3610000;0
547;15505;8;74;36;3;33;.917;3610000;0
547;16006;8;0;0;0;0;.00nan;0;0
547;34740;33;0;0;0;0;.00nan;0;0
548;445;12;0;0;0;0;.00nan;0;0
548;1614;25;80;33;3;30;.909;3587000;0
548;5182;25;0;0;0;0;.00nan;0;0
548;34786;12;93;36;1;35;.972;3600000;0
549;335;18;0;0;0;0;.00nan;0;0
549;1913;30;0;0;0;0;.00nan;0;0
549;4826;30;89;41;3;38;.927;3587000;0
549;5001;18;68;21;2;19;.905;3600000;0
550;1251;14;59;35;4;31;.886;3579000;0
550;1572;4838;0;0;0;0;.00nan;0;0
550;2328;4838;61;26;3;23;.885;3600000;0
550;25584;14;0;0;0;0;.00nan;0;0
551;61;31;0;0;0;0;.00nan;0;0
551;233;29;0;0;0;0;.00nan;0;0
551;18351;29;97;24;0;24;1.000;3600000;0
551;34797;31;70;24;1;23;.958;3573000;0
552;928;20;0;0;0;0;.00nan;0;0
552;5385;17;61;33;4;29;.879;3600000;0
552;18078;20;72;21;1;20;.952;3600000;0
552;34006;17;0;0;0;0;.00nan;0;0
553;1074;0;90;49;4;45;.918;3900000;0
553;10103;24;68;39;4;35;.897;3900000;0
553;13979;24;0;0;0;0;.00nan;0;0
553;31035;0;0;0;0;0;.00nan;0;0
554;13842;34;0;0;0;0;.00nan;0;0
554;15464;32;79;55;5;50;.909;3600000;0
554;15502;34;73;22;1;21;.955;3600000;0
554;31643;32;0;0;0;0;.00nan;0;0
555;335;18;0;0;0;0;.00nan;0;0
555;724;11;61;45;7;38;.844;3600000;0
555;5001;18;73;19;1;18;.947;3600000;0
555;21522;11;0;0;0;0;.00nan;0;0
556;738;27;0;0;0;0;.00nan;0;0
556;1251;14;0;0;0;0;.00nan;0;0
556;25584;14;75;24;2;22;.917;3900000;0
556;26623;27;83;25;2;23;.920;3869000;0
557;544;19;64;31;3;28;.903;3587000;0
557;1572;4838;78;30;2;28;.933;3600000;0
557;2328;4838;0;0;0;0;.00nan;0;0
557;31124;19;0;0;0;0;.00nan;0;0
558;2058;28;0;0;0;0;.00nan;0;0
558;2423;15;71;26;2;24;.923;3563000;0
558;4106;15;0;0;0;0;.00nan;0;0
558;26824;28;100;37;1;36;.973;3600000;0
559;323;9;77;51;5;46;.902;3532000;0
559;20853;9;0;0;0;0;.00nan;0;0
559;27739;22;77;34;3;31;.912;3600000;0
559;28026;22;0;0;0;0;.00nan;0;0
560;233;29;0;0;0;0;.00nan;0;0
560;18104;10;0;0;0;0;.00nan;0;0
560;18351;29;64;21;2;19;.905;3600000;0
560;27488;10;86;47;3;44;.936;3552000;0
561;51;21;0;0;0;0;.00nan;0;0
561;823;23;99;18;0;18;1.000;3600000;0
561;10274;23;0;0;0;0;.00nan;0;0
561;25843;21;60;31;5;26;.839;3600000;0
562;445;12;0;0;0;0;.00nan;0;0
562;1614;25;64;28;4;24;.857;3589000;0
562;5182;25;0;0;0;0;.00nan;0;0
562;34786;12;80;31;2;29;.935;3600000;0
563;544;19;0;0;0;0;.00nan;0;0
563;4506;33;78;34;3;31;.912;3881000;0
563;31124;19;66;35;4;31;.886;3881000;0
563;34740;33;0;0;0;0;.00nan;0;0
564;500;4182;83;36;2;34;.944;3900000;0
564;1913;30;0;0;0;0;.00nan;0;0
564;4826;30;100;44;2;42;.955;3900000;0
564;25521;4182;0;0;0;0;.00nan;0;0
565;4450;5;0;0;0;0;.00nan;0;0
565;5385;17;0;0;0;0;.00nan;0;0
565;19823;5;87;17;0;17;1.000;3600000;0
565;34006;17;89;46;3;43;.935;3600000;0
566;1821;3;0;0;0;0;.00nan;0;0
566;2054;3;75;35;3;32;.914;3827000;0
566;2058;28;72;45;4;41;.911;3827000;0
566;26824;28;0;0;0;0;.00nan;0;0
567;61;31;62;20;2;18;.900;3600000;0
567;1074;0;0;0;0;0;.00nan;0;0
567;31035;0;61;33;4;29;.879;3538000;0
567;34797;31;0;0;0;0;.00nan;0;0
568;823;23;52;38;6;32;.842;3161000;0
568;928;20;0;0;0;0;.00nan;0;0
568;10274;23;56;4;0;4;1.000;439000;0
568;18078;20;61;25;3;22;.880;3600000;0
569;10103;24;37;15;4;11;.733;3627000;0
569;13842;34;0;0;0;0;.00nan;0;0
569;13979;24;0;0;0;0;.00nan;0;0
569;15502;34;81;34;3;31;.912;3627000;0
570;15464;32;0;0;0;0;.00nan;0;0
570;15505;8;49;1;0;1;1.000;395000;0
570;16006;8;28;32;7;25;.781;3205000;0
570;31643;32;84;24;1;23;.958;3600000;0
571;262;35;0;0;0;0;.00nan;0;0
571;1430;35;85;43;3;40;.930;3546000;0
571;1796;16;79;28;2;26;.929;3600000;0
571;14321;16;0;0;0;0;.00nan;0;0
572;724;11;66;43;5;38;.884;3629000;0
572;1251;14;0;0;0;0;.00nan;0;0
572;21522;11;0;0;0;0;.00nan;0;0
572;25584;14;63;32;4;28;.875;3629000;0
573;335;18;0;0;0;0;.00nan;0;0
573;1572;4838;75;38;3;35;.921;3794000;0
573;2328;4838;0;0;0;0;.00nan;0;0
573;5001;18;57;19;2;17;.895;3794000;0
574;323;9;100;37;0;37;1.000;3600000;0
574;4450;5;0;0;0;0;.00nan;0;0
574;19823;5;54;9;1;8;.889;3562000;0
574;20853;9;0;0;0;0;.00nan;0;0
575;233;29;0;0;0;0;.00nan;0;0
575;18104;10;0;0;0;0;.00nan;0;0
575;18351;29;41;31;6;25;.806;3696000;0
575;27488;10;59;34;5;29;.853;3696000;0
576;738;27;0;0;0;0;.00nan;0;0
576;2423;15;84;32;3;29;.906;3596000;0
576;4106;15;0;0;0;0;.00nan;0;0
576;26623;27;88;33;2;31;.939;3600000;0
577;51;21;38;28;5;23;.821;3600000;0
577;25843;21;0;0;0;0;.00nan;0;0
577;27739;22;0;0;0;0;.00nan;0;0
577;28026;22;60;30;4;26;.867;3600000;0
578;544;19;0;0;0;0;.00nan;0;0
578;15505;8;0;0;0;0;.00nan;0;0
578;16006;8;85;28;2;26;.929;3515000;0
578;31124;19;100;26;0;26;1.000;3600000;0
579;1614;25;70;18;1;17;.944;3600000;0
579;1913;30;74;37;3;34;.919;3574000;0
579;4826;30;0;0;0;0;.00nan;0;0
579;5182;25;0;0;0;0;.00nan;0;0
580;445;12;0;0;0;0;.00nan;0;0
580;22601;26;0;0;0;0;.00nan;0;0
580;32754;26;87;26;1;25;.962;3900000;0
580;34786;12;67;19;1;18;.947;3900000;0
581;500;4182;100;27;0;27;1.000;3600000;0
581;4506;33;54;39;5;34;.872;3600000;0
581;25521;4182;0;0;0;0;.00nan;0;0
581;34740;33;0;0;0;0;.00nan;0;0
582;1821;3;74;30;2;28;.933;3600000;0
582;2054;3;0;0;0;0;.00nan;0;0
582;10103;24;70;38;4;34;.895;3581000;0
582;13979;24;0;0;0;0;.00nan;0;0
583;262;35;0;0;0;0;.00nan;0;0
583;1430;35;69;21;2;19;.905;3600000;0
583;2058;28;0;0;0;0;.00nan;0;0
583;26824;28;89;49;4;45;.918;3568000;0
584;823;23;67;35;3;32;.914;3600000;0
584;10274;23;0;0;0;0;.00nan;0;0
584;18104;10;39;20;5;15;.750;3565000;0
584;27488;10;0;0;0;0;.00nan;0;0
585;51;21;89;45;3;42;.933;3600000;0
585;4450;5;0;0;0;0;.00nan;0;0
585;19823;5;74;9;0;9;1.000;3600000;0
585;25843;21;0;0;0;0;.00nan;0;0
586;1074;0;61;41;5;36;.878;3588000;0
586;27739;22;0;0;0;0;.00nan;0;0
586;28026;22;44;18;4;14;.778;3600000;0
586;31035;0;0;0;0;0;.00nan;0;0
587;323;9;86;38;2;36;.947;3600000;0
587;738;27;0;0;0;0;.00nan;0;0
587;20853;9;0;0;0;0;.00nan;0;0
587;26623;27;51;26;4;22;.846;3573000;0
588;61;31;58;24;3;21;.875;3600000;0
588;544;19;0;0;0;0;.00nan;0;0
588;31124;19;100;33;0;33;1.000;3600000;0
588;34797;31;0;0;0;0;.00nan;0;0
589;233;29;0;0;0;0;.00nan;0;0
589;13842;34;63;29;3;26;.897;3600000;0
589;15502;34;0;0;0;0;.00nan;0;0
589;18351;29;70;25;2;23;.920;3600000;0
590;1614;25;79;41;3;38;.927;3577000;0
590;5182;25;0;0;0;0;.00nan;0;0
590;15505;8;0;0;0;0;.00nan;0;0
590;16006;8;84;29;2;27;.931;3600000;0
591;4506;33;78;30;2;28;.933;3600000;0
591;22601;26;0;0;0;0;.00nan;0;0
591;32754;26;50;34;5;29;.853;3600000;0
591;34740;33;0;0;0;0;.00nan;0;0
592;500;4182;37;18;4;14;.778;3543000;0
592;15464;32;0;0;0;0;.00nan;0;0
592;25521;4182;0;0;0;0;.00nan;0;0
592;31643;32;87;46;3;43;.935;3600000;0
593;1251;14;0;0;0;0;.00nan;0;0
593;1913;30;0;0;0;0;.00nan;0;0
593;4826;30;99;48;2;46;.958;3600000;0
593;25584;14;28;25;6;19;.760;3600000;0
594;928;20;0;0;0;0;.00nan;0;0
594;1572;4838;0;0;0;0;.00nan;0;0
594;2328;4838;97;23;0;23;1.000;3600000;0
594;18078;20;63;25;2;23;.920;3540000;0
595;823;23;93;38;2;36;.947;3900000;0
595;1821;3;0;0;0;0;.00nan;0;0
595;2054;3;92;34;2;32;.941;3900000;0
595;10274;23;0;0;0;0;.00nan;0;0
596;1796;16;58;36;4;32;.889;3600000;0
596;2423;15;0;0;0;0;.00nan;0;0
596;4106;15;96;37;1;36;.973;3600000;0
596;14321;16;0;0;0;0;.00nan;0;0
597;335;18;0;0;0;0;.00nan;0;0
597;928;20;0;0;0;0;.00nan;0;0
597;5001;18;75;32;3;29;.906;3600000;0
597;18078;20;50;27;4;23;.852;3586000;0
598;262;35;0;0;0;0;.00nan;0;0
598;1430;35;99;32;1;31;.969;3600000;0
598;4450;5;0;0;0;0;.00nan;0;0
598;19823;5;66;25;3;22;.880;3513000;0
599;738;27;0;0;0;0;.00nan;0;0
599;5385;17;0;0;0;0;.00nan;0;0
599;26623;27;65;22;2;20;.909;3600000;0
599;34006;17;62;40;5;35;.875;3600000;0
600;1074;0;99;41;2;39;.951;3600000;0
600;1821;3;56;28;3;25;.893;3544000;0
600;2054;3;0;0;0;0;.00nan;0;0
600;31035;0;0;0;0;0;.00nan;0;0
601;233;29;0;0;0;0;.00nan;0;0
601;544;19;0;0;0;0;.00nan;0;0
601;18351;29;63;27;3;24;.889;3584000;0
601;31124;19;92;36;1;35;.972;3600000;0
602;51;21;73;32;3;29;.906;3600000;0
602;13842;34;25;26;6;20;.769;3177000;0
602;15502;34;50;1;0;1;1.000;423000;0
602;25843;21;0;0;0;0;.00nan;0;0
603;1251;14;80;37;3;34;.919;3556000;0
603;2423;15;87;36;2;34;.944;3600000;0
603;4106;15;0;0;0;0;.00nan;0;0
603;25584;14;0;0;0;0;.00nan;0;0
604;61;31;0;0;0;0;.00nan;0;0
604;445;12;0;0;0;0;.00nan;0;0
604;34786;12;78;31;2;29;.935;3572000;0
604;34797;31;87;29;1;28;.966;3600000;0
605;1614;25;100;28;0;28;1.000;3600000;0
605;4506;33;84;30;2;28;.933;3542000;0
605;5182;25;0;0;0;0;.00nan;0;0
605;34740;33;0;0;0;0;.00nan;0;0
606;15505;8;0;0;0;0;.00nan;0;0
606;16006;8;82;27;1;26;.963;3600000;0
606;22601;26;80;36;2;34;.944;3548000;0
606;32754;26;0;0;0;0;.00nan;0;0
607;500;4182;54;4;0;4;1.000;629000;0
607;18104;10;0;0;0;0;.00nan;0;0
607;25521;4182;33;32;6;26;.813;2929000;0
607;27488;10;59;34;5;29;.853;3600000;0
608;323;9;72;32;3;29;.906;3600000;0
608;1913;30;70;15;0;15;1.000;1411000;0
608;4826;30;39;25;4;21;.840;2143000;0
608;20853;9;0;0;0;0;.00nan;0;0
609;724;11;100;39;2;37;.949;3600000;0
609;15464;32;0;0;0;0;.00nan;0;0
609;21522;11;0;0;0;0;.00nan;0;0
609;31643;32;67;31;3;28;.903;3589000;0
610;1572;4838;0;0;0;0;.00nan;0;0
610;2058;28;0;0;0;0;.00nan;0;0
610;2328;4838;75;37;3;34;.919;3600000;0
610;26824;28;21;35;8;27;.771;3600000;0
611;544;19;100;29;0;29;1.000;3600000;0
611;10103;24;92;33;1;32;.970;3600000;0
611;13979;24;0;0;0;0;.00nan;0;0
611;31124;19;0;0;0;0;.00nan;0;0
612;1796;16;0;0;0;0;.00nan;0;0
612;14321;16;60;31;4;27;.871;3600000;0
612;27739;22;0;0;0;0;.00nan;0;0
612;28026;22;81;34;3;31;.912;3600000;0
613;1074;0;0;0;0;0;.00nan;0;0
613;5385;17;0;0;0;0;.00nan;0;0
613;31035;0;86;24;1;23;.958;3600000;0
613;34006;17;83;39;3;36;.923;3565000;0
614;233;29;0;0;0;0;.00nan;0;0
614;4450;5;0;0;0;0;.00nan;0;0
614;18351;29;35;30;5;25;.833;3600000;0
614;19823;5;100;23;0;23;1.000;3600000;0
615;738;27;0;0;0;0;.00nan;0;0
615;1251;14;74;25;1;24;.960;3600000;0
615;25584;14;0;0;0;0;.00nan;0;0
615;26623;27;88;36;2;34;.944;3555000;0
616;61;31;0;0;0;0;.00nan;0;0
616;10103;24;0;0;0;0;.00nan;0;0
616;13979;24;60;24;2;22;.917;3600000;0
616;34797;31;99;45;1;44;.978;3600000;0
617;51;21;75;21;1;20;.952;3600000;0
617;13842;34;0;0;0;0;.00nan;0;0
617;15502;34;77;30;2;28;.933;3566000;0
617;25843;21;0;0;0;0;.00nan;0;0
618;445;12;0;0;0;0;.00nan;0;0
618;2423;15;73;33;3;30;.909;3600000;0
618;4106;15;0;0;0;0;.00nan;0;0
618;34786;12;49;31;5;26;.839;3554000;0
619;262;35;69;41;5;36;.878;3577000;0
619;1430;35;0;0;0;0;.00nan;0;0
619;27739;22;70;28;3;25;.893;3600000;0
619;28026;22;0;0;0;0;.00nan;0;0
620;1572;4838;0;0;0;0;.00nan;0;0
620;2328;4838;77;42;3;39;.929;3600000;0
620;4506;33;100;29;0;29;1.000;3600000;0
620;34740;33;0;0;0;0;.00nan;0;0
621;1614;25;36;24;5;19;.792;3600000;0
621;1821;3;0;0;0;0;.00nan;0;0
621;2054;3;83;32;2;30;.938;3600000;0
621;5182;25;0;0;0;0;.00nan;0;0
622;823;23;0;0;0;0;.00nan;0;0
622;928;20;0;0;0;0;.00nan;0;0
622;10274;23;81;16;0;16;1.000;3600000;0
622;18078;20;62;25;2;23;.920;3554000;0
623;15464;32;0;0;0;0;.00nan;0;0
623;22601;26;0;0;0;0;.00nan;0;0
623;31643;32;95;18;0;18;1.000;3600000;0
623;32754;26;98;51;1;50;.980;3600000;0
624;335;18;0;0;0;0;.00nan;0;0
624;2058;28;0;0;0;0;.00nan;0;0
624;5001;18;57;20;2;18;.900;3600000;0
624;26824;28;56;28;3;25;.893;3557000;0
625;500;4182;70;21;1;20;.952;3600000;0
625;15505;8;0;0;0;0;.00nan;0;0
625;16006;8;91;36;2;34;.944;3547000;0
625;25521;4182;0;0;0;0;.00nan;0;0
626;1913;30;0;0;0;0;.00nan;0;0
626;4826;30;100;36;0;36;1.000;3600000;0
626;18104;10;0;0;0;0;.00nan;0;0
626;27488;10;61;22;2;20;.909;3528000;0
627;323;9;60;30;4;26;.867;3600000;0
627;724;11;88;45;3;42;.933;3600000;0
627;20853;9;0;0;0;0;.00nan;0;0
627;21522;11;0;0;0;0;.00nan;0;0
628;445;12;90;35;2;33;.943;3600000;0
628;1796;16;73;35;3;32;.914;3579000;0
628;14321;16;0;0;0;0;.00nan;0;0
628;34786;12;0;0;0;0;.00nan;0;0
629;1074;0;97;52;2;50;.962;3600000;0
629;13842;34;0;0;0;0;.00nan;0;0
629;15502;34;85;15;0;15;1.000;3600000;0
629;31035;0;0;0;0;0;.00nan;0;0
630;51;21;84;33;3;30;.909;3745000;0
630;233;29;0;0;0;0;.00nan;0;0
630;18351;29;74;29;2;27;.931;3745000;0
630;25843;21;0;0;0;0;.00nan;0;0
631;4450;5;79;16;0;16;1.000;1817000;0
631;19823;5;42;22;4;18;.818;2083000;0
631;27739;22;0;0;0;0;.00nan;0;0
631;28026;22;56;31;4;27;.871;3900000;0
632;262;35;0;0;0;0;.00nan;0;0
632;1430;35;73;27;2;25;.926;3600000;0
632;4506;33;69;32;3;29;.906;3547000;0
632;34740;33;0;0;0;0;.00nan;0;0
633;1572;4838;0;0;0;0;.00nan;0;0
633;1614;25;100;21;0;21;1.000;3600000;0
633;2328;4838;61;38;6;32;.842;3600000;0
633;5182;25;0;0;0;0;.00nan;0;0
634;823;23;0;0;0;0;.00nan;0;0
634;2058;28;100;39;1;38;.974;3900000;0
634;10274;23;82;34;1;33;.971;3900000;0
634;26824;28;0;0;0;0;.00nan;0;0
635;724;11;73;49;5;44;.898;3600000;0
635;18104;10;65;29;3;26;.897;3600000;0
635;21522;11;0;0;0;0;.00nan;0;0
635;27488;10;0;0;0;0;.00nan;0;0
636;233;29;0;0;0;0;.00nan;0;0
636;5385;17;0;0;0;0;.00nan;0;0
636;18351;29;95;21;0;21;1.000;3600000;0
636;34006;17;68;40;4;36;.900;3600000;0
637;61;31;0;0;0;0;.00nan;0;0
637;335;18;0;0;0;0;.00nan;0;0
637;5001;18;83;29;1;28;.966;3600000;0
637;34797;31;49;29;4;25;.862;3600000;0
638;1251;14;0;0;0;0;.00nan;0;0
638;10103;24;69;36;3;33;.917;3600000;0
638;13979;24;0;0;0;0;.00nan;0;0
638;25584;14;78;32;2;30;.938;3600000;0
639;13842;34;79;38;3;35;.921;3900000;0
639;15502;34;0;0;0;0;.00nan;0;0
639;15505;8;0;0;0;0;.00nan;0;0
639;16006;8;88;35;3;32;.914;3900000;0
640;1614;25;65;14;1;13;.929;3600000;0
640;5182;25;0;0;0;0;.00nan;0;0
640;15464;32;0;0;0;0;.00nan;0;0
640;31643;32;80;43;3;40;.930;3584000;0
641;544;19;80;26;1;25;.962;3600000;0
641;928;20;8;23;7;16;.696;2033000;0
641;18078;20;40;19;4;15;.789;1567000;0
641;31124;19;0;0;0;0;.00nan;0;0
642;500;4182;59;19;2;17;.895;3600000;0
642;1821;3;0;0;0;0;.00nan;0;0
642;2054;3;38;28;5;23;.821;3600000;0
642;25521;4182;0;0;0;0;.00nan;0;0
643;1913;30;0;0;0;0;.00nan;0;0
643;2423;15;86;38;3;35;.921;3600000;0
643;4106;15;0;0;0;0;.00nan;0;0
643;4826;30;63;35;4;31;.886;3576000;0
644;323;9;73;33;3;30;.909;3600000;0
644;738;27;62;32;4;28;.875;3561000;0
644;20853;9;0;0;0;0;.00nan;0;0
644;26623;27;0;0;0;0;.00nan;0;0
645;1074;0;93;46;3;43;.935;3558000;0
645;4450;5;0;0;0;0;.00nan;0;0
645;19823;5;69;18;1;17;.944;3600000;0
645;31035;0;0;0;0;0;.00nan;0;0
646;445;12;0;0;0;0;.00nan;0;0
646;1572;4838;0;0;0;0;.00nan;0;0
646;2328;4838;61;21;2;19;.905;3600000;0
646;34786;12;70;32;3;29;.906;3548000;0
647;262;35;0;0;0;0;.00nan;0;0
647;823;23;44;20;3;17;.850;3580000;0
647;1430;35;88;29;2;27;.931;3600000;0
647;10274;23;0;0;0;0;.00nan;0;0
648;1821;3;80;37;3;34;.919;3600000;0
648;2054;3;0;0;0;0;.00nan;0;0
648;22601;26;0;0;0;0;.00nan;0;0
648;32754;26;55;34;5;29;.853;3517000;0
649;1251;14;0;0;0;0;.00nan;0;0
649;4450;5;94;35;1;34;.971;3600000;0
649;19823;5;0;0;0;0;.00nan;0;0
649;25584;14;49;16;2;14;.875;3600000;0
650;323;9;47;36;6;30;.833;2612000;0
650;4506;33;90;17;0;17;1.000;3600000;0
650;20853;9;60;8;0;8;1.000;988000;0
650;34740;33;0;0;0;0;.00nan;0;0
651;233;29;0;0;0;0;.00nan;0;0
651;335;18;0;0;0;0;.00nan;0;0
651;5001;18;100;32;0;32;1.000;3600000;0
651;18351;29;88;26;1;25;.962;3566000;0
652;51;21;99;26;0;26;1.000;3600000;0
652;928;20;0;0;0;0;.00nan;0;0
652;18078;20;63;24;2;22;.917;3534000;0
652;25843;21;0;0;0;0;.00nan;0;0
653;10103;24;80;33;2;31;.939;3600000;0
653;13842;34;77;48;5;43;.896;3600000;0
653;13979;24;0;0;0;0;.00nan;0;0
653;15502;34;0;0;0;0;.00nan;0;0
654;1074;0;0;0;0;0;.00nan;0;0
654;15505;8;0;0;0;0;.00nan;0;0
654;16006;8;62;35;4;31;.886;3543000;0
654;31035;0;77;36;3;33;.917;3600000;0
655;1572;4838;0;0;0;0;.00nan;0;0
655;1796;16;77;23;1;22;.957;3600000;0
655;2328;4838;66;26;2;24;.923;3596000;0
655;14321;16;0;0;0;0;.00nan;0;0
656;5385;17;0;0;0;0;.00nan;0;0
656;15464;32;0;0;0;0;.00nan;0;0
656;31643;32;88;39;3;36;.923;3600000;0
656;34006;17;37;21;4;17;.810;3557000;0
657;544;19;0;0;0;0;.00nan;0;0
657;2058;28;0;0;0;0;.00nan;0;0
657;26824;28;69;24;2;22;.917;3900000;0
657;31124;19;83;33;2;31;.939;3900000;0
658;724;11;22;25;6;19;.760;2472000;0
658;2423;15;99;34;2;32;.941;3600000;0
658;4106;15;0;0;0;0;.00nan;0;0
658;21522;11;50;10;1;9;.900;1128000;0
659;738;27;0;0;0;0;.00nan;0;0
659;18104;10;64;35;4;31;.886;3734000;0
659;26623;27;85;37;3;34;.919;3734000;0
659;27488;10;0;0;0;0;.00nan;0;0
660;61;31;0;0;0;0;.00nan;0;0
660;445;12;0;0;0;0;.00nan;0;0
660;34786;12;71;45;5;40;.889;3600000;0
660;34797;31;88;37;2;35;.946;3600000;0
661;262;35;0;0;0;0;.00nan;0;0
661;1430;35;73;17;1;16;.941;3600000;0
661;1913;30;0;0;0;0;.00nan;0;0
661;4826;30;98;56;4;52;.929;3600000;0
662;1614;25;88;26;1;25;.962;3600000;0
662;5182;25;0;0;0;0;.00nan;0;0
662;22601;26;0;0;0;0;.00nan;0;0
662;32754;26;57;23;2;21;.913;3591000;0
663;500;4182;71;29;3;26;.897;3600000;0
663;823;23;82;50;5;45;.900;3547000;0
663;10274;23;0;0;0;0;.00nan;0;0
663;25521;4182;0;0;0;0;.00nan;0;0
664;4450;5;0;0;0;0;.00nan;0;0
664;15464;32;0;0;0;0;.00nan;0;0
664;19823;5;62;23;3;20;.870;3600000;0
664;31643;32;61;37;5;32;.865;3549000;0
665;51;21;89;42;3;39;.929;3600000;0
665;1074;0;100;35;0;35;1.000;3600000;0
665;25843;21;0;0;0;0;.00nan;0;0
665;31035;0;0;0;0;0;.00nan;0;0
666;323;9;90;29;1;28;.966;3600000;0
666;5385;17;0;0;0;0;.00nan;0;0
666;20853;9;0;0;0;0;.00nan;0;0
666;34006;17;98;44;2;42;.955;3600000;0
667;233;29;0;0;0;0;.00nan;0;0
667;445;12;65;24;2;22;.917;3600000;0
667;18351;29;67;40;4;36;.900;3562000;0
667;34786;12;0;0;0;0;.00nan;0;0
668;61;31;62;27;3;24;.889;3600000;0
668;13842;34;60;36;5;31;.861;3541000;0
668;15502;34;0;0;0;0;.00nan;0;0
668;34797;31;0;0;0;0;.00nan;0;0
669;928;20;0;0;0;0;.00nan;0;0
669;18078;20;43;25;4;21;.840;3521000;0
669;27739;22;0;0;0;0;.00nan;0;0
669;28026;22;80;34;2;32;.941;3600000;0
670;1251;14;42;28;5;23;.821;2371000;0
670;18104;10;36;30;6;24;.800;3759000;0
670;25584;14;47;12;2;10;.833;1388000;0
670;27488;10;0;0;0;0;.00nan;0;0
671;335;18;0;0;0;0;.00nan;0;0
671;5001;18;64;38;4;34;.895;3703000;0
671;10103;24;51;30;5;25;.833;3703000;0
671;13979;24;0;0;0;0;.00nan;0;0
672;1913;30;23;21;5;16;.762;2349000;0
672;4826;30;66;11;0;11;1.000;1251000;0
672;15505;8;0;0;0;0;.00nan;0;0
672;16006;8;60;34;4;30;.882;3600000;0
673;1796;16;94;35;1;34;.971;3600000;0
673;1821;3;48;25;3;22;.880;3513000;0
673;2054;3;0;0;0;0;.00nan;0;0
673;14321;16;0;0;0;0;.00nan;0;0
674;2058;28;0;0;0;0;.00nan;0;0
674;4506;33;64;26;3;23;.885;3637000;0
674;26824;28;84;45;4;41;.911;3637000;0
674;34740;33;0;0;0;0;.00nan;0;0
675;500;4182;0;0;0;0;.00nan;0;0
675;544;19;0;0;0;0;.00nan;0;0
675;25521;4182;99;44;3;41;.932;3600000;0
675;31124;19;45;27;5;22;.815;3516000;0
676;1614;25;0;0;0;0;.00nan;0;0
676;5182;25;58;12;1;11;.917;3600000;0
676;22601;26;83;32;2;30;.938;3573000;0
676;32754;26;0;0;0;0;.00nan;0;0
677;738;27;0;0;0;0;.00nan;0;0
677;2423;15;66;33;4;29;.879;3600000;0
677;4106;15;0;0;0;0;.00nan;0;0
677;26623;27;86;29;1;28;.966;3600000;0
678;724;11;42;33;6;27;.818;3600000;0
678;1572;4838;80;37;3;34;.919;3600000;0
678;2328;4838;0;0;0;0;.00nan;0;0
678;21522;11;0;0;0;0;.00nan;0;0
679;335;18;0;0;0;0;.00nan;0;0
679;5001;18;57;45;6;39;.867;3600000;0
679;27739;22;80;28;1;27;.964;3600000;0
679;28026;22;0;0;0;0;.00nan;0;0
680;823;23;80;37;3;34;.919;3678000;0
680;4506;33;0;0;0;0;.00nan;0;0
680;10274;23;0;0;0;0;.00nan;0;0
680;34740;33;80;38;4;34;.895;3678000;0
681;323;9;68;21;1;20;.952;3600000;0
681;5385;17;0;0;0;0;.00nan;0;0
681;20853;9;0;0;0;0;.00nan;0;0
681;34006;17;59;33;4;29;.879;3600000;0
682;51;21;100;33;1;32;.970;3600000;0
682;1821;3;0;0;0;0;.00nan;0;0
682;2054;3;58;17;2;15;.882;3547000;0
682;25843;21;0;0;0;0;.00nan;0;0
683;928;20;82;42;3;39;.929;3900000;0
683;1251;14;0;0;0;0;.00nan;0;0
683;18078;20;0;0;0;0;.00nan;0;0
683;25584;14;59;29;3;26;.897;3900000;0
684;1796;16;84;29;1;28;.966;3600000;0
684;14321;16;0;0;0;0;.00nan;0;0
684;15464;32;19;24;6;18;.750;2334000;0
684;31643;32;29;15;4;11;.733;1266000;0
685;1430;35;79;28;1;27;.964;3600000;0
685;1614;25;73;36;3;33;.917;3544000;0
685;5048;35;0;0;0;0;.00nan;0;0
685;5182;25;0;0;0;0;.00nan;0;0
686;1074;0;77;30;2;28;.933;3600000;0
686;22601;26;81;39;3;36;.923;3558000;0
686;31035;0;0;0;0;0;.00nan;0;0
686;32754;26;0;0;0;0;.00nan;0;0
687;500;4182;99;51;2;49;.961;3831000;0
687;2423;15;71;30;3;27;.900;3831000;0
687;4106;15;0;0;0;0;.00nan;0;0
687;25521;4182;0;0;0;0;.00nan;0;0
688;724;11;62;33;3;30;.909;3515000;0
688;738;27;76;16;1;15;.938;3600000;0
688;21522;11;0;0;0;0;.00nan;0;0
688;26623;27;0;0;0;0;.00nan;0;0
689;1572;4838;83;32;2;30;.938;3600000;0
689;2328;4838;0;0;0;0;.00nan;0;0
689;15505;8;0;0;0;0;.00nan;0;0
689;16006;8;60;38;4;34;.895;3578000;0
690;4450;5;0;0;0;0;.00nan;0;0
690;10103;24;100;51;3;48;.941;3600000;0
690;13979;24;0;0;0;0;.00nan;0;0
690;19823;5;47;24;4;20;.833;3568000;0
691;2058;28;62;35;4;31;.886;3600000;0
691;5385;17;30;28;6;22;.786;3574000;0
691;26824;28;0;0;0;0;.00nan;0;0
691;34006;17;0;0;0;0;.00nan;0;0
692;928;20;0;0;0;0;.00nan;0;0
692;13842;34;0;0;0;0;.00nan;0;0
692;15502;34;10;26;7;19;.731;3600000;0
692;18078;20;51;33;4;29;.879;3600000;0
693;323;9;0;0;0;0;.00nan;0;0
693;1251;14;76;32;2;30;.938;3600000;0
693;20853;9;69;32;3;29;.906;3557000;0
693;25584;14;0;0;0;0;.00nan;0;0
694;4506;33;72;19;1;18;.947;3900000;0
694;27739;22;0;0;0;0;.00nan;0;0
694;28026;22;85;35;1;34;.971;3900000;0
694;34740;33;0;0;0;0;.00nan;0;0
695;335;18;0;0;0;0;.00nan;0;0
695;5001;18;52;25;3;22;.880;3582000;0
695;15464;32;0;0;0;0;.00nan;0;0
695;31643;32;82;27;1;26;.963;3600000;0
696;445;12;0;0;0;0;.00nan;0;0
696;1074;0;69;37;4;33;.892;3576000;0
696;31035;0;0;0;0;0;.00nan;0;0
696;34786;12;63;26;3;23;.885;3600000;0
697;61;31;0;0;0;0;.00nan;0;0
697;544;19;0;0;0;0;.00nan;0;0
697;31124;19;73;29;3;26;.897;3676000;0
697;34797;31;93;46;4;42;.913;3676000;0
698;823;23;82;31;2;29;.935;3600000;0
698;10274;23;0;0;0;0;.00nan;0;0
698;15505;8;0;0;0;0;.00nan;0;0
698;16006;8;39;34;6;28;.824;3600000;0
699;233;29;0;0;0;0;.00nan;0;0
699;724;11;0;0;0;0;.00nan;0;0
699;18351;29;100;27;0;27;1.000;3600000;0
699;21522;11;38;32;6;26;.813;3600000;0
700;51;21;0;0;0;0;.00nan;0;0
700;22601;26;0;0;0;0;.00nan;0;0
700;25843;21;80;29;2;27;.931;3600000;0
700;32754;26;56;25;3;22;.880;3556000;0
701;1821;3;0;0;0;0;.00nan;0;0
701;2054;3;73;25;2;23;.920;3600000;0
701;18104;10;0;0;0;0;.00nan;0;0
701;27488;10;54;30;4;26;.867;3547000;0
702;1614;25;69;24;2;22;.917;3600000;0
702;1913;30;0;0;0;0;.00nan;0;0
702;4826;30;49;33;5;28;.848;3600000;0
702;5182;25;0;0;0;0;.00nan;0;0
703;4450;5;0;0;0;0;.00nan;0;0
703;19823;5;68;25;2;23;.920;3600000;0
703;27739;22;0;0;0;0;.00nan;0;0
703;28026;22;62;30;3;27;.900;3569000;0
704;445;12;44;28;5;23;.821;3600000;0
704;5385;17;55;5;0;5;1.000;389000;0
704;34006;17;72;49;6;43;.878;3200000;0
704;34786;12;0;0;0;0;.00nan;0;0
705;1251;14;0;0;0;0;.00nan;0;0
705;13842;34;81;43;4;39;.907;3900000;0
705;15502;34;0;0;0;0;.00nan;0;0
705;25584;14;59;34;4;30;.882;3900000;0
706;2058;28;58;32;4;28;.875;3600000;0
706;2423;15;88;27;1;26;.963;3600000;0
706;4106;15;0;0;0;0;.00nan;0;0
706;26824;28;0;0;0;0;.00nan;0;0
707;4506;33;75;35;4;31;.886;3600000;0
707;15464;32;0;0;0;0;.00nan;0;0
707;31643;32;57;27;3;24;.889;3600000;0
707;34740;33;0;0;0;0;.00nan;0;0
708;61;31;0;0;0;0;.00nan;0;0
708;823;23;59;25;3;22;.880;3547000;0
708;10274;23;0;0;0;0;.00nan;0;0
708;34797;31;99;45;2;43;.956;3600000;0
709;500;4182;70;27;2;25;.926;3566000;0
709;1074;0;92;39;1;38;.974;3600000;0
709;25521;4182;0;0;0;0;.00nan;0;0
709;31035;0;0;0;0;0;.00nan;0;0
710;724;11;30;26;6;20;.769;2708000;0
710;1614;25;0;0;0;0;.00nan;0;0
710;5182;25;84;34;1;33;.971;3600000;0
710;21522;11;68;12;0;12;1.000;892000;0
711;738;27;0;0;0;0;.00nan;0;0
711;1572;4838;0;0;0;0;.00nan;0;0
711;2328;4838;63;32;3;29;.906;3563000;0
711;26623;27;76;21;1;20;.952;3600000;0
712;323;9;90;42;2;40;.952;3548000;0
712;445;12;0;0;0;0;.00nan;0;0
712;20853;9;0;0;0;0;.00nan;0;0
712;34786;12;95;34;1;33;.971;3600000;0
713;928;20;0;0;0;0;.00nan;0;0
713;18078;20;100;25;0;25;1.000;3600000;0
713;22601;26;88;33;2;31;.939;3559000;0
713;32754;26;0;0;0;0;.00nan;0;0
714;10103;24;68;47;5;42;.894;3600000;0
714;13979;24;0;0;0;0;.00nan;0;0
714;18104;10;86;29;1;28;.966;3600000;0
714;27488;10;0;0;0;0;.00nan;0;0
715;2423;15;0;0;0;0;.00nan;0;0
715;4106;15;88;27;1;26;.963;3600000;0
715;13842;34;0;0;0;0;.00nan;0;0
715;15502;34;55;36;5;31;.861;3600000;0
716;1430;35;80;32;2;30;.938;3600000;0
716;5048;35;0;0;0;0;.00nan;0;0
716;15505;8;55;28;3;25;.893;3600000;0
716;16006;8;0;0;0;0;.00nan;0;0
717;61;31;92;51;4;47;.922;3755000;0
717;335;18;67;32;3;29;.906;3755000;0
717;5001;18;0;0;0;0;.00nan;0;0
717;34797;31;0;0;0;0;.00nan;0;0
718;233;29;0;0;0;0;.00nan;0;0
718;1913;30;0;0;0;0;.00nan;0;0
718;4826;30;72;26;3;23;.885;3777000;0
718;18351;29;94;39;2;37;.949;3777000;0
719;1572;4838;76;30;2;28;.933;3600000;0
719;1796;16;68;33;3;30;.909;3562000;0
719;2328;4838;0;0;0;0;.00nan;0;0
719;14321;16;0;0;0;0;.00nan;0;0
720;4450;5;0;0;0;0;.00nan;0;0
720;4506;33;92;31;1;30;.968;3600000;0
720;19823;5;56;29;4;25;.862;3600000;0
720;34740;33;0;0;0;0;.00nan;0;0
721;1251;14;65;22;2;20;.909;3600000;0
721;5385;17;0;0;0;0;.00nan;0;0
721;25584;14;0;0;0;0;.00nan;0;0
721;34006;17;67;51;6;45;.882;3600000;0
722;928;20;0;0;0;0;.00nan;0;0
722;1821;3;92;29;1;28;.966;3600000;0
722;2054;3;0;0;0;0;.00nan;0;0
722;18078;20;96;42;2;40;.952;3574000;0
723;51;21;95;28;0;28;1.000;3900000;0
723;10103;24;100;38;0;38;1.000;3900000;0
723;13979;24;0;0;0;0;.00nan;0;0
723;25843;21;0;0;0;0;.00nan;0;0
724;18104;10;0;0;0;0;.00nan;0;0
724;22601;26;0;0;0;0;.00nan;0;0
724;27488;10;36;23;4;19;.826;3553000;0
724;32754;26;79;41;3;38;.927;3600000;0
725;2058;28;100;45;0;45;1.000;3900000;0
725;26824;28;0;0;0;0;.00nan;0;0
725;27739;22;0;0;0;0;.00nan;0;0
725;28026;22;86;24;0;24;1.000;3900000;0
726;323;9;0;0;0;0;.00nan;0;0
726;15464;32;0;0;0;0;.00nan;0;0
726;20853;9;81;41;3;38;.927;3534000;0
726;31643;32;68;19;1;18;.947;3600000;0
727;1430;35;88;26;1;25;.962;3600000;0
727;5048;35;0;0;0;0;.00nan;0;0
727;15505;8;0;0;0;0;.00nan;0;0
727;16006;8;97;32;2;30;.938;3564000;0
728;1074;0;85;27;1;26;.963;3600000;0
728;1614;25;47;33;5;28;.848;3600000;0
728;5182;25;0;0;0;0;.00nan;0;0
728;31035;0;0;0;0;0;.00nan;0;0
729;544;19;0;0;0;0;.00nan;0;0
729;823;23;28;27;6;21;.778;2194000;0
729;10274;23;67;9;0;9;1.000;1406000;0
729;31124;19;71;38;3;35;.921;3600000;0
730;233;29;0;0;0;0;.00nan;0;0
730;738;27;0;0;0;0;.00nan;0;0
730;18351;29;89;41;2;39;.951;3551000;0
730;26623;27;94;28;1;27;.964;3600000;0
731;51;21;72;27;3;24;.889;3570000;0
731;724;11;96;26;1;25;.962;3600000;0
731;21522;11;0;0;0;0;.00nan;0;0
731;25843;21;0;0;0;0;.00nan;0;0
732;2423;15;55;26;3;23;.885;3600000;0
732;4106;15;0;0;0;0;.00nan;0;0
732;4506;33;68;46;5;41;.891;3521000;0
732;34740;33;0;0;0;0;.00nan;0;0
733;2058;28;94;43;2;41;.953;3600000;0
733;13842;34;0;0;0;0;.00nan;0;0
733;15502;34;37;24;4;20;.833;3551000;0
733;26824;28;0;0;0;0;.00nan;0;0
734;335;18;0;0;0;0;.00nan;0;0
734;1796;16;80;42;3;39;.929;3900000;0
734;5001;18;82;41;3;38;.927;3900000;0
734;14321;16;0;0;0;0;.00nan;0;0
735;61;31;0;0;0;0;.00nan;0;0
735;1572;4838;100;47;2;45;.957;3900000;0
735;2328;4838;0;0;0;0;.00nan;0;0
735;34797;31;70;28;2;26;.929;3900000;0
736;1913;30;0;0;0;0;.00nan;0;0
736;4450;5;0;0;0;0;.00nan;0;0
736;4826;30;85;49;4;45;.918;3558000;0
736;19823;5;53;24;3;21;.875;3600000;0
737;724;11;0;0;0;0;.00nan;0;0
737;18104;10;0;0;0;0;.00nan;0;0
737;21522;11;52;34;5;29;.853;3600000;0
737;27488;10;56;28;4;24;.857;3600000;0
738;445;12;0;0;0;0;.00nan;0;0
738;1251;14;0;0;0;0;.00nan;0;0
738;25584;14;86;37;2;35;.946;3900000;0
738;34786;12;78;30;2;28;.933;3900000;0
739;500;4182;85;32;1;31;.969;3774000;0
739;25521;4182;0;0;0;0;.00nan;0;0
739;27739;22;0;0;0;0;.00nan;0;0
739;28026;22;80;27;2;25;.926;3774000;0
740;1074;0;82;29;1;28;.966;3900000;0
740;1430;35;90;25;1;24;.960;3900000;0
740;5048;35;0;0;0;0;.00nan;0;0
740;31035;0;0;0;0;0;.00nan;0;0
741;1614;25;82;22;1;21;.955;3900000;0
741;5182;25;0;0;0;0;.00nan;0;0
741;15505;8;0;0;0;0;.00nan;0;0
741;16006;8;95;46;1;45;.978;3900000;0
742;544;19;0;0;0;0;.00nan;0;0
742;1796;16;0;0;0;0;.00nan;0;0
742;14321;16;36;21;4;17;.810;3546000;0
742;31124;19;70;30;2;28;.933;3600000;0
743;2058;28;0;0;0;0;.00nan;0;0
743;5385;17;0;0;0;0;.00nan;0;0
743;26824;28;53;20;3;17;.850;3555000;0
743;34006;17;73;28;2;26;.929;3600000;0
744;51;21;68;30;3;27;.900;3600000;0
744;445;12;39;29;5;24;.828;3528000;0
744;25843;21;0;0;0;0;.00nan;0;0
744;34786;12;0;0;0;0;.00nan;0;0
745;928;20;0;0;0;0;.00nan;0;0
745;1251;14;91;31;2;29;.935;3900000;0
745;18078;20;89;35;2;33;.943;3900000;0
745;25584;14;0;0;0;0;.00nan;0;0
746;2423;15;58;37;4;33;.892;3548000;0
746;4106;15;0;0;0;0;.00nan;0;0
746;22601;26;0;0;0;0;.00nan;0;0
746;32754;26;92;43;2;41;.953;3600000;0
747;500;4182;0;0;0;0;.00nan;0;0
747;10103;24;79;31;2;29;.935;3600000;0
747;13979;24;0;0;0;0;.00nan;0;0
747;25521;4182;76;33;3;30;.909;3600000;0
748;61;31;0;0;0;0;.00nan;0;0
748;4506;33;86;29;1;28;.966;3600000;0
748;34740;33;0;0;0;0;.00nan;0;0
748;34797;31;63;27;3;24;.889;3560000;0
749;335;18;0;0;0;0;.00nan;0;0
749;823;23;83;29;1;28;.966;3900000;0
749;5001;18;82;26;1;25;.962;3900000;0
749;10274;23;0;0;0;0;.00nan;0;0
750;1572;4838;0;0;0;0;.00nan;0;0
750;2328;4838;82;34;3;31;.912;3600000;0
750;15464;32;44;4;1;3;.750;1035000;0
750;31643;32;24;28;7;21;.750;2565000;0
751;1821;3;0;0;0;0;.00nan;0;0
751;1913;30;92;45;3;42;.933;3835000;0
751;2054;3;64;24;2;22;.917;3835000;0
751;4826;30;0;0;0;0;.00nan;0;0
752;323;9;65;21;2;19;.905;3900000;0
752;15505;8;0;0;0;0;.00nan;0;0
752;16006;8;89;41;2;39;.951;3900000;0
752;20853;9;0;0;0;0;.00nan;0;0
753;738;27;0;0;0;0;.00nan;0;0
753;26623;27;100;32;0;32;1.000;3600000;0
753;27739;22;0;0;0;0;.00nan;0;0
753;28026;22;72;24;3;21;.875;3600000;0
754;544;19;0;0;0;0;.00nan;0;0
754;13842;34;0;0;0;0;.00nan;0;0
754;15502;34;58;38;4;34;.895;3600000;0
754;31124;19;96;30;1;29;.967;3600000;0
755;1614;25;22;10;4;6;.600;695000;0
755;4450;5;0;0;0;0;.00nan;0;0
755;5182;25;39;24;4;20;.833;2905000;0
755;19823;5;99;45;2;43;.956;3600000;0
756;1074;0;0;0;0;0;.00nan;0;0
756;1913;30;0;0;0;0;.00nan;0;0
756;4826;30;86;41;4;37;.902;3774000;0
756;31035;0;81;34;3;31;.912;3774000;0
757;2058;28;0;0;0;0;.00nan;0;0
757;10103;24;74;33;3;30;.909;3600000;0
757;13979;24;0;0;0;0;.00nan;0;0
757;26824;28;58;32;4;28;.875;3566000;0
758;51;21;84;31;2;29;.935;3600000;0
758;233;29;0;0;0;0;.00nan;0;0
758;18351;29;77;33;3;30;.909;3557000;0
758;25843;21;0;0;0;0;.00nan;0;0
759;61;31;0;0;0;0;.00nan;0;0
759;500;4182;58;34;5;29;.853;3733000;0
759;25521;4182;0;0;0;0;.00nan;0;0
759;34797;31;77;38;4;34;.895;3751000;0
760;724;11;0;0;0;0;.00nan;0;0
760;928;20;0;0;0;0;.00nan;0;0
760;18078;20;58;33;4;29;.879;3762000;0
760;21522;11;58;30;3;27;.900;3762000;0
761;1572;4838;0;0;0;0;.00nan;0;0
761;2328;4838;58;35;4;31;.886;3600000;0
761;2423;15;40;25;5;20;.800;3600000;0
761;4106;15;0;0;0;0;.00nan;0;0
762;13842;34;98;53;2;51;.962;3900000;0
762;15502;34;0;0;0;0;.00nan;0;0
762;18104;10;0;0;0;0;.00nan;0;0
762;27488;10;85;28;2;26;.929;3900000;0
763;544;19;74;50;5;45;.900;3600000;0
763;1796;16;67;28;2;26;.929;3600000;0
763;14321;16;0;0;0;0;.00nan;0;0
763;31124;19;0;0;0;0;.00nan;0;0
764;335;18;0;0;0;0;.00nan;0;0
764;4506;33;90;30;1;29;.967;3561000;0
764;5001;18;100;37;0;37;1.000;3600000;0
764;34740;33;0;0;0;0;.00nan;0;0
765;823;23;73;22;2;20;.909;3900000;0
765;10274;23;0;0;0;0;.00nan;0;0
765;15464;32;0;0;0;0;.00nan;0;0
765;31643;32;100;55;2;53;.964;3900000;0
766;262;35;44;33;5;28;.848;3582000;0
766;1430;35;0;0;0;0;.00nan;0;0
766;18104;10;73;33;3;30;.909;3600000;0
766;27488;10;0;0;0;0;.00nan;0;0
767;323;9;0;0;0;0;.00nan;0;0
767;2423;15;0;0;0;0;.00nan;0;0
767;4106;15;75;17;1;16;.941;3600000;0
767;20853;9;63;39;4;35;.897;3600000;0
768;1614;25;77;25;2;23;.920;3600000;0
768;5182;25;0;0;0;0;.00nan;0;0
768;15505;8;0;0;0;0;.00nan;0;0
768;16006;8;52;26;3;23;.885;3559000;0
769;445;12;0;0;0;0;.00nan;0;0
769;27739;22;0;0;0;0;.00nan;0;0
769;28026;22;84;26;2;24;.923;3900000;0
769;34786;12;86;31;2;29;.935;3900000;0
770;4450;5;0;0;0;0;.00nan;0;0
770;19823;5;83;27;2;25;.926;3900000;0
770;22601;26;93;39;2;37;.949;3900000;0
770;32754;26;0;0;0;0;.00nan;0;0
771;823;23;64;31;3;28;.903;3600000;0
771;1074;0;48;25;4;21;.840;3577000;0
771;10274;23;0;0;0;0;.00nan;0;0
771;31035;0;0;0;0;0;.00nan;0;0
772;1913;30;92;54;5;49;.907;3600000;0
772;2058;28;41;18;4;14;.778;3600000;0
772;4826;30;0;0;0;0;.00nan;0;0
772;26824;28;0;0;0;0;.00nan;0;0
773;323;9;89;31;1;30;.968;3600000;0
773;1821;3;71;34;3;31;.912;3529000;0
773;2054;3;0;0;0;0;.00nan;0;0
773;20853;9;0;0;0;0;.00nan;0;0
774;233;29;30;33;6;27;.818;3600000;0
774;500;4182;87;38;3;35;.921;3600000;0
774;18351;29;0;0;0;0;.00nan;0;0
774;25521;4182;0;0;0;0;.00nan;0;0
775;61;31;0;0;0;0;.00nan;0;0
775;738;27;0;0;0;0;.00nan;0;0
775;26623;27;24;31;6;25;.806;3600000;0
775;34797;31;69;31;3;28;.903;3600000;0
776;928;20;0;0;0;0;.00nan;0;0
776;1572;4838;0;0;0;0;.00nan;0;0
776;2328;4838;66;14;1;13;.929;3600000;0
776;18078;20;72;33;3;30;.909;3561000;0
777;724;11;76;34;3;31;.912;3514000;0
777;1251;14;0;0;0;0;.00nan;0;0
777;21522;11;0;0;0;0;.00nan;0;0
777;25584;14;82;26;1;25;.962;3600000;0
778;51;21;94;40;2;38;.950;3900000;0
778;10103;24;65;22;2;20;.909;3900000;0
778;13979;24;0;0;0;0;.00nan;0;0
778;25843;21;0;0;0;0;.00nan;0;0
779;1796;16;98;41;1;40;.976;3562000;0
779;4506;33;100;27;0;27;1.000;3600000;0
779;14321;16;0;0;0;0;.00nan;0;0
779;34740;33;0;0;0;0;.00nan;0;0
780;335;18;0;0;0;0;.00nan;0;0
780;544;19;0;0;0;0;.00nan;0;0
780;5001;18;61;32;4;28;.875;3900000;0
780;31124;19;46;29;4;25;.862;3900000;0
781;5385;17;0;0;0;0;.00nan;0;0
781;22601;26;0;0;0;0;.00nan;0;0
781;32754;26;82;24;1;23;.958;3600000;0
781;34006;17;60;24;2;22;.917;3542000;0
782;1074;0;0;0;0;0;.00nan;0;0
782;13842;34;0;0;0;0;.00nan;0;0
782;15502;34;90;22;0;22;1.000;3600000;0
782;31035;0;44;38;6;32;.842;3600000;0
783;262;35;88;39;2;37;.949;3572000;0
783;928;20;90;33;1;32;.970;3600000;0
783;1430;35;0;0;0;0;.00nan;0;0
783;18078;20;0;0;0;0;.00nan;0;0
784;1572;4838;62;40;5;35;.875;3600000;0
784;2328;4838;0;0;0;0;.00nan;0;0
784;18104;10;0;0;0;0;.00nan;0;0
784;27488;10;57;17;2;15;.882;3600000;0
785;724;11;0;0;0;0;.00nan;0;0
785;2423;15;30;27;6;21;.778;2299000;0
785;4106;15;23;4;3;1;.250;1301000;0
785;21522;11;58;33;4;29;.879;3600000;0
786;738;27;34;14;4;10;.714;1049000;0
786;10103;24;0;0;0;0;.00nan;0;0
786;13979;24;43;23;4;19;.826;3600000;0
786;26623;27;80;34;3;31;.912;2551000;0
787;1796;16;0;0;0;0;.00nan;0;0
787;14321;16;52;32;5;27;.844;3600000;0
787;15505;8;0;0;0;0;.00nan;0;0
787;16006;8;84;35;2;33;.943;3600000;0
788;445;12;0;0;0;0;.00nan;0;0
788;4450;5;0;0;0;0;.00nan;0;0
788;19823;5;48;26;5;21;.808;3565000;0
788;34786;12;83;42;4;38;.905;3600000;0
789;1614;25;66;26;3;23;.885;3600000;0
789;5182;25;0;0;0;0;.00nan;0;0
789;5385;17;56;32;4;28;.875;3584000;0
789;34006;17;0;0;0;0;.00nan;0;0
790;823;23;50;28;4;24;.857;3533000;0
790;2058;28;90;42;2;40;.952;3600000;0
790;10274;23;0;0;0;0;.00nan;0;0
790;26824;28;0;0;0;0;.00nan;0;0
791;323;9;54;29;4;25;.862;3593000;0
791;1913;30;0;0;0;0;.00nan;0;0
791;4826;30;80;36;2;34;.944;3600000;0
791;20853;9;0;0;0;0;.00nan;0;0
792;61;31;40;3;1;2;.667;594000;0
792;13842;34;81;25;1;24;.960;3600000;0
792;15502;34;0;0;0;0;.00nan;0;0
792;34797;31;28;24;6;18;.750;3006000;0
793;335;18;0;0;0;0;.00nan;0;0
793;5001;18;99;37;1;36;.973;3600000;0
793;15505;8;60;33;4;29;.879;3600000;0
793;16006;8;0;0;0;0;.00nan;0;0
794;1572;4838;0;0;0;0;.00nan;0;0
794;2328;4838;64;35;4;31;.886;3600000;0
794;4450;5;0;0;0;0;.00nan;0;0
794;19823;5;78;22;1;21;.955;3600000;0
795;1074;0;67;46;5;41;.891;3074000;0
795;1796;16;59;16;2;14;.875;3600000;0
795;14321;16;0;0;0;0;.00nan;0;0
795;31035;0;58;10;1;9;.900;526000;0
796;233;29;0;0;0;0;.00nan;0;0
796;738;27;77;36;3;33;.917;3545000;0
796;18351;29;70;25;2;23;.920;3600000;0
796;26623;27;0;0;0;0;.00nan;0;0
797;51;21;100;30;0;30;1.000;3600000;0
797;1821;3;0;0;0;0;.00nan;0;0
797;2054;3;73;39;4;35;.897;3600000;0
797;25843;21;0;0;0;0;.00nan;0;0
798;928;20;0;0;0;0;.00nan;0;0
798;2058;28;0;0;0;0;.00nan;0;0
798;18078;20;55;28;3;25;.893;3600000;0
798;26824;28;52;27;4;23;.852;3600000;0
799;61;31;78;39;3;36;.923;3644000;0
799;18104;10;0;0;0;0;.00nan;0;0
799;27488;10;68;24;2;22;.917;3644000;0
799;34797;31;0;0;0;0;.00nan;0;0
800;1251;14;68;37;4;33;.892;3900000;0
800;4506;33;49;25;4;21;.840;3900000;0
800;25584;14;0;0;0;0;.00nan;0;0
800;34740;33;0;0;0;0;.00nan;0;0
801;2423;15;63;37;4;33;.892;3600000;0
801;4106;15;0;0;0;0;.00nan;0;0
801;27739;22;0;0;0;0;.00nan;0;0
801;28026;22;57;35;5;30;.857;3579000;0
802;335;18;0;0;0;0;.00nan;0;0
802;5001;18;81;35;2;33;.943;3600000;0
802;15464;32;0;0;0;0;.00nan;0;0
802;31643;32;74;36;3;33;.917;3571000;0
803;445;12;0;0;0;0;.00nan;0;0
803;544;19;0;0;0;0;.00nan;0;0
803;31124;19;67;22;2;20;.909;3600000;0
803;34786;12;67;37;4;33;.892;3573000;0
804;1614;25;76;28;2;26;.929;3600000;0
804;5182;25;0;0;0;0;.00nan;0;0
804;22601;26;0;0;0;0;.00nan;0;0
804;32754;26;97;51;3;48;.941;3577000;0
805;500;4182;49;22;3;19;.864;3824000;0
805;5385;17;0;0;0;0;.00nan;0;0
805;25521;4182;0;0;0;0;.00nan;0;0
805;34006;17;97;41;2;39;.951;3824000;0
806;323;9;78;35;2;33;.943;3600000;0
806;724;11;20;22;6;16;.727;2638000;0
806;20853;9;0;0;0;0;.00nan;0;0
806;21522;11;52;4;0;4;1.000;962000;0
807;823;23;68;38;4;34;.895;3600000;0
807;10274;23;0;0;0;0;.00nan;0;0
807;27739;22;100;23;0;23;1.000;3600000;0
807;28026;22;0;0;0;0;.00nan;0;0
808;262;35;0;0;0;0;.00nan;0;0
808;1430;35;81;28;1;27;.964;3600000;0
808;15505;8;37;7;2;5;.714;1587000;0
808;16006;8;47;29;5;24;.828;2013000;0
809;544;19;64;32;4;28;.875;3600000;0
809;22601;26;61;39;5;34;.872;3552000;0
809;31124;19;0;0;0;0;.00nan;0;0
809;32754;26;0;0;0;0;.00nan;0;0
810;323;9;99;34;1;33;.971;3600000;0
810;1251;14;0;0;0;0;.00nan;0;0
810;20853;9;0;0;0;0;.00nan;0;0
810;25584;14;42;28;5;23;.821;3600000;0
811;233;29;0;0;0;0;.00nan;0;0
811;823;23;73;24;1;23;.958;3600000;0
811;10274;23;0;0;0;0;.00nan;0;0
811;18351;29;76;44;5;39;.886;3600000;0
812;445;12;0;0;0;0;.00nan;0;0
812;4506;33;79;23;1;22;.957;3600000;0
812;34740;33;0;0;0;0;.00nan;0;0
812;34786;12;85;31;2;29;.935;3545000;0
813;724;11;0;0;0;0;.00nan;0;0
813;21522;11;57;25;3;22;.880;3600000;0
813;22601;26;0;0;0;0;.00nan;0;0
813;32754;26;64;33;4;29;.879;3587000;0
814;262;35;64;27;3;24;.889;3600000;0
814;1430;35;0;0;0;0;.00nan;0;0
814;1821;3;33;16;4;12;.750;3598000;0
814;2054;3;0;0;0;0;.00nan;0;0
815;61;31;0;0;0;0;.00nan;0;0
815;13842;34;0;0;0;0;.00nan;0;0
815;15502;34;68;18;1;17;.944;3600000;0
815;34797;31;89;50;2;48;.960;3600000;0
816;51;21;67;23;2;21;.913;3600000;0
816;2423;15;60;28;3;25;.893;3600000;0
816;25843;21;0;0;0;0;.00nan;0;0
816;31858;15;0;0;0;0;.00nan;0;0
817;18104;10;0;0;0;0;.00nan;0;0
817;27488;10;72;24;1;23;.958;3600000;0
817;27739;22;33;39;7;32;.821;3600000;0
817;28026;22;0;0;0;0;.00nan;0;0
818;445;12;0;0;0;0;.00nan;0;0
818;15464;32;0;0;0;0;.00nan;0;0
818;31643;32;80;40;3;37;.925;3563000;0
818;34786;12;91;33;2;31;.939;3600000;0
819;335;18;58;21;2;19;.905;3512000;0
819;544;19;0;0;0;0;.00nan;0;0
819;5001;18;0;0;0;0;.00nan;0;0
819;31124;19;100;31;0;31;1.000;3600000;0
820;738;27;0;0;0;0;.00nan;0;0
820;928;20;0;0;0;0;.00nan;0;0
820;18078;20;88;14;0;14;1.000;3600000;0
820;26623;27;70;23;2;21;.913;3600000;0
821;1572;4838;0;0;0;0;.00nan;0;0
821;2328;4838;89;38;2;36;.947;3588000;0
821;4450;5;92;22;0;22;1.000;3600000;0
821;19823;5;0;0;0;0;.00nan;0;0
822;10103;24;74;36;3;33;.917;3518000;0
822;13842;34;100;42;1;41;.976;3600000;0
822;13979;24;0;0;0;0;.00nan;0;0
822;15502;34;0;0;0;0;.00nan;0;0
823;51;21;0;0;0;0;.00nan;0;0
823;15505;8;0;0;0;0;.00nan;0;0
823;16006;8;72;39;4;35;.897;3885000;0
823;25843;21;72;37;4;33;.892;3900000;0
824;1796;16;62;26;3;23;.885;3600000;0
824;5385;17;0;0;0;0;.00nan;0;0
824;14321;16;0;0;0;0;.00nan;0;0
824;34006;17;63;43;5;38;.884;3570000;0
825;1614;25;52;32;4;28;.875;3542000;0
825;4506;33;85;39;3;36;.923;3600000;0
825;5182;25;0;0;0;0;.00nan;0;0
825;34740;33;0;0;0;0;.00nan;0;0
826;500;4182;76;21;1;20;.952;3600000;0
826;22601;26;66;27;3;24;.889;3575000;0
826;25521;4182;0;0;0;0;.00nan;0;0
826;32754;26;0;0;0;0;.00nan;0;0
827;724;11;0;0;0;0;.00nan;0;0
827;1913;30;0;0;0;0;.00nan;0;0
827;4826;30;96;26;1;25;.962;3600000;0
827;21522;11;71;36;3;33;.917;3566000;0
828;323;9;24;20;5;15;.750;3600000;0
828;1821;3;0;0;0;0;.00nan;0;0
828;2054;3;100;31;0;31;1.000;3600000;0
828;20853;9;0;0;0;0;.00nan;0;0
829;1074;0;64;28;3;25;.893;3555000;0
829;2058;28;79;36;2;34;.944;3600000;0
829;26824;28;0;0;0;0;.00nan;0;0
829;31035;0;0;0;0;0;.00nan;0;0
830;61;31;0;0;0;0;.00nan;0;0
830;823;23;76;23;1;22;.957;3600000;0
830;10274;23;0;0;0;0;.00nan;0;0
830;34797;31;81;36;2;34;.944;3553000;0
831;1251;14;96;30;0;30;1.000;3900000;0
831;25584;14;0;0;0;0;.00nan;0;0
831;27739;22;0;0;0;0;.00nan;0;0
831;28026;22;100;38;0;38;1.000;3900000;0
832;2423;15;32;9;3;6;.667;567000;0
832;18104;10;47;28;4;24;.857;3600000;0
832;27488;10;0;0;0;0;.00nan;0;0
832;31858;15;85;33;2;31;.939;2979000;0
833;233;29;0;0;0;0;.00nan;0;0
833;15464;32;0;0;0;0;.00nan;0;0
833;18351;29;98;43;2;41;.953;3575000;0
833;31643;32;100;23;0;23;1.000;3600000;0
834;262;35;0;0;0;0;.00nan;0;0
834;544;19;0;0;0;0;.00nan;0;0
834;1430;35;70;33;3;30;.909;3600000;0
834;31124;19;35;33;6;27;.818;3600000;0
835;500;4182;0;0;0;0;.00nan;0;0
835;1614;25;61;41;6;35;.854;3600000;0
835;5182;25;0;0;0;0;.00nan;0;0
835;25521;4182;54;26;3;23;.885;3600000;0
836;724;11;69;25;3;22;.880;3600000;0
836;928;20;0;0;0;0;.00nan;0;0
836;18078;20;49;30;4;26;.867;3585000;0
836;21522;11;0;0;0;0;.00nan;0;0
837;738;27;0;0;0;0;.00nan;0;0
837;4450;5;72;23;2;21;.913;3600000;0
837;19823;5;0;0;0;0;.00nan;0;0
837;26623;27;84;36;3;33;.917;3576000;0
838;335;18;0;0;0;0;.00nan;0;0
838;5001;18;17;25;7;18;.720;3600000;0
838;18104;10;0;0;0;0;.00nan;0;0
838;27488;10;86;31;1;30;.968;3600000;0
839;823;23;75;33;3;30;.909;3600000;0
839;10103;24;60;33;4;29;.879;3590000;0
839;10274;23;0;0;0;0;.00nan;0;0
839;13979;24;0;0;0;0;.00nan;0;0
840;2423;15;92;33;1;32;.970;3600000;0
840;13842;34;0;0;0;0;.00nan;0;0
840;15502;34;28;30;6;24;.800;3600000;0
840;31858;15;0;0;0;0;.00nan;0;0
841;1796;16;65;27;3;24;.889;3600000;0
841;14321;16;0;0;0;0;.00nan;0;0
841;15505;8;0;0;0;0;.00nan;0;0
841;16006;8;83;52;5;47;.904;3594000;0
842;445;12;0;0;0;0;.00nan;0;0
842;5385;17;36;15;4;11;.733;1715000;0
842;34006;17;46;26;4;22;.846;1885000;0
842;34786;12;100;25;0;25;1.000;3600000;0
843;4506;33;77;28;2;26;.929;3600000;0
843;22601;26;63;31;3;28;.903;3572000;0
843;32754;26;0;0;0;0;.00nan;0;0
843;34740;33;0;0;0;0;.00nan;0;0
844;928;20;0;0;0;0;.00nan;0;0
844;1913;30;0;0;0;0;.00nan;0;0
844;4826;30;100;31;0;31;1.000;3600000;0
844;18078;20;69;39;4;35;.897;3600000;0
845;738;27;79;38;4;34;.895;3512000;0
845;1572;4838;0;0;0;0;.00nan;0;0
845;2328;4838;89;31;2;29;.935;3600000;0
845;26623;27;0;0;0;0;.00nan;0;0
846;51;21;71;22;1;21;.955;3600000;0
846;335;18;53;23;3;20;.870;3600000;0
846;5001;18;0;0;0;0;.00nan;0;0
846;25843;21;0;0;0;0;.00nan;0;0
847;1251;14;84;29;2;27;.931;3600000;0
847;1796;16;73;34;3;31;.912;3591000;0
847;14321;16;0;0;0;0;.00nan;0;0
847;25584;14;0;0;0;0;.00nan;0;0
848;1821;3;0;0;0;0;.00nan;0;0
848;2054;3;56;34;6;28;.824;3600000;0
848;27739;22;0;0;0;0;.00nan;0;0
848;28026;22;56;23;3;20;.870;3600000;0
849;724;11;0;0;0;0;.00nan;0;0
849;4450;5;63;25;3;22;.880;3600000;0
849;19823;5;0;0;0;0;.00nan;0;0
849;21522;11;56;42;5;37;.881;3600000;0
850;323;9;64;37;4;33;.892;3564000;0
850;10103;24;80;26;2;24;.923;3600000;0
850;13979;24;0;0;0;0;.00nan;0;0
850;20853;9;0;0;0;0;.00nan;0;0
851;233;29;0;0;0;0;.00nan;0;0
851;2058;28;0;0;0;0;.00nan;0;0
851;18351;29;100;47;0;47;1.000;3600000;0
851;26824;28;49;27;4;23;.852;3600000;0
852;823;23;84;39;3;36;.923;3600000;0
852;1251;14;0;0;0;0;.00nan;0;0
852;10274;23;0;0;0;0;.00nan;0;0
852;25584;14;63;21;2;19;.905;3600000;0
853;51;21;0;0;0;0;.00nan;0;0
853;13842;34;0;0;0;0;.00nan;0;0
853;15502;34;78;21;1;20;.952;3600000;0
853;25843;21;74;53;5;48;.906;3600000;0
854;262;35;0;0;0;0;.00nan;0;0
854;544;19;0;0;0;0;.00nan;0;0
854;1430;35;92;30;1;29;.967;3600000;0
854;31124;19;57;23;3;20;.870;3538000;0
855;1074;0;66;31;4;27;.871;3600000;0
855;4506;33;0;0;0;0;.00nan;0;0
855;31035;0;0;0;0;0;.00nan;0;0
855;34740;33;44;31;5;26;.839;3547000;0
856;928;20;0;0;0;0;.00nan;0;0
856;1614;25;75;37;3;34;.919;3814000;0
856;5182;25;0;0;0;0;.00nan;0;0
856;18078;20;88;34;2;32;.941;3814000;0
857;500;4182;100;22;0;22;1.000;3600000;0
857;738;27;0;0;0;0;.00nan;0;0
857;25521;4182;0;0;0;0;.00nan;0;0
857;26623;27;60;34;4;30;.882;3600000;0
858;1913;30;0;0;0;0;.00nan;0;0
858;4450;5;0;0;0;0;.00nan;0;0
858;4826;30;75;39;4;35;.897;3600000;0
858;19823;5;98;39;2;37;.949;3600000;0
859;1821;3;77;25;1;24;.960;3600000;0
859;2054;3;0;0;0;0;.00nan;0;0
859;5385;17;0;0;0;0;.00nan;0;0
859;34006;17;90;58;5;53;.914;3600000;0
860;1796;16;72;34;3;31;.912;3600000;0
860;14321;16;0;0;0;0;.00nan;0;0
860;18104;10;66;48;5;43;.896;3554000;0
860;27488;10;0;0;0;0;.00nan;0;0
861;445;12;0;0;0;0;.00nan;0;0
861;724;11;92;41;3;38;.927;3671000;0
861;21522;11;0;0;0;0;.00nan;0;0
861;34786;12;58;22;2;20;.909;3671000;0
862;1572;4838;0;0;0;0;.00nan;0;0
862;2328;4838;64;43;5;38;.884;3600000;0
862;15464;32;0;0;0;0;.00nan;0;0
862;31643;32;71;17;1;16;.941;3600000;0
863;233;29;0;0;0;0;.00nan;0;0
863;2423;15;64;26;3;23;.885;3513000;0
863;18351;29;100;40;1;39;.975;3600000;0
863;31858;15;0;0;0;0;.00nan;0;0
864;61;31;58;22;3;19;.864;2474000;0
864;2058;28;100;34;1;33;.971;3600000;0
864;26824;28;0;0;0;0;.00nan;0;0
864;34797;31;25;12;4;8;.667;1126000;0
865;335;18;0;0;0;0;.00nan;0;0
865;928;20;0;0;0;0;.00nan;0;0
865;5001;18;69;29;3;26;.897;3555000;0
865;18078;20;75;28;2;26;.929;3600000;0
866;262;35;0;0;0;0;.00nan;0;0
866;1251;14;100;26;0;26;1.000;3600000;0
866;1430;35;51;32;5;27;.844;3600000;0
866;25584;14;0;0;0;0;.00nan;0;0
867;10103;24;68;25;2;23;.920;3600000;0
867;13979;24;0;0;0;0;.00nan;0;0
867;27739;22;0;0;0;0;.00nan;0;0
867;28026;22;48;27;4;23;.852;3519000;0
868;823;23;64;48;6;42;.875;3600000;0
868;10274;23;0;0;0;0;.00nan;0;0
868;15505;8;10;26;7;19;.731;3600000;0
868;16006;8;0;0;0;0;.00nan;0;0
869;544;19;0;0;0;0;.00nan;0;0
869;1074;0;96;32;1;31;.969;3600000;0
869;31035;0;0;0;0;0;.00nan;0;0
869;31124;19;62;25;2;23;.920;3567000;0
870;1614;25;50;27;4;23;.852;3578000;0
870;5182;25;0;0;0;0;.00nan;0;0
870;22601;26;0;0;0;0;.00nan;0;0
870;32754;26;88;40;3;37;.925;3600000;0
871;500;4182;99;52;4;48;.923;3900000;0
871;4450;5;0;0;0;0;.00nan;0;0
871;19823;5;62;33;4;29;.879;3900000;0
871;25521;4182;0;0;0;0;.00nan;0;0
872;262;35;72;34;3;31;.912;3553000;0
872;1430;35;0;0;0;0;.00nan;0;0
872;5385;17;85;31;1;30;.968;3600000;0
872;34006;17;0;0;0;0;.00nan;0;0
873;233;29;9;8;5;3;.375;826000;0
873;323;9;63;30;4;26;.867;3600000;0
873;18351;29;90;27;0;27;1.000;2732000;0
873;20853;9;0;0;0;0;.00nan;0;0
874;51;21;86;41;4;37;.902;3600000;0
874;18104;10;75;23;2;21;.913;3600000;0
874;25843;21;0;0;0;0;.00nan;0;0
874;27488;10;0;0;0;0;.00nan;0;0
875;2423;15;83;41;2;39;.951;3900000;0
875;10103;24;100;46;2;44;.957;3900000;0
875;13979;24;0;0;0;0;.00nan;0;0
875;31858;15;0;0;0;0;.00nan;0;0
876;724;11;57;27;3;24;.889;3900000;0
876;13842;34;0;0;0;0;.00nan;0;0
876;15502;34;87;42;3;39;.929;3900000;0
876;21522;11;0;0;0;0;.00nan;0;0
877;445;12;75;26;2;24;.923;2625000;0
877;4506;33;78;37;3;34;.919;3600000;0
877;34740;33;0;0;0;0;.00nan;0;0
877;34786;12;32;15;4;11;.733;975000;0
878;500;4182;88;26;1;25;.962;3600000;0
878;1913;30;0;0;0;0;.00nan;0;0
878;4826;30;87;44;3;41;.932;3590000;0
878;25521;4182;0;0;0;0;.00nan;0;0
879;335;18;0;0;0;0;.00nan;0;0
879;1821;3;0;0;0;0;.00nan;0;0
879;2054;3;98;22;0;22;1.000;3600000;0
879;5001;18;88;36;2;34;.944;3560000;0
880;61;31;0;0;0;0;.00nan;0;0
880;323;9;0;0;0;0;.00nan;0;0
880;20853;9;50;40;6;34;.850;3570000;0
880;34797;31;46;28;5;23;.821;3600000;0
881;928;20;23;30;7;23;.767;3600000;0
881;1796;16;84;24;1;23;.958;3600000;0
881;14321;16;0;0;0;0;.00nan;0;0
881;18078;20;0;0;0;0;.00nan;0;0
882;1251;14;51;28;4;24;.857;3900000;0
882;15505;8;0;0;0;0;.00nan;0;0
882;16006;8;100;55;4;51;.927;3900000;0
882;25584;14;0;0;0;0;.00nan;0;0
883;1572;4838;0;0;0;0;.00nan;0;0
883;2328;4838;79;37;3;34;.919;3600000;0
883;27739;22;0;0;0;0;.00nan;0;0
883;28026;22;93;25;0;25;1.000;3600000;0
884;4450;5;63;22;2;20;.909;3600000;0
884;13842;34;35;12;3;9;.750;265000;0
884;15502;34;65;40;5;35;.875;3335000;0
884;19823;5;0;0;0;0;.00nan;0;0
885;544;19;0;0;0;0;.00nan;0;0
885;1614;25;0;0;0;0;.00nan;0;0
885;5182;25;94;36;2;34;.944;3600000;0
885;31124;19;45;17;3;14;.824;3546000;0
886;823;23;0;0;0;0;.00nan;0;0
886;1074;0;100;37;0;37;1.000;3600000;0
886;10274;23;72;19;1;18;.947;3543000;0
886;31035;0;0;0;0;0;.00nan;0;0
887;2058;28;73;28;2;26;.929;3600000;0
887;22601;26;0;0;0;0;.00nan;0;0
887;26824;28;0;0;0;0;.00nan;0;0
887;32754;26;60;35;4;31;.886;3594000;0
888;738;27;0;0;0;0;.00nan;0;0
888;15464;32;0;0;0;0;.00nan;0;0
888;26623;27;91;44;3;41;.932;3600000;0
888;31643;32;51;35;5;30;.857;3519000;0
889;724;11;17;20;6;14;.700;3600000;0
889;5385;17;0;0;0;0;.00nan;0;0
889;21522;11;0;0;0;0;.00nan;0;0
889;34006;17;89;37;2;35;.946;3600000;0
890;51;21;87;41;3;38;.927;3600000;0
890;1796;16;0;0;0;0;.00nan;0;0
890;14321;16;39;17;4;13;.765;3557000;0
890;25843;21;0;0;0;0;.00nan;0;0
891;1572;4838;76;35;3;32;.914;3600000;0
891;2328;4838;0;0;0;0;.00nan;0;0
891;10103;24;52;30;4;26;.867;3584000;0
891;13979;24;0;0;0;0;.00nan;0;0
892;233;29;0;0;0;0;.00nan;0;0
892;15505;8;81;35;2;33;.943;3900000;0
892;16006;8;0;0;0;0;.00nan;0;0
892;18351;29;58;20;2;18;.900;3900000;0
893;262;35;0;0;0;0;.00nan;0;0
893;445;12;0;0;0;0;.00nan;0;0
893;1430;35;91;46;3;43;.935;3600000;0
893;34786;12;100;28;0;28;1.000;3600000;0
894;4506;33;71;28;2;26;.929;3900000;0
894;18104;10;74;31;2;29;.935;3900000;0
894;27488;10;0;0;0;0;.00nan;0;0
894;34740;33;0;0;0;0;.00nan;0;0
895;500;4182;75;24;2;22;.917;3600000;0
895;2058;28;0;0;0;0;.00nan;0;0
895;25521;4182;0;0;0;0;.00nan;0;0
895;26824;28;69;36;3;33;.917;3600000;0
896;738;27;68;26;2;24;.923;3544000;0
896;1913;30;0;0;0;0;.00nan;0;0
896;4826;30;85;22;1;21;.955;3600000;0
896;26623;27;0;0;0;0;.00nan;0;0
897;724;11;0;0;0;0;.00nan;0;0
897;4450;5;0;0;0;0;.00nan;0;0
897;19823;5;50;27;4;23;.852;3551000;0
897;21522;11;67;33;3;30;.909;3600000;0
898;61;31;98;26;0;26;1.000;3600000;0
898;5385;17;26;14;4;10;.714;927000;0
898;34006;17;49;37;6;31;.838;2673000;0
898;34797;31;0;0;0;0;.00nan;0;0
899;928;20;0;0;0;0;.00nan;0;0
899;1614;25;84;28;1;27;.964;3600000;0
899;5182;25;0;0;0;0;.00nan;0;0
899;18078;20;93;38;2;36;.947;3600000;0
900;1821;3;0;0;0;0;.00nan;0;0
900;2054;3;58;25;3;22;.880;3551000;0
900;13842;34;0;0;0;0;.00nan;0;0
900;15502;34;89;36;2;34;.944;3600000;0
901;1572;4838;0;0;0;0;.00nan;0;0
901;1821;3;65;23;2;21;.913;3600000;0
901;2054;3;0;0;0;0;.00nan;0;0
901;2328;4838;65;32;3;29;.906;3550000;0
902;323;9;86;35;2;33;.943;3600000;0
902;20853;9;0;0;0;0;.00nan;0;0
902;22601;26;0;0;0;0;.00nan;0;0
902;32754;26;33;24;5;19;.792;3600000;0
903;51;21;65;30;4;26;.867;3600000;0
903;1614;25;0;0;0;0;.00nan;0;0
903;5182;25;83;31;2;29;.935;3600000;0
903;25843;21;0;0;0;0;.00nan;0;0
904;500;4182;87;33;3;30;.909;3900000;0
904;1251;14;55;23;3;20;.870;3900000;0
904;25521;4182;0;0;0;0;.00nan;0;0
904;25584;14;0;0;0;0;.00nan;0;0
905;61;31;74;50;5;45;.900;3600000;0
905;2423;15;0;0;0;0;.00nan;0;0
905;31858;15;60;29;3;26;.897;3600000;0
905;34797;31;0;0;0;0;.00nan;0;0
906;1913;30;0;0;0;0;.00nan;0;0
906;4826;30;83;35;3;32;.914;3600000;0
906;15505;8;0;0;0;0;.00nan;0;0
906;16006;8;87;50;4;46;.920;3547000;0
907;1796;16;47;18;3;15;.833;3560000;0
907;2058;28;95;40;2;38;.950;3600000;0
907;14321;16;0;0;0;0;.00nan;0;0
907;26824;28;0;0;0;0;.00nan;0;0
908;445;12;0;0;0;0;.00nan;0;0
908;15464;32;0;0;0;0;.00nan;0;0
908;31643;32;59;27;3;24;.889;3525000;0
908;34786;12;76;24;1;23;.958;3600000;0
909;262;35;0;0;0;0;.00nan;0;0
909;1430;35;51;37;5;32;.865;3600000;0
909;18104;10;0;0;0;0;.00nan;0;0
909;27488;10;75;27;2;25;.926;3600000;0
910;233;29;0;0;0;0;.00nan;0;0
910;4506;33;100;32;1;31;.969;3600000;0
910;18351;29;60;35;4;31;.886;3600000;0
910;34740;33;0;0;0;0;.00nan;0;0
911;544;19;0;0;0;0;.00nan;0;0
911;27739;22;0;0;0;0;.00nan;0;0
911;28026;22;100;40;2;38;.950;3900000;0
911;31124;19;83;35;2;33;.943;3900000;0
912;823;23;62;37;5;32;.865;3822000;0
912;10274;23;0;0;0;0;.00nan;0;0
912;27739;22;0;0;0;0;.00nan;0;0
912;28026;22;61;30;4;26;.867;3819000;0
913;335;18;0;0;0;0;.00nan;0;0
913;1074;0;60;31;4;27;.871;3544000;0
913;5001;18;77;28;2;26;.929;3600000;0
913;31035;0;0;0;0;0;.00nan;0;0
914;4450;5;0;0;0;0;.00nan;0;0
914;15505;8;0;0;0;0;.00nan;0;0
914;16006;8;94;43;2;41;.953;3564000;0
914;19823;5;94;20;0;20;1.000;3600000;0
915;500;4182;47;17;3;14;.824;3597000;0
915;5385;17;0;0;0;0;.00nan;0;0
915;25521;4182;0;0;0;0;.00nan;0;0
915;34006;17;99;36;1;35;.972;3600000;0
916;1821;3;0;0;0;0;.00nan;0;0
916;2054;3;61;29;4;25;.862;3551000;0
916;22601;26;0;0;0;0;.00nan;0;0
916;32754;26;96;45;2;43;.956;3600000;0
917;1572;4838;0;0;0;0;.00nan;0;0
917;2058;28;69;31;3;28;.903;3548000;0
917;2328;4838;92;37;2;35;.946;3600000;0
917;26824;28;0;0;0;0;.00nan;0;0
918;262;35;0;0;0;0;.00nan;0;0
918;323;9;62;33;4;29;.879;3600000;0
918;1430;35;63;21;2;19;.905;3600000;0
918;20853;9;0;0;0;0;.00nan;0;0
919;61;31;0;0;0;0;.00nan;0;0
919;1251;14;54;39;5;34;.872;3550000;0
919;25584;14;0;0;0;0;.00nan;0;0
919;34797;31;76;38;4;34;.895;3600000;0
920;51;21;100;22;0;22;1.000;3600000;0
920;4506;33;64;22;2;20;.909;3534000;0
920;25843;21;0;0;0;0;.00nan;0;0
920;34740;33;0;0;0;0;.00nan;0;0
921;928;20;0;0;0;0;.00nan;0;0
921;2423;15;28;26;5;21;.808;3900000;0
921;18078;20;58;38;5;33;.868;3900000;0
921;31858;15;0;0;0;0;.00nan;0;0
922;1614;25;51;36;5;31;.861;3600000;0
922;5182;25;0;0;0;0;.00nan;0;0
922;10103;24;70;28;3;25;.893;3600000;0
922;13979;24;0;0;0;0;.00nan;0;0
923;1796;16;83;29;1;28;.966;3600000;0
923;14321;16;0;0;0;0;.00nan;0;0
923;18104;10;48;30;4;26;.867;3600000;0
923;27488;10;0;0;0;0;.00nan;0;0
924;1913;30;61;30;3;27;.900;3600000;0
924;4826;30;0;0;0;0;.00nan;0;0
924;15464;32;0;0;0;0;.00nan;0;0
924;31643;32;80;32;2;30;.938;3600000;0
925;233;29;0;0;0;0;.00nan;0;0
925;544;19;0;0;0;0;.00nan;0;0
925;18351;29;78;30;2;28;.933;3600000;0
925;31124;19;69;34;4;30;.882;3557000;0
926;724;11;99;31;1;30;.968;3600000;0
926;738;27;0;0;0;0;.00nan;0;0
926;21522;11;0;0;0;0;.00nan;0;0
926;26623;27;56;39;6;33;.846;3600000;0
927;928;20;100;26;0;26;1.000;3600000;0
927;4506;33;73;36;4;32;.889;3600000;0
927;18078;20;0;0;0;0;.00nan;0;0
927;34740;33;0;0;0;0;.00nan;0;0
928;500;4182;28;28;6;22;.786;3515000;0
928;2423;15;0;0;0;0;.00nan;0;0
928;25521;4182;0;0;0;0;.00nan;0;0
928;31858;15;58;31;4;27;.871;3600000;0
929;262;35;67;33;2;31;.939;3548000;0
929;1430;35;0;0;0;0;.00nan;0;0
929;13842;34;0;0;0;0;.00nan;0;0
929;15502;34;88;30;1;29;.967;3600000;0
930;335;18;0;0;0;0;.00nan;0;0
930;5001;18;63;33;4;29;.879;3562000;0
930;27739;22;0;0;0;0;.00nan;0;0
930;28026;22;71;27;3;24;.889;3600000;0
931;4450;5;0;0;0;0;.00nan;0;0
931;19823;5;67;29;3;26;.897;3600000;0
931;22601;26;28;9;3;6;.667;537000;0
931;32754;26;38;35;6;29;.829;3063000;0
932;1074;0;0;0;0;0;.00nan;0;0
932;1572;4838;70;20;1;19;.950;3600000;0
932;2328;4838;0;0;0;0;.00nan;0;0
932;31035;0;77;38;4;34;.895;3600000;0
933;2058;28;47;24;4;20;.833;3691000;0
933;15505;8;0;0;0;0;.00nan;0;0
933;16006;8;69;41;5;36;.878;3691000;0
933;26824;28;0;0;0;0;.00nan;0;0
934;51;21;58;27;3;24;.889;3592000;0
934;1913;30;0;0;0;0;.00nan;0;0
934;4826;30;100;46;2;44;.957;3600000;0
934;25843;21;0;0;0;0;.00nan;0;0
935;1251;14;54;4;0;4;1.000;383000;0
935;10103;24;81;25;1;24;.960;3600000;0
935;13979;24;0;0;0;0;.00nan;0;0
935;25584;14;22;28;6;22;.786;3217000;0
936;1796;16;76;33;3;30;.909;3707000;0
936;14321;16;0;0;0;0;.00nan;0;0
936;15464;32;0;0;0;0;.00nan;0;0
936;31643;32;70;21;2;19;.905;3707000;0
937;445;12;0;0;0;0;.00nan;0;0
937;18104;10;49;1;0;1;1.000;510000;0
937;27488;10;73;58;7;51;.879;3090000;0
937;34786;12;34;17;4;13;.765;3600000;0
938;323;9;69;31;3;28;.903;3579000;0
938;544;19;0;0;0;0;.00nan;0;0
938;20853;9;0;0;0;0;.00nan;0;0
938;31124;19;82;28;1;27;.964;3600000;0
939;233;29;0;0;0;0;.00nan;0;0
939;823;23;64;32;4;28;.875;3584000;0
939;10274;23;0;0;0;0;.00nan;0;0
939;18351;29;89;31;2;29;.935;3600000;0
940;724;11;91;40;1;39;.975;3600000;0
940;738;27;0;0;0;0;.00nan;0;0
940;21522;11;0;0;0;0;.00nan;0;0
940;26623;27;70;29;4;25;.862;3600000;0
941;1821;3;71;29;2;27;.931;3703000;0
941;2054;3;0;0;0;0;.00nan;0;0
941;5385;17;0;0;0;0;.00nan;0;0
941;34006;17;89;39;3;36;.923;3703000;0
942;928;20;66;22;2;20;.909;3636000;0
942;1913;30;90;36;1;35;.972;3636000;0
942;4826;30;0;0;0;0;.00nan;0;0
942;18078;20;0;0;0;0;.00nan;0;0
943;1074;0;47;46;6;40;.870;3335000;0
943;1251;14;48;20;3;17;.850;3600000;0
943;25584;14;0;0;0;0;.00nan;0;0
943;31035;0;50;2;0;2;1.000;265000;0
944;2423;15;95;32;1;31;.969;3600000;0
944;10103;24;0;0;0;0;.00nan;0;0
944;13979;24;78;33;3;30;.909;3563000;0
944;31858;15;0;0;0;0;.00nan;0;0
945;500;4182;22;10;4;6;.600;934000;0
945;13842;34;0;0;0;0;.00nan;0;0
945;15502;34;87;25;1;24;.960;3600000;0
945;25521;4182;74;22;1;21;.955;2666000;0
946;1796;16;72;29;3;26;.897;3590000;0
946;4506;33;70;21;2;19;.905;3600000;0
946;14321;16;0;0;0;0;.00nan;0;0
946;34740;33;0;0;0;0;.00nan;0;0
947;262;35;0;0;0;0;.00nan;0;0
947;1430;35;71;29;2;27;.931;3900000;0
947;15464;32;88;40;2;38;.950;3900000;0
947;31643;32;0;0;0;0;.00nan;0;0
948;544;19;95;38;2;36;.947;3600000;0
948;1614;25;52;37;5;32;.865;3600000;0
948;5182;25;0;0;0;0;.00nan;0;0
948;31124;19;0;0;0;0;.00nan;0;0
949;233;29;0;0;0;0;.00nan;0;0
949;335;18;0;0;0;0;.00nan;0;0
949;5001;18;56;27;3;24;.889;3563000;0
949;18351;29;73;26;2;24;.923;3600000;0
950;61;31;0;0;0;0;.00nan;0;0
950;724;11;0;0;0;0;.00nan;0;0
950;21522;11;70;33;3;30;.909;3600000;0
950;34797;31;42;36;6;30;.833;3600000;0
951;2058;28;77;30;2;28;.933;3600000;0
951;22601;26;0;0;0;0;.00nan;0;0
951;26824;28;0;0;0;0;.00nan;0;0
951;32754;26;66;40;5;35;.875;3600000;0
952;445;12;0;0;0;0;.00nan;0;0
952;1821;3;0;0;0;0;.00nan;0;0
952;2054;3;90;17;0;17;1.000;3600000;0
952;34786;12;80;45;4;41;.911;3600000;0
953;1074;0;99;35;1;34;.971;3600000;0
953;22601;26;68;39;4;35;.897;3600000;0
953;31035;0;0;0;0;0;.00nan;0;0
953;32754;26;0;0;0;0;.00nan;0;0
954;1913;30;77;31;2;29;.935;3600000;0
954;4826;30;0;0;0;0;.00nan;0;0
954;18104;10;75;23;1;22;.957;3600000;0
954;27488;10;0;0;0;0;.00nan;0;0
955;928;20;0;0;0;0;.00nan;0;0
955;18078;20;100;37;0;37;1.000;3600000;0
955;27739;22;0;0;0;0;.00nan;0;0
955;28026;22;59;30;4;26;.867;3600000;0
956;4450;5;0;0;0;0;.00nan;0;0
956;15505;8;0;0;0;0;.00nan;0;0
956;16006;8;100;38;0;38;1.000;3600000;0
956;19823;5;60;20;2;18;.900;3515000;0
957;2423;15;86;42;3;39;.929;3600000;0
957;15464;32;0;0;0;0;.00nan;0;0
957;31643;32;61;52;6;46;.885;3600000;0
957;31858;15;0;0;0;0;.00nan;0;0
958;500;4182;100;24;0;24;1.000;3600000;0
958;4506;33;97;33;1;32;.970;3600000;0
958;25521;4182;0;0;0;0;.00nan;0;0
958;34740;33;0;0;0;0;.00nan;0;0
959;323;9;93;39;2;37;.949;3900000;0
959;823;23;90;36;2;34;.944;3900000;0
959;10274;23;0;0;0;0;.00nan;0;0
959;20853;9;0;0;0;0;.00nan;0;0
960;51;21;8;13;6;7;.538;1250000;0
960;335;18;0;0;0;0;.00nan;0;0
960;5001;18;78;24;1;23;.958;3600000;0
960;25843;21;47;23;3;20;.870;2350000;0
961;724;11;70;25;2;23;.920;3537000;0
961;1614;25;100;28;0;28;1.000;3600000;0
961;5182;25;0;0;0;0;.00nan;0;0
961;21522;11;0;0;0;0;.00nan;0;0
962;61;31;84;28;1;27;.964;3600000;0
962;738;27;0;0;0;0;.00nan;0;0
962;26623;27;60;30;4;26;.867;3600000;0
962;34797;31;0;0;0;0;.00nan;0;0
963;2058;28;0;0;0;0;.00nan;0;0
963;13842;34;73;40;3;37;.925;3012000;0
963;15502;34;32;11;3;8;.727;588000;0
963;26824;28;75;22;1;21;.955;3600000;0
964;262;35;0;0;0;0;.00nan;0;0
964;1430;35;71;32;3;29;.906;3587000;0
964;4450;5;88;27;1;26;.963;3600000;0
964;19823;5;0;0;0;0;.00nan;0;0
965;51;21;84;30;2;28;.933;3600000;0
965;544;19;0;0;0;0;.00nan;0;0
965;25843;21;0;0;0;0;.00nan;0;0
965;31124;19;71;30;3;27;.900;3544000;0
966;233;29;0;0;0;0;.00nan;0;0
966;1572;4838;0;0;0;0;.00nan;0;0
966;2328;4838;73;36;3;33;.917;3600000;0
966;18351;29;100;35;0;35;1.000;3600000;0
967;1821;3;0;0;0;0;.00nan;0;0
967;2054;3;94;40;2;38;.950;3600000;0
967;10103;24;57;32;4;28;.875;3538000;0
967;13979;24;0;0;0;0;.00nan;0;0
968;445;12;0;0;0;0;.00nan;0;0
968;1074;0;71;31;3;28;.903;3600000;0
968;31035;0;0;0;0;0;.00nan;0;0
968;34786;12;100;27;0;27;1.000;3600000;0
969;1251;14;0;0;0;0;.00nan;0;0
969;15464;32;0;0;0;0;.00nan;0;0
969;25584;14;42;27;5;22;.815;3600000;0
969;31643;32;90;36;1;35;.972;3600000;0
970;13842;34;0;0;0;0;.00nan;0;0
970;15502;34;63;29;3;26;.897;3600000;0
970;27739;22;0;0;0;0;.00nan;0;0
970;28026;22;52;27;4;23;.852;3545000;0
971;1796;16;79;34;2;32;.941;3600000;0
971;2423;15;67;38;5;33;.868;3600000;0
971;14321;16;0;0;0;0;.00nan;0;0
971;31858;15;0;0;0;0;.00nan;0;0
972;823;23;98;46;2;44;.957;3575000;0
972;5385;17;0;0;0;0;.00nan;0;0
972;10274;23;0;0;0;0;.00nan;0;0
972;34006;17;100;26;0;26;1.000;3600000;0
973;323;9;68;49;6;43;.878;3600000;0
973;335;18;0;0;0;0;.00nan;0;0
973;5001;18;93;26;1;25;.962;3600000;0
973;20853;9;0;0;0;0;.00nan;0;0
974;61;31;0;0;0;0;.00nan;0;0
974;500;4182;0;0;0;0;.00nan;0;0
974;25521;4182;83;21;1;20;.952;3600000;0
974;34797;31;50;37;5;32;.865;3600000;0
975;724;11;0;0;0;0;.00nan;0;0
975;738;27;0;0;0;0;.00nan;0;0
975;21522;11;63;43;4;39;.907;3576000;0
975;26623;27;69;28;3;25;.893;3600000;0
976;1251;14;74;27;2;25;.926;3900000;0
976;2058;28;96;47;2;45;.957;3900000;0
976;25584;14;0;0;0;0;.00nan;0;0
976;26824;28;0;0;0;0;.00nan;0;0
977;10103;24;0;0;0;0;.00nan;0;0
977;13979;24;86;33;3;30;.909;3900000;0
977;27739;22;0;0;0;0;.00nan;0;0
977;28026;22;75;38;3;35;.921;3865000;0
978;4450;5;0;0;0;0;.00nan;0;0
978;4506;33;87;30;2;28;.933;3600000;0
978;19823;5;60;22;3;19;.864;3547000;0
978;34740;33;0;0;0;0;.00nan;0;0
979;544;19;0;0;0;0;.00nan;0;0
979;5385;17;0;0;0;0;.00nan;0;0
979;31124;19;100;36;0;36;1.000;3600000;0
979;34006;17;61;33;4;29;.879;3600000;0
980;61;31;77;28;2;26;.929;3600000;0
980;1913;30;0;0;0;0;.00nan;0;0
980;4826;30;66;36;4;32;.889;3558000;0
980;34797;31;0;0;0;0;.00nan;0;0
981;738;27;72;43;4;39;.907;3600000;0
981;1614;25;93;16;0;16;1.000;3600000;0
981;5182;25;0;0;0;0;.00nan;0;0
981;26623;27;0;0;0;0;.00nan;0;0
982;1074;0;0;0;0;0;.00nan;0;0
982;2058;28;0;0;0;0;.00nan;0;0
982;26824;28;57;28;3;25;.893;3600000;0
982;31035;0;60;33;4;29;.879;3594000;0
983;233;29;0;0;0;0;.00nan;0;0
983;18104;10;0;0;0;0;.00nan;0;0
983;18351;29;64;29;4;25;.862;3837000;0
983;27488;10;71;34;3;31;.912;3837000;0
984;445;12;0;0;0;0;.00nan;0;0
984;928;20;0;0;0;0;.00nan;0;0
984;18078;20;87;36;2;34;.944;3600000;0
984;34786;12;62;30;4;26;.867;3542000;0
985;1796;16;77;26;3;23;.885;3551000;0
985;13842;34;0;0;0;0;.00nan;0;0
985;14321;16;0;0;0;0;.00nan;0;0
985;15502;34;90;37;2;35;.946;3600000;0
986;1821;3;66;37;4;33;.892;3600000;0
986;2054;3;0;0;0;0;.00nan;0;0
986;15464;32;0;0;0;0;.00nan;0;0
986;31643;32;55;24;3;21;.875;3600000;0
987;262;35;0;0;0;0;.00nan;0;0
987;1430;35;77;32;2;30;.938;3572000;0
987;15505;8;0;0;0;0;.00nan;0;0
987;16006;8;97;28;1;27;.964;3600000;0
988;51;21;67;38;4;34;.895;3600000;0
988;823;23;99;25;0;25;1.000;3600000;0
988;10274;23;0;0;0;0;.00nan;0;0
988;25843;21;0;0;0;0;.00nan;0;0
989;335;18;69;22;2;20;.909;3600000;0
989;544;19;0;0;0;0;.00nan;0;0
989;5001;18;0;0;0;0;.00nan;0;0
989;31124;19;32;39;7;32;.821;3600000;0
990;2423;15;0;0;0;0;.00nan;0;0
990;22601;26;64;9;0;9;1.000;1288000;0
990;31858;15;70;28;2;26;.929;3600000;0
990;32754;26;43;36;6;30;.833;2312000;0
991;500;4182;82;32;2;30;.938;3600000;0
991;724;11;62;31;3;28;.903;3588000;0
991;21522;11;0;0;0;0;.00nan;0;0
991;25521;4182;0;0;0;0;.00nan;0;0
992;323;9;92;33;1;32;.970;3600000;0
992;1572;4838;0;0;0;0;.00nan;0;0
992;2328;4838;68;48;6;42;.875;3600000;0
992;20853;9;0;0;0;0;.00nan;0;0
993;928;20;82;20;1;19;.950;3600000;0
993;1251;14;66;23;2;21;.913;3600000;0
993;18078;20;0;0;0;0;.00nan;0;0
993;25584;14;0;0;0;0;.00nan;0;0
994;445;12;0;0;0;0;.00nan;0;0
994;27739;22;0;0;0;0;.00nan;0;0
994;28026;22;34;18;4;14;.778;3546000;0
994;34786;12;72;39;3;36;.923;3600000;0
995;10103;24;79;33;3;30;.909;3600000;0
995;13979;24;0;0;0;0;.00nan;0;0
995;18104;10;54;33;4;29;.879;3600000;0
995;27488;10;0;0;0;0;.00nan;0;0
996;4506;33;55;23;3;20;.870;3600000;0
996;15505;8;53;28;4;24;.857;3600000;0
996;16006;8;0;0;0;0;.00nan;0;0
996;34740;33;0;0;0;0;.00nan;0;0
997;335;18;0;0;0;0;.00nan;0;0
997;5001;18;90;21;0;21;1.000;3600000;0
997;5385;17;90;43;2;41;.953;3556000;0
997;34006;17;0;0;0;0;.00nan;0;0
998;738;27;0;0;0;0;.00nan;0;0
998;22601;26;0;0;0;0;.00nan;0;0
998;26623;27;86;40;2;38;.950;3653000;0
998;32754;26;72;31;3;28;.903;3653000;0
999;1074;0;82;40;3;37;.925;3593000;0
999;4450;5;0;0;0;0;.00nan;0;0
999;19823;5;68;18;2;16;.889;3600000;0
999;31035;0;0;0;0;0;.00nan;0;0
1000;262;35;53;34;4;30;.882;3600000;0
1000;500;4182;16;19;6;13;.684;3228000;0
1000;1430;35;0;0;0;0;.00nan;0;0
1000;25521;4182;50;2;0;2;1.000;356000;0
1001;823;23;61;25;3;22;.880;3600000;0
1001;1614;25;100;51;1;50;.980;3600000;0
1001;5182;25;0;0;0;0;.00nan;0;0
1001;10274;23;0;0;0;0;.00nan;0;0
1002;1913;30;0;0;0;0;.00nan;0;0
1002;4826;30;88;56;5;51;.911;3600000;0
1002;15464;32;0;0;0;0;.00nan;0;0
1002;31643;32;72;26;2;24;.923;3600000;0
1003;323;9;0;0;0;0;.00nan;0;0
1003;1251;14;0;0;0;0;.00nan;0;0
1003;20853;9;64;30;3;27;.900;3544000;0
1003;25584;14;67;26;2;24;.923;3600000;0
1004;51;21;0;0;0;0;.00nan;0;0
1004;18104;10;0;0;0;0;.00nan;0;0
1004;25843;21;50;33;4;29;.879;3576000;0
1004;27488;10;82;40;3;37;.925;3600000;0
1005;928;20;50;7;1;6;.857;344000;0
1005;4450;5;37;11;3;8;.727;3600000;0
1005;18078;20;54;44;6;38;.864;3256000;0
1005;19823;5;0;0;0;0;.00nan;0;0
1006;2423;15;37;26;5;21;.808;3514000;0
1006;13842;34;0;0;0;0;.00nan;0;0
1006;15502;34;74;36;3;33;.917;3600000;0
1006;31858;15;0;0;0;0;.00nan;0;0
1007;1796;16;88;30;1;29;.967;3600000;0
1007;14321;16;0;0;0;0;.00nan;0;0
1007;27739;22;0;0;0;0;.00nan;0;0
1007;28026;22;57;22;2;20;.909;3553000;0
1008;233;29;0;0;0;0;.00nan;0;0
1008;10103;24;92;35;1;34;.971;3600000;0
1008;13979;24;0;0;0;0;.00nan;0;0
1008;18351;29;61;32;4;28;.875;3600000;0
1009;445;12;0;0;0;0;.00nan;0;0
1009;823;23;32;23;5;18;.783;2462000;0
1009;10274;23;20;11;4;7;.636;1138000;0
1009;34786;12;67;21;2;19;.905;3600000;0
1010;500;4182;60;24;3;21;.875;3600000;0
1010;4506;33;49;40;6;34;.850;3600000;0
1010;25521;4182;0;0;0;0;.00nan;0;0
1010;34740;33;0;0;0;0;.00nan;0;0
1011;544;19;0;0;0;0;.00nan;0;0
1011;738;27;0;0;0;0;.00nan;0;0
1011;26623;27;98;41;2;39;.951;3900000;0
1011;31124;19;77;32;2;30;.938;3900000;0
1012;724;11;0;0;0;0;.00nan;0;0
1012;15464;32;100;22;0;22;1.000;3600000;0
1012;21522;11;52;26;4;22;.846;3600000;0
1012;31643;32;0;0;0;0;.00nan;0;0
1013;2423;15;0;0;0;0;.00nan;0;0
1013;5385;17;0;0;0;0;.00nan;0;0
1013;31858;15;83;31;2;29;.935;3600000;0
1013;34006;17;64;33;4;29;.879;3540000;0
1014;51;21;76;33;3;30;.909;3600000;0
1014;1821;3;0;0;0;0;.00nan;0;0
1014;2054;3;24;25;6;19;.760;3600000;0
1014;25843;21;0;0;0;0;.00nan;0;0
1015;335;18;0;0;0;0;.00nan;0;0
1015;1614;25;88;31;2;29;.935;3600000;0
1015;5001;18;54;26;3;23;.885;3546000;0
1015;5182;25;0;0;0;0;.00nan;0;0
1016;1572;4838;89;28;1;27;.964;3600000;0
1016;2328;4838;0;0;0;0;.00nan;0;0
1016;22601;26;0;0;0;0;.00nan;0;0
1016;32754;26;36;40;7;33;.825;3600000;0
1017;1913;30;0;0;0;0;.00nan;0;0
1017;4826;30;70;40;4;36;.900;3600000;0
1017;15505;8;0;0;0;0;.00nan;0;0
1017;16006;8;59;23;3;20;.870;3600000;0
1018;233;29;0;0;0;0;.00nan;0;0
1018;4450;5;0;0;0;0;.00nan;0;0
1018;18351;29;79;41;4;37;.902;3600000;0
1018;19823;5;94;21;0;21;1.000;3600000;0
1019;61;31;86;25;2;23;.920;3900000;0
1019;1074;0;96;47;2;45;.957;3900000;0
1019;31035;0;0;0;0;0;.00nan;0;0
1019;34797;31;0;0;0;0;.00nan;0;0
1020;928;20;0;0;0;0;.00nan;0;0
1020;2058;28;41;38;6;32;.842;3600000;0
1020;18078;20;79;32;3;29;.906;3600000;0
1020;26824;28;0;0;0;0;.00nan;0;0
1021;445;12;54;5;0;5;1.000;1075000;0
1021;10103;24;62;26;3;23;.885;3600000;0
1021;13979;24;0;0;0;0;.00nan;0;0
1021;34786;12;38;29;6;23;.793;2525000;0
1022;1251;14;96;34;1;33;.971;3900000;0
1022;1796;16;96;27;1;26;.963;3900000;0
1022;14321;16;0;0;0;0;.00nan;0;0
1022;25584;14;0;0;0;0;.00nan;0;0
1023;262;35;0;0;0;0;.00nan;0;0
1023;335;18;100;26;0;26;1.000;3600000;0
1023;1430;35;59;38;5;33;.868;3600000;0
1023;5001;18;0;0;0;0;.00nan;0;0
1024;738;27;0;0;0;0;.00nan;0;0
1024;823;23;92;36;3;33;.917;3900000;0
1024;10274;23;0;0;0;0;.00nan;0;0
1024;26623;27;73;38;3;35;.921;3900000;0
1025;500;4182;0;0;0;0;.00nan;0;0
1025;15464;32;62;34;4;30;.882;3562000;0
1025;25521;4182;78;28;2;26;.929;3600000;0
1025;31643;32;0;0;0;0;.00nan;0;0
1026;724;11;97;21;0;21;1.000;3600000;0
1026;15505;8;51;41;6;35;.854;3600000;0
1026;16006;8;0;0;0;0;.00nan;0;0
1026;21522;11;0;0;0;0;.00nan;0;0
1027;5385;17;0;0;0;0;.00nan;0;0
1027;27739;22;0;0;0;0;.00nan;0;0
1027;28026;22;61;23;3;20;.870;3885000;0
1027;34006;17;90;54;3;51;.944;3900000;0
1028;2423;15;92;41;2;39;.951;3600000;0
1028;18104;10;0;0;0;0;.00nan;0;0
1028;27488;10;56;26;3;23;.885;3585000;0
1028;31858;15;0;0;0;0;.00nan;0;0
1029;4506;33;70;27;3;24;.889;3563000;0
1029;13842;34;0;0;0;0;.00nan;0;0
1029;15502;34;87;36;2;34;.944;3600000;0
1029;34740;33;0;0;0;0;.00nan;0;0
1030;1251;14;0;0;0;0;.00nan;0;0
1030;1614;25;76;28;2;26;.929;3600000;0
1030;5182;25;0;0;0;0;.00nan;0;0
1030;25584;14;74;31;3;28;.903;3569000;0
1031;544;19;0;0;0;0;.00nan;0;0
1031;22601;26;0;0;0;0;.00nan;0;0
1031;31124;19;48;22;3;19;.864;3900000;0
1031;32754;26;81;41;3;38;.927;3900000;0
1032;1572;4838;59;38;4;34;.895;3543000;0
1032;1913;30;0;0;0;0;.00nan;0;0
1032;2328;4838;0;0;0;0;.00nan;0;0
1032;4826;30;87;34;2;32;.941;3600000;0
1033;928;20;96;49;2;47;.959;3900000;0
1033;4450;5;0;0;0;0;.00nan;0;0
1033;18078;20;0;0;0;0;.00nan;0;0
1033;19823;5;62;18;2;16;.889;3900000;0
1034;1074;0;95;44;2;42;.955;3600000;0
1034;1821;3;68;32;3;29;.906;3543000;0
1034;2054;3;0;0;0;0;.00nan;0;0
1034;31035;0;0;0;0;0;.00nan;0;0
1035;61;31;53;13;2;11;.846;3883000;0
1035;2058;28;92;46;3;43;.935;3883000;0
1035;26824;28;0;0;0;0;.00nan;0;0
1035;34797;31;0;0;0;0;.00nan;0;0
1036;233;29;0;0;0;0;.00nan;0;0
1036;2553;9;0;0;0;0;.00nan;0;0
1036;18351;29;52;23;3;20;.870;3562000;0
1036;20853;9;74;28;2;26;.929;3600000;0
1037;51;21;72;32;2;30;.938;3585000;0
1037;25843;21;0;0;0;0;.00nan;0;0
1037;27739;22;71;19;1;18;.947;3600000;0
1037;28026;22;0;0;0;0;.00nan;0;0
1038;1796;16;84;30;2;28;.933;3600000;0
1038;10103;24;31;31;6;25;.806;3600000;0
1038;13979;24;0;0;0;0;.00nan;0;0
1038;14321;16;0;0;0;0;.00nan;0;0
1039;335;18;56;33;4;29;.879;3600000;0
1039;445;12;0;0;0;0;.00nan;0;0
1039;5001;18;0;0;0;0;.00nan;0;0
1039;34786;12;85;33;2;31;.939;3600000;0
1040;262;35;0;0;0;0;.00nan;0;0
1040;1430;35;59;20;2;18;.900;3600000;0
1040;13842;34;0;0;0;0;.00nan;0;0
1040;15502;34;96;48;3;45;.938;3544000;0
1041;544;19;75;38;4;34;.895;3527000;0
1041;823;23;84;34;2;32;.941;3600000;0
1041;10274;23;0;0;0;0;.00nan;0;0
1041;31124;19;0;0;0;0;.00nan;0;0
1042;500;4182;85;30;2;28;.933;3600000;0
1042;15505;8;0;0;0;0;.00nan;0;0
1042;16006;8;60;37;5;32;.865;3600000;0
1042;25521;4182;0;0;0;0;.00nan;0;0
1043;724;11;95;36;2;34;.944;3600000;0
1043;1572;4838;0;0;0;0;.00nan;0;0
1043;2328;4838;57;31;4;27;.871;3571000;0
1043;21522;11;0;0;0;0;.00nan;0;0
1044;738;27;0;0;0;0;.00nan;0;0
1044;1913;30;100;46;2;44;.957;3900000;0
1044;4826;30;0;0;0;0;.00nan;0;0
1044;26623;27;71;27;2;25;.926;3900000;0
1045;61;31;0;0;0;0;.00nan;0;0
1045;1821;3;0;0;0;0;.00nan;0;0
1045;2054;3;58;31;4;27;.871;3900000;0
1045;34797;31;62;32;4;28;.875;3900000;0
1046;51;21;0;0;0;0;.00nan;0;0
1046;1074;0;0;0;0;0;.00nan;0;0
1046;25843;21;71;19;1;18;.947;3600000;0
1046;31035;0;59;28;4;24;.857;3600000;0
1047;233;29;0;0;0;0;.00nan;0;0
1047;928;20;62;32;3;29;.906;3322000;0
1047;18078;20;29;7;3;4;.571;278000;0
1047;18351;29;80;24;1;23;.958;3600000;0
1048;5385;17;0;0;0;0;.00nan;0;0
1048;18104;10;86;34;3;31;.912;3600000;0
1048;27488;10;0;0;0;0;.00nan;0;0
1048;34006;17;72;39;4;35;.897;3600000;0
1049;2423;15;94;39;2;37;.949;3600000;0
1049;2553;9;78;41;4;37;.902;3577000;0
1049;20853;9;0;0;0;0;.00nan;0;0
1049;31858;15;0;0;0;0;.00nan;0;0
1050;1251;14;0;0;0;0;.00nan;0;0
1050;15464;32;0;0;0;0;.00nan;0;0
1050;25584;14;64;37;4;33;.892;3600000;0
1050;31643;32;83;16;0;16;1.000;3600000;0
1051;262;35;33;11;3;8;.727;320000;0
1051;1430;35;72;32;3;29;.906;3280000;0
1051;1614;25;66;21;2;19;.905;3600000;0
1051;5182;25;0;0;0;0;.00nan;0;0
1052;4506;33;55;24;3;21;.875;3600000;0
1052;22601;26;0;0;0;0;.00nan;0;0
1052;32754;26;69;41;5;36;.878;3577000;0
1052;34740;33;0;0;0;0;.00nan;0;0
1053;10103;24;74;19;1;18;.947;3600000;0
1053;13979;24;0;0;0;0;.00nan;0;0
1053;27739;22;0;0;0;0;.00nan;0;0
1053;28026;22;86;38;2;36;.947;3586000;0
1054;5385;17;23;10;4;6;.600;1175000;0
1054;15505;8;0;0;0;0;.00nan;0;0
1054;16006;8;96;43;2;41;.953;3600000;0
1054;34006;17;54;20;3;17;.850;2425000;0
1055;335;18;0;0;0;0;.00nan;0;0
1055;1796;16;65;11;1;10;.909;3600000;0
1055;5001;18;85;51;5;46;.902;3600000;0
1055;14321;16;0;0;0;0;.00nan;0;0
1056;823;23;64;30;4;26;.867;3900000;0
1056;10274;23;0;0;0;0;.00nan;0;0
1056;22601;26;72;42;4;38;.905;3900000;0
1056;32754;26;0;0;0;0;.00nan;0;0
1057;724;11;49;17;3;14;.824;2607000;0
1057;1572;4838;78;24;1;23;.958;3600000;0
1057;2328;4838;0;0;0;0;.00nan;0;0
1057;21522;11;19;8;4;4;.500;993000;0
1058;1821;3;0;0;0;0;.00nan;0;0
1058;2054;3;100;46;0;46;1.000;3600000;0
1058;4450;5;0;0;0;0;.00nan;0;0
1058;19823;5;69;27;2;25;.926;3516000;0
1059;233;29;0;0;0;0;.00nan;0;0
1059;10103;24;87;32;1;31;.969;3600000;0
1059;13979;24;0;0;0;0;.00nan;0;0
1059;18351;29;34;24;5;19;.792;3600000;0
1060;61;31;0;0;0;0;.00nan;0;0
1060;1074;0;74;33;3;30;.909;3900000;0
1060;31035;0;0;0;0;0;.00nan;0;0
1060;34797;31;74;39;3;36;.923;3900000;0
1061;2423;15;64;34;4;30;.882;3548000;0
1061;18104;10;55;27;3;24;.889;3600000;0
1061;27488;10;0;0;0;0;.00nan;0;0
1061;31858;15;0;0;0;0;.00nan;0;0
1062;928;20;0;0;0;0;.00nan;0;0
1062;13842;34;0;0;0;0;.00nan;0;0
1062;15502;34;67;25;3;22;.880;3600000;0
1062;18078;20;35;20;4;16;.800;3547000;0
1063;2058;28;49;34;5;29;.853;3550000;0
1063;15464;32;0;0;0;0;.00nan;0;0
1063;26824;28;0;0;0;0;.00nan;0;0
1063;31643;32;63;25;3;22;.880;3600000;0
1064;262;35;58;26;3;23;.885;3600000;0
1064;1251;14;91;38;2;36;.947;3600000;0
1064;1430;35;0;0;0;0;.00nan;0;0
1064;25584;14;0;0;0;0;.00nan;0;0
1065;544;19;0;0;0;0;.00nan;0;0
1065;1614;25;62;30;4;26;.867;3567000;0
1065;5182;25;0;0;0;0;.00nan;0;0
1065;31124;19;90;37;2;35;.946;3600000;0
1066;445;12;0;0;0;0;.00nan;0;0
1066;1913;30;0;0;0;0;.00nan;0;0
1066;4826;30;89;30;1;29;.967;3600000;0
1066;34786;12;50;28;4;24;.857;3600000;0
1067;4506;33;83;24;2;22;.917;3900000;0
1067;5385;17;0;0;0;0;.00nan;0;0
1067;34006;17;93;46;2;44;.957;3900000;0
1067;34740;33;0;0;0;0;.00nan;0;0
1068;2553;9;61;38;5;33;.868;3600000;0
1068;18104;10;0;0;0;0;.00nan;0;0
1068;20853;9;0;0;0;0;.00nan;0;0
1068;27488;10;67;23;2;21;.913;3600000;0
1069;724;11;42;21;4;17;.810;1146000;0
1069;823;23;72;28;2;26;.929;3600000;0
1069;10274;23;0;0;0;0;.00nan;0;0
1069;21522;11;49;22;3;19;.864;2454000;0
1070;335;18;45;8;2;6;.750;737000;0
1070;1796;16;83;22;1;21;.955;3600000;0
1070;5001;18;51;40;6;34;.850;2863000;0
1070;14321;16;0;0;0;0;.00nan;0;0
1071;738;27;37;15;3;12;.800;2415000;0
1071;22601;26;0;0;0;0;.00nan;0;0
1071;26623;27;30;14;4;10;.714;1185000;0
1071;32754;26;31;25;6;19;.760;3600000;0
1072;500;4182;70;35;3;32;.914;3570000;0
1072;1572;4838;0;0;0;0;.00nan;0;0
1072;2328;4838;92;37;1;36;.973;3600000;0
1072;25521;4182;0;0;0;0;.00nan;0;0
1073;51;21;97;44;2;42;.955;3900000;0
1073;4450;5;0;0;0;0;.00nan;0;0
1073;19823;5;72;24;2;22;.917;3900000;0
1073;25843;21;0;0;0;0;.00nan;0;0
1074;1821;3;0;0;0;0;.00nan;0;0
1074;2054;3;79;41;4;37;.902;3563000;0
1074;4506;33;72;33;3;30;.909;3600000;0
1074;34740;33;0;0;0;0;.00nan;0;0
1075;61;31;0;0;0;0;.00nan;0;0
1075;15505;8;0;0;0;0;.00nan;0;0
1075;16006;8;92;43;4;39;.907;3588000;0
1075;34797;31;66;21;2;19;.905;3600000;0
1076;928;20;0;0;0;0;.00nan;0;0
1076;13842;34;0;0;0;0;.00nan;0;0
1076;15502;34;97;45;2;43;.956;3519000;0
1076;18078;20;100;35;0;35;1.000;3600000;0
1077;1074;0;98;34;1;33;.971;3600000;0
1077;10103;24;69;28;2;26;.929;3600000;0
1077;13979;24;0;0;0;0;.00nan;0;0
1077;31035;0;0;0;0;0;.00nan;0;0
1078;262;35;0;0;0;0;.00nan;0;0
1078;1430;35;90;31;1;30;.968;3600000;0
1078;2423;15;0;0;0;0;.00nan;0;0
1078;31858;15;69;38;4;34;.895;3600000;0
1079;738;27;0;0;0;0;.00nan;0;0
1079;1614;25;0;0;0;0;.00nan;0;0
1079;5182;25;86;27;1;26;.963;3600000;0
1079;26623;27;63;41;5;36;.878;3600000;0
1080;544;19;0;0;0;0;.00nan;0;0
1080;724;11;95;41;2;39;.951;3900000;0
1080;21522;11;0;0;0;0;.00nan;0;0
1080;31124;19;65;22;2;20;.909;3900000;0
1081;445;12;0;0;0;0;.00nan;0;0
1081;1913;30;0;0;0;0;.00nan;0;0
1081;4826;30;96;47;3;44;.936;3900000;0
1081;34786;12;58;23;3;20;.870;3900000;0
1082;5385;17;82;53;5;48;.906;3563000;0
1082;15464;32;0;0;0;0;.00nan;0;0
1082;31643;32;65;27;3;24;.889;3600000;0
1082;34006;17;0;0;0;0;.00nan;0;0
1083;323;9;86;25;2;23;.920;3600000;0
1083;2058;28;71;35;4;31;.886;3518000;0
1083;20853;9;0;0;0;0;.00nan;0;0
1083;26824;28;0;0;0;0;.00nan;0;0
1084;233;29;0;0;0;0;.00nan;0;0
1084;15505;8;40;44;7;37;.841;3308000;0
1084;16006;8;52;2;0;2;1.000;292000;0
1084;18351;29;81;34;3;31;.912;3600000;0
1085;928;20;0;0;0;0;.00nan;0;0
1085;18078;20;73;29;3;26;.897;3600000;0
1085;18104;10;0;0;0;0;.00nan;0;0
1085;27488;10;80;52;4;48;.923;3551000;0
1086;823;23;99;47;1;46;.979;3600000;0
1086;1796;16;65;25;2;23;.920;3549000;0
1086;10274;23;0;0;0;0;.00nan;0;0
1086;14321;16;0;0;0;0;.00nan;0;0
1087;1913;30;71;36;3;33;.917;3600000;0
1087;4826;30;0;0;0;0;.00nan;0;0
1087;22601;26;0;0;0;0;.00nan;0;0
1087;32754;26;60;30;4;26;.867;3550000;0
1088;500;4182;75;22;1;21;.955;3600000;0
1088;1572;4838;71;26;2;24;.923;3600000;0
1088;2328;4838;0;0;0;0;.00nan;0;0
1088;25521;4182;0;0;0;0;.00nan;0;0
1089;4450;5;0;0;0;0;.00nan;0;0
1089;13842;34;58;36;5;31;.861;3585000;0
1089;15502;34;0;0;0;0;.00nan;0;0
1089;19823;5;81;35;3;32;.914;3600000;0
1090;233;29;52;34;4;30;.882;3600000;0
1090;1074;0;99;40;1;39;.975;3600000;0
1090;18351;29;0;0;0;0;.00nan;0;0
1090;31035;0;0;0;0;0;.00nan;0;0
1091;51;21;90;34;1;33;.971;3900000;0
1091;61;31;0;0;0;0;.00nan;0;0
1091;25843;21;0;0;0;0;.00nan;0;0
1091;34797;31;100;37;1;36;.973;3900000;0
1092;1251;14;0;0;0;0;.00nan;0;0
1092;1821;3;79;32;2;30;.938;3600000;0
1092;2054;3;0;0;0;0;.00nan;0;0
1092;25584;14;68;27;3;24;.889;3600000;0
1093;262;35;0;0;0;0;.00nan;0;0
1093;1430;35;81;23;1;22;.957;3600000;0
1093;10103;24;63;28;3;25;.893;3570000;0
1093;13979;24;0;0;0;0;.00nan;0;0
1094;15464;32;66;29;3;26;.897;3600000;0
1094;27739;22;0;0;0;0;.00nan;0;0
1094;28026;22;67;40;4;36;.900;3566000;0
1094;31643;32;0;0;0;0;.00nan;0;0
1095;724;11;62;23;2;21;.913;3557000;0
1095;4506;33;0;0;0;0;.00nan;0;0
1095;21522;11;0;0;0;0;.00nan;0;0
1095;34740;33;82;29;1;28;.966;3600000;0
1096;1614;25;71;31;3;28;.903;3881000;0
1096;2423;15;87;49;4;45;.918;3880000;0
1096;5182;25;0;0;0;0;.00nan;0;0
1096;31858;15;0;0;0;0;.00nan;0;0
1097;544;19;36;22;4;18;.818;3517000;0
1097;1796;16;88;37;2;35;.946;3600000;0
1097;14321;16;0;0;0;0;.00nan;0;0
1097;31124;19;0;0;0;0;.00nan;0;0
1098;445;12;0;0;0;0;.00nan;0;0
1098;738;27;0;0;0;0;.00nan;0;0
1098;26623;27;62;29;3;26;.897;3890000;0
1098;34786;12;65;32;4;28;.875;3890000;0
1099;61;31;100;28;0;28;1.000;3600000;0
1099;5385;17;75;26;1;25;.962;3557000;0
1099;34006;17;0;0;0;0;.00nan;0;0
1099;34797;31;0;0;0;0;.00nan;0;0
1100;323;9;66;36;4;32;.889;3600000;0
1100;2058;28;86;28;1;27;.964;2503000;0
1100;20853;9;0;0;0;0;.00nan;0;0
1100;26824;28;20;9;4;5;.556;1089000;0
1101;51;21;0;0;0;0;.00nan;0;0
1101;928;20;0;0;0;0;.00nan;0;0
1101;18078;20;67;27;2;25;.926;3600000;0
1101;25843;21;53;23;3;20;.870;3550000;0
1102;1251;14;99;49;1;48;.980;3600000;0
1102;18104;10;71;37;4;33;.892;3600000;0
1102;25584;14;0;0;0;0;.00nan;0;0
1102;27488;10;0;0;0;0;.00nan;0;0
1103;262;35;35;35;7;28;.800;2995000;0
1103;1430;35;40;2;1;1;.500;605000;0
1103;27739;22;96;31;1;30;.968;3600000;0
1103;28026;22;0;0;0;0;.00nan;0;0
1104;15505;8;0;0;0;0;.00nan;0;0
1104;16006;8;94;21;0;21;1.000;3600000;0
1104;22601;26;0;0;0;0;.00nan;0;0
1104;32754;26;51;34;5;29;.853;3600000;0
1105;335;18;0;0;0;0;.00nan;0;0
1105;500;4182;70;35;4;31;.886;3600000;0
1105;5001;18;82;25;1;24;.960;3600000;0
1105;25521;4182;0;0;0;0;.00nan;0;0
1106;823;23;91;40;2;38;.950;3600000;0
1106;1913;30;0;0;0;0;.00nan;0;0
1106;4826;30;68;39;4;35;.897;3549000;0
1106;10274;23;0;0;0;0;.00nan;0;0
1107;445;12;49;20;4;16;.800;3896000;0
1107;1572;4838;50;24;3;21;.875;3896000;0
1107;2328;4838;0;0;0;0;.00nan;0;0
1107;34786;12;0;0;0;0;.00nan;0;0
1108;233;29;0;0;0;0;.00nan;0;0
1108;1821;3;0;0;0;0;.00nan;0;0
1108;2054;3;52;32;4;28;.875;3900000;0
1108;18351;29;43;27;4;23;.852;3900000;0
1109;4450;5;0;0;0;0;.00nan;0;0
1109;13842;34;0;0;0;0;.00nan;0;0
1109;15502;34;97;38;1;37;.974;3900000;0
1109;19823;5;64;12;1;11;.917;3900000;0
1110;1796;16;0;0;0;0;.00nan;0;0
1110;3281;26;61;42;5;37;.881;3600000;0
1110;14321;16;63;13;1;12;.923;3600000;0
1110;32754;26;0;0;0;0;.00nan;0;0
1111;544;19;0;0;0;0;.00nan;0;0
1111;724;11;0;0;0;0;.00nan;0;0
1111;21522;11;84;43;3;40;.930;3600000;0
1111;31124;19;25;27;7;20;.741;3600000;0
1112;5385;17;54;30;4;26;.867;3600000;0
1112;10103;24;61;30;5;25;.833;3561000;0
1112;13979;24;0;0;0;0;.00nan;0;0
1112;34006;17;0;0;0;0;.00nan;0;0
1113;1074;0;59;37;5;32;.865;3600000;0
1113;2058;28;43;35;6;29;.829;3558000;0
1113;26824;28;0;0;0;0;.00nan;0;0
1113;31035;0;0;0;0;0;.00nan;0;0
1114;323;9;84;44;3;41;.932;3600000;0
1114;4450;5;98;17;0;17;1.000;3600000;0
1114;19823;5;0;0;0;0;.00nan;0;0
1114;20853;9;0;0;0;0;.00nan;0;0
1115;61;31;31;24;5;19;.792;1986000;0
1115;1821;3;63;24;2;22;.917;3600000;0
1115;2054;3;0;0;0;0;.00nan;0;0
1115;34797;31;42;10;2;8;.800;1614000;0
1116;51;21;63;28;3;25;.893;3600000;0
1116;18104;10;51;2;0;2;1.000;425000;0
1116;25843;21;0;0;0;0;.00nan;0;0
1116;27488;10;28;39;8;31;.795;3175000;0
1117;1251;14;0;0;0;0;.00nan;0;0
1117;13842;34;91;46;2;44;.957;3600000;0
1117;15502;34;0;0;0;0;.00nan;0;0
1117;25584;14;64;30;3;27;.900;3570000;0
1118;1614;25;83;41;3;38;.927;3539000;0
1118;2423;15;80;26;2;24;.923;3600000;0
1118;5182;25;0;0;0;0;.00nan;0;0
1118;31858;15;0;0;0;0;.00nan;0;0
1119;262;35;0;0;0;0;.00nan;0;0
1119;1430;35;93;41;2;39;.951;3600000;0
1119;15464;32;0;0;0;0;.00nan;0;0
1119;31643;32;81;44;3;41;.932;3569000;0
1120;376;12;0;0;0;0;.00nan;0;0
1120;928;20;0;0;0;0;.00nan;0;0
1120;18078;20;41;27;5;22;.815;3600000;0
1120;34786;12;100;29;0;29;1.000;3600000;0
1121;738;27;73;30;2;28;.933;3744000;0
1121;823;23;100;33;1;32;.970;3744000;0
1121;10274;23;0;0;0;0;.00nan;0;0
1121;26623;27;0;0;0;0;.00nan;0;0
1122;233;29;0;0;0;0;.00nan;0;0
1122;18351;29;99;33;1;32;.970;3600000;0
1122;27739;22;0;0;0;0;.00nan;0;0
1122;28026;22;71;43;4;39;.907;3600000;0
1123;1572;4838;86;36;2;34;.944;3600000;0
1123;1796;16;70;31;3;28;.903;3586000;0
1123;2328;4838;0;0;0;0;.00nan;0;0
1123;14321;16;0;0;0;0;.00nan;0;0
1124;323;9;0;0;0;0;.00nan;0;0
1124;4506;33;56;23;2;21;.913;3600000;0
1124;20853;9;68;29;3;26;.897;3558000;0
1124;34740;33;0;0;0;0;.00nan;0;0
1125;544;19;0;0;0;0;.00nan;0;0
1125;1913;30;0;0;0;0;.00nan;0;0
1125;4826;30;68;31;3;28;.903;3600000;0
1125;31124;19;36;18;4;14;.778;3581000;0
1126;335;18;0;0;0;0;.00nan;0;0
1126;500;4182;63;21;2;19;.905;3900000;0
1126;5001;18;72;24;2;22;.917;3900000;0
1126;25521;4182;0;0;0;0;.00nan;0;0
1127;51;21;100;41;2;39;.951;3600000;0
1127;2058;28;0;0;0;0;.00nan;0;0
1127;25843;21;0;0;0;0;.00nan;0;0
1127;26824;28;48;19;3;16;.842;3563000;0
1128;2423;15;41;26;4;22;.846;3600000;0
1128;18104;10;100;35;0;35;1.000;3600000;0
1128;27488;10;0;0;0;0;.00nan;0;0
1128;31858;15;0;0;0;0;.00nan;0;0
1129;5385;17;22;26;7;19;.731;1803000;0
1129;10103;24;75;28;1;27;.964;3600000;0
1129;13979;24;0;0;0;0;.00nan;0;0
1129;34006;17;67;24;2;22;.917;1797000;0
1130;1251;14;44;32;5;27;.844;3590000;0
1130;13842;34;0;0;0;0;.00nan;0;0
1130;15502;34;77;35;3;32;.914;3600000;0
1130;25584;14;0;0;0;0;.00nan;0;0
1131;1572;4838;0;0;0;0;.00nan;0;0
1131;2328;4838;96;22;0;22;1.000;3600000;0
1131;15505;8;0;0;0;0;.00nan;0;0
1131;16006;8;92;42;2;40;.952;3588000;0
1132;376;12;0;0;0;0;.00nan;0;0
1132;1821;3;0;0;0;0;.00nan;0;0
1132;2054;3;81;26;1;25;.962;3600000;0
1132;34786;12;76;33;3;30;.909;3530000;0
1133;335;18;0;0;0;0;.00nan;0;0
1133;3281;26;58;42;5;37;.881;3554000;0
1133;5001;18;57;37;4;33;.892;3600000;0
1133;32754;26;0;0;0;0;.00nan;0;0
1134;724;11;52;27;3;24;.889;3900000;0
1134;823;23;0;0;0;0;.00nan;0;0
1134;10274;23;82;37;3;34;.919;3900000;0
1134;21522;11;0;0;0;0;.00nan;0;0
1135;544;19;47;33;5;28;.848;3600000;0
1135;738;27;0;0;0;0;.00nan;0;0
1135;26623;27;78;23;1;22;.957;3600000;0
1135;31124;19;0;0;0;0;.00nan;0;0
1136;233;29;0;0;0;0;.00nan;0;0
1136;4450;5;0;0;0;0;.00nan;0;0
1136;18351;29;62;24;3;21;.875;3600000;0
1136;19823;5;70;46;5;41;.891;3549000;0
1137;61;31;0;0;0;0;.00nan;0;0
1137;5385;17;0;0;0;0;.00nan;0;0
1137;34006;17;98;51;2;49;.961;3568000;0
1137;34797;31;57;14;1;13;.929;3600000;0
1138;928;20;0;0;0;0;.00nan;0;0
1138;10103;24;0;0;0;0;.00nan;0;0
1138;13979;24;59;27;3;24;.889;3558000;0
1138;18078;20;97;39;2;37;.949;3600000;0
1139;262;35;0;0;0;0;.00nan;0;0
1139;1430;35;84;22;1;21;.955;3600000;0
1139;1796;16;100;33;0;33;1.000;3600000;0
1139;14321;16;0;0;0;0;.00nan;0;0
1140;1614;25;91;42;3;39;.929;3600000;0
1140;4506;33;60;31;4;27;.871;3550000;0
1140;5182;25;0;0;0;0;.00nan;0;0
1140;34740;33;0;0;0;0;.00nan;0;0
1141;717;0;0;0;0;0;.00nan;0;0
1141;1074;0;56;51;8;43;.843;3600000;0
1141;1821;3;0;0;0;0;.00nan;0;0
1141;2054;3;100;25;0;25;1.000;3600000;0
1142;323;9;72;25;2;23;.920;3600000;0
1142;13842;34;52;31;4;27;.871;3538000;0
1142;15502;34;0;0;0;0;.00nan;0;0
1142;20853;9;0;0;0;0;.00nan;0;0
1143;2058;28;50;27;4;23;.852;3600000;0
1143;18104;10;43;34;6;28;.824;3600000;0
1143;26824;28;0;0;0;0;.00nan;0;0
1143;27488;10;0;0;0;0;.00nan;0;0
1144;1251;14;0;0;0;0;.00nan;0;0
1144;1913;30;0;0;0;0;.00nan;0;0
1144;4826;30;56;37;5;32;.865;3600000;0
1144;25584;14;91;18;0;18;1.000;3600000;0
1145;2423;15;76;23;1;22;.957;3600000;0
1145;27739;22;0;0;0;0;.00nan;0;0
1145;28026;22;80;37;3;34;.919;3582000;0
1145;31858;15;0;0;0;0;.00nan;0;0
1146;928;20;0;0;0;0;.00nan;0;0
1146;1796;16;83;37;3;34;.919;3900000;0
1146;14321;16;0;0;0;0;.00nan;0;0
1146;18078;20;67;27;3;24;.889;3900000;0
1147;61;31;79;44;3;41;.932;3566000;0
1147;15464;32;0;0;0;0;.00nan;0;0
1147;31643;32;98;33;1;32;.970;3600000;0
1147;34797;31;0;0;0;0;.00nan;0;0
1148;51;21;88;28;2;26;.929;3600000;0
1148;376;12;36;30;6;24;.800;3600000;0
1148;25843;21;0;0;0;0;.00nan;0;0
1148;34786;12;0;0;0;0;.00nan;0;0
1149;262;35;71;49;5;44;.898;3730000;0
1149;724;11;62;30;4;26;.867;3730000;0
1149;1430;35;0;0;0;0;.00nan;0;0
1149;21522;11;0;0;0;0;.00nan;0;0
1150;823;23;83;46;4;42;.913;3563000;0
1150;1614;25;82;36;3;33;.917;3600000;0
1150;5182;25;0;0;0;0;.00nan;0;0
1150;10274;23;0;0;0;0;.00nan;0;0
1151;335;18;0;0;0;0;.00nan;0;0
1151;738;27;0;0;0;0;.00nan;0;0
1151;5001;18;78;27;1;26;.963;3900000;0
1151;26623;27;76;23;1;22;.957;3900000;0
1152;500;4182;58;13;1;12;.923;3600000;0
1152;3281;26;40;44;7;37;.841;3356000;0
1152;25521;4182;0;0;0;0;.00nan;0;0
1152;32754;26;41;2;1;1;.500;244000;0
1153;544;19;0;0;0;0;.00nan;0;0
1153;1572;4838;0;0;0;0;.00nan;0;0
1153;2328;4838;83;44;3;41;.932;3588000;0
1153;31124;19;81;27;1;26;.963;3600000;0
1154;2058;28;0;0;0;0;.00nan;0;0
1154;4506;33;100;37;1;36;.973;3600000;0
1154;26824;28;66;44;5;39;.886;3600000;0
1154;34740;33;0;0;0;0;.00nan;0;0
1155;233;29;0;0;0;0;.00nan;0;0
1155;5385;17;82;48;3;45;.938;3600000;0
1155;18351;29;89;15;0;15;1.000;3600000;0
1155;34006;17;0;0;0;0;.00nan;0;0
1156;2423;15;82;24;1;23;.958;3890000;0
1156;15464;32;97;42;1;41;.976;3900000;0
1156;31643;32;0;0;0;0;.00nan;0;0
1156;31858;15;0;0;0;0;.00nan;0;0
1157;4450;5;0;0;0;0;.00nan;0;0
1157;19823;5;70;15;1;14;.933;3600000;0
1157;27739;22;51;45;6;39;.867;3600000;0
1157;28026;22;0;0;0;0;.00nan;0;0
1158;1913;30;80;48;5;43;.896;3600000;0
1158;4826;30;0;0;0;0;.00nan;0;0
1158;10103;24;80;32;2;30;.938;3600000;0
1158;13979;24;0;0;0;0;.00nan;0;0
1159;376;12;0;0;0;0;.00nan;0;0
1159;15505;8;0;0;0;0;.00nan;0;0
1159;16006;8;77;29;2;27;.931;3600000;0
1159;34786;12;66;27;3;24;.889;3600000;0
1160;500;4182;98;28;1;27;.964;3900000;0
1160;738;27;95;41;1;40;.976;3900000;0
1160;25521;4182;0;0;0;0;.00nan;0;0
1160;26623;27;0;0;0;0;.00nan;0;0
1161;717;0;0;0;0;0;.00nan;0;0
1161;1074;0;93;45;1;44;.978;3600000;0
1161;4506;33;0;0;0;0;.00nan;0;0
1161;34740;33;58;27;3;24;.889;3530000;0
1162;262;35;0;0;0;0;.00nan;0;0
1162;823;23;68;27;3;24;.889;3900000;0
1162;1430;35;60;35;3;32;.914;3900000;0
1162;10274;23;0;0;0;0;.00nan;0;0
1163;1796;16;38;29;5;24;.828;3600000;0
1163;4450;5;0;0;0;0;.00nan;0;0
1163;14321;16;0;0;0;0;.00nan;0;0
1163;19823;5;91;33;2;31;.939;3600000;0
1164;1821;3;0;0;0;0;.00nan;0;0
1164;2054;3;65;22;2;20;.909;3600000;0
1164;5385;17;96;44;3;41;.932;3572000;0
1164;34006;17;0;0;0;0;.00nan;0;0
1165;323;9;42;31;5;26;.839;3514000;0
1165;2058;28;56;28;3;25;.893;3600000;0
1165;20853;9;0;0;0;0;.00nan;0;0
1165;26824;28;0;0;0;0;.00nan;0;0
1166;61;31;0;0;0;0;.00nan;0;0
1166;1913;30;0;0;0;0;.00nan;0;0
1166;4826;30;83;30;2;28;.933;3548000;0
1166;34797;31;100;31;0;31;1.000;3600000;0
1167;10103;24;74;39;4;35;.897;3600000;0
1167;13979;24;0;0;0;0;.00nan;0;0
1167;18104;10;52;38;5;33;.868;3600000;0
1167;27488;10;0;0;0;0;.00nan;0;0
1168;2423;15;82;17;0;17;1.000;3600000;0
1168;13842;34;0;0;0;0;.00nan;0;0
1168;15502;34;98;51;3;48;.941;3600000;0
1168;31858;15;0;0;0;0;.00nan;0;0
1169;1251;14;0;0;0;0;.00nan;0;0
1169;25584;14;75;40;4;36;.900;3600000;0
1169;27739;22;59;9;0;9;1.000;1239000;0
1169;28026;22;41;32;6;26;.813;2323000;0
1170;738;27;0;0;0;0;.00nan;0;0
1170;15505;8;0;0;0;0;.00nan;0;0
1170;16006;8;100;24;0;24;1.000;3600000;0
1170;26623;27;71;39;4;35;.897;3600000;0
1171;823;23;0;0;0;0;.00nan;0;0
1171;10274;23;53;26;4;22;.846;3600000;0
1171;15464;32;0;0;0;0;.00nan;0;0
1171;31643;32;35;26;5;21;.808;3600000;0
1172;233;29;0;0;0;0;.00nan;0;0
1172;445;12;0;0;0;0;.00nan;0;0
1172;18351;29;82;33;3;30;.909;3600000;0
1172;34786;12;100;27;0;27;1.000;3600000;0
1173;544;19;75;22;1;21;.955;3900000;0
1173;1572;4838;0;0;0;0;.00nan;0;0
1173;2328;4838;100;38;1;37;.974;3900000;0
1173;31124;19;0;0;0;0;.00nan;0;0
1174;335;18;0;0;0;0;.00nan;0;0
1174;500;4182;86;31;1;30;.968;3727000;0
1174;5001;18;82;38;2;36;.947;3727000;0
1174;25521;4182;0;0;0;0;.00nan;0;0
1175;51;21;89;29;1;28;.966;3600000;0
1175;3281;26;71;28;3;25;.893;3519000;0
1175;25843;21;0;0;0;0;.00nan;0;0
1175;32754;26;0;0;0;0;.00nan;0;0
1176;1251;14;60;50;6;44;.880;3130000;0
1176;18104;10;0;0;0;0;.00nan;0;0
1176;25584;14;44;5;1;4;.800;470000;0
1176;27488;10;86;27;1;26;.963;3600000;0
1177;717;0;0;0;0;0;.00nan;0;0
1177;1074;0;79;34;3;31;.912;3900000;0
1177;13842;34;49;25;3;22;.880;3900000;0
1177;15502;34;0;0;0;0;.00nan;0;0
1178;1572;4838;76;18;1;17;.944;3600000;0
1178;2328;4838;0;0;0;0;.00nan;0;0
1178;4506;33;97;45;2;43;.956;3547000;0
1178;34740;33;0;0;0;0;.00nan;0;0
1179;724;11;100;18;0;18;1.000;3600000;0
1179;1614;25;81;50;4;46;.920;3600000;0
1179;5182;25;0;0;0;0;.00nan;0;0
1179;21522;11;0;0;0;0;.00nan;0;0
1180;2058;28;85;29;1;28;.966;3600000;0
1180;4450;5;0;0;0;0;.00nan;0;0
1180;19823;5;72;28;2;26;.929;3573000;0
1180;26824;28;0;0;0;0;.00nan;0;0
1181;1796;16;78;30;2;28;.933;3600000;0
1181;5385;17;98;30;0;30;1.000;3600000;0
1181;14321;16;0;0;0;0;.00nan;0;0
1181;34006;17;0;0;0;0;.00nan;0;0
1182;1821;3;0;0;0;0;.00nan;0;0
1182;2054;3;100;34;0;34;1.000;3670000;0
1182;27739;22;0;0;0;0;.00nan;0;0
1182;28026;22;75;23;1;22;.957;3670000;0
1183;233;29;0;0;0;0;.00nan;0;0
1183;1913;30;100;36;1;35;.972;3900000;0
1183;4826;30;0;0;0;0;.00nan;0;0
1183;18351;29;83;27;1;26;.963;3900000;0
1184;928;20;0;0;0;0;.00nan;0;0
1184;2423;15;97;34;1;33;.971;3600000;0
1184;18078;20;74;26;2;24;.923;3590000;0
1184;31858;15;0;0;0;0;.00nan;0;0
1185;323;9;43;27;4;23;.852;3600000;0
1185;10103;24;100;25;0;25;1.000;3600000;0
1185;13979;24;0;0;0;0;.00nan;0;0
1185;20853;9;0;0;0;0;.00nan;0;0
1186;724;11;79;19;1;18;.947;3600000;0
1186;15505;8;0;0;0;0;.00nan;0;0
1186;16006;8;98;52;3;49;.942;3556000;0
1186;21522;11;0;0;0;0;.00nan;0;0
1187;738;27;0;0;0;0;.00nan;0;0
1187;15464;32;0;0;0;0;.00nan;0;0
1187;26623;27;71;35;3;32;.914;3600000;0
1187;31643;32;60;39;4;35;.897;3588000;0
1188;262;35;0;0;0;0;.00nan;0;0
1188;445;12;0;0;0;0;.00nan;0;0
1188;1430;35;74;32;2;30;.938;3600000;0
1188;34786;12;78;23;1;22;.957;3600000;0
1189;51;21;57;31;3;28;.903;3900000;0
1189;1614;25;0;0;0;0;.00nan;0;0
1189;5182;25;59;26;3;23;.885;3900000;0
1189;25843;21;0;0;0;0;.00nan;0;0
1190;500;4182;75;20;1;19;.950;3600000;0
1190;544;19;0;0;0;0;.00nan;0;0
1190;25521;4182;0;0;0;0;.00nan;0;0
1190;31124;19;62;35;3;32;.914;3600000;0
1191;335;18;0;0;0;0;.00nan;0;0
1191;3281;26;65;31;3;28;.903;3600000;0
1191;5001;18;54;29;4;25;.862;3592000;0
1191;32754;26;0;0;0;0;.00nan;0;0
1192;717;0;0;0;0;0;.00nan;0;0
1192;928;20;0;0;0;0;.00nan;0;0
1192;1074;0;73;48;5;43;.896;3600000;0
1192;18078;20;50;13;2;11;.846;3600000;0
1193;61;31;0;0;0;0;.00nan;0;0
1193;4506;33;95;43;2;41;.953;3589000;0
1193;34740;33;0;0;0;0;.00nan;0;0
1193;34797;31;87;24;1;23;.958;3600000;0
1194;500;4182;72;30;3;27;.900;3600000;0
1194;823;23;55;37;4;33;.892;3568000;0
1194;10274;23;0;0;0;0;.00nan;0;0
1194;25521;4182;0;0;0;0;.00nan;0;0
1195;2423;15;95;54;3;51;.944;3600000;0
1195;4450;5;0;0;0;0;.00nan;0;0
1195;19823;5;50;31;4;27;.871;3556000;0
1195;31858;15;0;0;0;0;.00nan;0;0
1196;1251;14;0;0;0;0;.00nan;0;0
1196;5385;17;92;40;1;39;.975;3600000;0
1196;25584;14;52;15;2;13;.867;3564000;0
1196;34006;17;0;0;0;0;.00nan;0;0
1197;717;0;78;36;3;33;.917;3600000;0
1197;1074;0;0;0;0;0;.00nan;0;0
1197;27739;22;0;0;0;0;.00nan;0;0
1197;28026;22;69;23;2;21;.913;3600000;0
1198;1821;3;0;0;0;0;.00nan;0;0
1198;2054;3;80;41;3;38;.927;3600000;0
1198;2058;28;0;0;0;0;.00nan;0;0
1198;26824;28;68;32;4;28;.875;3542000;0
1199;233;29;0;0;0;0;.00nan;0;0
1199;4506;33;0;0;0;0;.00nan;0;0
1199;18351;29;53;18;2;16;.889;3600000;0
1199;34740;33;80;54;5;49;.907;3600000;0
1200;323;9;45;35;5;30;.857;3600000;0
1200;18104;10;72;32;3;29;.906;3600000;0
1200;20853;9;0;0;0;0;.00nan;0;0
1200;27488;10;0;0;0;0;.00nan;0;0
1201;262;35;0;0;0;0;.00nan;0;0
1201;1430;35;45;36;6;30;.833;3600000;0
1201;1796;16;98;34;1;33;.971;3600000;0
1201;14321;16;0;0;0;0;.00nan;0;0
1202;15464;32;0;0;0;0;.00nan;0;0
1202;15505;8;0;0;0;0;.00nan;0;0
1202;16006;8;70;22;2;20;.909;3555000;0
1202;31643;32;96;33;1;32;.970;3600000;0
1203;445;12;0;0;0;0;.00nan;0;0
1203;738;27;55;4;0;4;1.000;822000;0
1203;26623;27;20;22;6;16;.727;2778000;0
1203;34786;12;50;16;3;13;.813;3600000;0
1204;1614;25;57;31;4;27;.871;3600000;0
1204;5182;25;0;0;0;0;.00nan;0;0
1204;10103;24;100;25;0;25;1.000;3600000;0
1204;13979;24;0;0;0;0;.00nan;0;0
1205;544;19;50;17;2;15;.882;3600000;0
1205;3281;26;32;30;6;24;.800;3600000;0
1205;31124;19;0;0;0;0;.00nan;0;0
1205;32754;26;0;0;0;0;.00nan;0;0
1206;335;18;0;0;0;0;.00nan;0;0
1206;823;23;0;0;0;0;.00nan;0;0
1206;5001;18;46;22;4;18;.818;3778000;0
1206;10274;23;86;39;3;36;.923;3778000;0
1207;724;11;86;29;1;28;.966;3105000;0
1207;13842;34;0;0;0;0;.00nan;0;0
1207;15502;34;78;52;5;47;.904;3600000;0
1207;21522;11;30;7;3;4;.571;495000;0
1208;51;21;82;32;3;29;.906;3600000;0
1208;1572;4838;33;11;3;8;.727;497000;0
1208;2328;4838;64;33;3;30;.909;3103000;0
1208;25843;21;0;0;0;0;.00nan;0;0
1209;61;31;0;0;0;0;.00nan;0;0
1209;323;9;0;0;0;0;.00nan;0;0
1209;20853;9;89;37;2;35;.946;3515000;0
1209;34797;31;86;17;0;17;1.000;3600000;0
1210;928;20;81;30;2;28;.933;3645000;0
1210;1821;3;100;46;1;45;.978;3645000;0
1210;2054;3;0;0;0;0;.00nan;0;0
1210;18078;20;0;0;0;0;.00nan;0;0
1211;1251;14;91;31;1;30;.968;3600000;0
1211;5385;17;0;0;0;0;.00nan;0;0
1211;25584;14;0;0;0;0;.00nan;0;0
1211;34006;17;95;43;2;41;.953;3600000;0
1212;1796;16;75;24;2;22;.917;3600000;0
1212;14321;16;0;0;0;0;.00nan;0;0
1212;15464;32;89;31;1;30;.968;3600000;0
1212;31643;32;0;0;0;0;.00nan;0;0
1213;262;35;59;31;4;27;.871;3600000;0
1213;738;27;74;44;5;39;.886;3544000;0
1213;1430;35;0;0;0;0;.00nan;0;0
1213;26623;27;0;0;0;0;.00nan;0;0
1214;1913;30;0;0;0;0;.00nan;0;0
1214;4826;30;99;36;1;35;.972;3600000;0
1214;13842;34;58;27;3;24;.889;3541000;0
1214;15502;34;0;0;0;0;.00nan;0;0
1215;1614;25;75;29;2;27;.931;3900000;0
1215;5182;25;0;0;0;0;.00nan;0;0
1215;27739;22;0;0;0;0;.00nan;0;0
1215;28026;22;75;38;2;36;.947;3900000;0
1216;335;18;0;0;0;0;.00nan;0;0
1216;445;12;0;0;0;0;.00nan;0;0
1216;5001;18;69;34;3;31;.912;3600000;0
1216;34786;12;75;30;2;28;.933;3600000;0
1217;3281;26;0;0;0;0;.00nan;0;0
1217;10103;24;97;23;0;23;1.000;3600000;0
1217;13979;24;0;0;0;0;.00nan;0;0
1217;32754;26;98;36;1;35;.972;3578000;0
1218;51;21;61;25;3;22;.880;3600000;0
1218;500;4182;40;24;4;20;.833;3562000;0
1218;25521;4182;0;0;0;0;.00nan;0;0
1218;25843;21;0;0;0;0;.00nan;0;0
1219;1251;14;0;0;0;0;.00nan;0;0
1219;1821;3;0;0;0;0;.00nan;0;0
1219;2054;3;89;33;2;31;.939;3647000;0
1219;25584;14;75;30;3;27;.900;3647000;0
1220;262;35;98;42;2;40;.952;3600000;0
1220;717;0;0;0;0;0;.00nan;0;0
1220;1074;0;71;30;3;27;.900;3576000;0
1220;1430;35;0;0;0;0;.00nan;0;0
1221;233;29;0;0;0;0;.00nan;0;0
1221;323;9;75;37;3;34;.919;3600000;0
1221;18351;29;41;22;5;17;.773;3558000;0
1221;20853;9;0;0;0;0;.00nan;0;0
1222;61;31;0;0;0;0;.00nan;0;0
1222;928;20;0;0;0;0;.00nan;0;0
1222;18078;20;77;28;2;26;.929;3900000;0
1222;34797;31;67;24;2;22;.917;3900000;0
1223;4506;33;55;29;4;25;.862;3695000;0
1223;18104;10;51;25;3;22;.880;3695000;0
1223;27488;10;0;0;0;0;.00nan;0;0
1223;34740;33;0;0;0;0;.00nan;0;0
1224;1796;16;55;30;4;26;.867;3600000;0
1224;4450;5;0;0;0;0;.00nan;0;0
1224;14321;16;0;0;0;0;.00nan;0;0
1224;19823;5;88;28;1;27;.964;3600000;0
1225;724;11;87;29;1;28;.966;3600000;0
1225;1913;30;45;36;6;30;.833;3319000;0
1225;4826;30;49;1;0;1;1.000;281000;0
1225;21522;11;0;0;0;0;.00nan;0;0
1226;738;27;0;0;0;0;.00nan;0;0
1226;13842;34;60;40;6;34;.850;3600000;0
1226;15502;34;0;0;0;0;.00nan;0;0
1226;26623;27;68;30;3;27;.900;3600000;0
1227;2058;28;75;30;2;28;.933;3600000;0
1227;5385;17;81;42;4;38;.905;3600000;0
1227;26824;28;0;0;0;0;.00nan;0;0
1227;34006;17;0;0;0;0;.00nan;0;0
1228;445;12;0;0;0;0;.00nan;0;0
1228;823;23;78;26;1;25;.962;3689000;0
1228;10274;23;0;0;0;0;.00nan;0;0
1228;34786;12;93;42;2;40;.952;3689000;0
1229;3281;26;54;34;5;29;.853;3591000;0
1229;15505;8;0;0;0;0;.00nan;0;0
1229;16006;8;68;36;4;32;.889;3600000;0
1229;32754;26;0;0;0;0;.00nan;0;0
1230;500;4182;95;35;1;34;.971;3600000;0
1230;25521;4182;0;0;0;0;.00nan;0;0
1230;27739;22;0;0;0;0;.00nan;0;0
1230;28026;22;94;38;2;36;.947;3578000;0
1231;1572;4838;0;0;0;0;.00nan;0;0
1231;1614;25;73;33;3;30;.909;3600000;0
1231;2328;4838;40;30;5;25;.833;3542000;0
1231;5182;25;0;0;0;0;.00nan;0;0
1232;717;0;0;0;0;0;.00nan;0;0
1232;1074;0;89;35;3;32;.914;3900000;0
1232;1251;14;0;0;0;0;.00nan;0;0
1232;25584;14;76;36;3;33;.917;3900000;0
1233;233;29;38;15;3;12;.800;2075000;0
1233;1821;3;0;0;0;0;.00nan;0;0
1233;2054;3;99;43;2;41;.953;3600000;0
1233;18351;29;29;16;4;12;.750;1525000;0
1234;61;31;0;0;0;0;.00nan;0;0
1234;323;9;75;34;3;31;.912;3900000;0
1234;20853;9;0;0;0;0;.00nan;0;0
1234;34797;31;56;18;3;15;.833;3900000;0
1235;51;21;0;0;0;0;.00nan;0;0
1235;5385;17;0;0;0;0;.00nan;0;0
1235;25843;21;78;32;2;30;.938;3526000;0
1235;34006;17;91;35;1;34;.971;3600000;0
1236;928;20;0;0;0;0;.00nan;0;0
1236;18078;20;82;40;3;37;.925;3600000;0
1236;18104;10;42;29;4;25;.862;3577000;0
1236;27488;10;0;0;0;0;.00nan;0;0
1237;2423;15;100;41;2;39;.951;3900000;0
1237;4450;5;0;0;0;0;.00nan;0;0
1237;19823;5;81;35;2;33;.943;3900000;0
1237;31858;15;0;0;0;0;.00nan;0;0
1238;4506;33;56;36;5;31;.861;3564000;0
1238;10103;24;63;31;3;28;.903;3600000;0
1238;13979;24;0;0;0;0;.00nan;0;0
1238;34740;33;0;0;0;0;.00nan;0;0
1239;262;35;0;0;0;0;.00nan;0;0
1239;335;18;0;0;0;0;.00nan;0;0
1239;1430;35;99;41;2;39;.951;3900000;0
1239;5001;18;80;33;2;31;.939;3900000;0
1240;445;12;74;31;2;29;.935;3900000;0
1240;544;19;92;42;2;40;.952;3900000;0
1240;31124;19;0;0;0;0;.00nan;0;0
1240;34786;12;0;0;0;0;.00nan;0;0
1241;724;11;69;22;2;20;.909;3600000;0
1241;15505;8;0;0;0;0;.00nan;0;0
1241;16006;8;66;36;4;32;.889;3568000;0
1241;21522;11;0;0;0;0;.00nan;0;0
1242;738;27;0;0;0;0;.00nan;0;0
1242;1796;16;95;43;2;41;.953;3600000;0
1242;14321;16;0;0;0;0;.00nan;0;0
1242;26623;27;75;33;3;30;.909;3568000;0
1243;2058;28;0;0;0;0;.00nan;0;0
1243;13842;34;0;0;0;0;.00nan;0;0
1243;15502;34;95;36;2;34;.944;3600000;0
1243;26824;28;31;16;4;12;.750;3565000;0
1244;262;35;47;29;4;25;.862;3600000;0
1244;1430;35;0;0;0;0;.00nan;0;0
1244;1572;4838;53;21;3;18;.857;3600000;0
1244;2328;4838;0;0;0;0;.00nan;0;0
1245;823;23;100;25;0;25;1.000;3600000;0
1245;1614;25;97;35;1;34;.971;3582000;0
1245;5182;25;0;0;0;0;.00nan;0;0
1245;10274;23;0;0;0;0;.00nan;0;0
1246;3281;26;90;38;2;36;.947;3600000;0
1246;27739;22;0;0;0;0;.00nan;0;0
1246;28026;22;56;35;4;31;.886;3525000;0
1246;32754;26;0;0;0;0;.00nan;0;0
1247;4450;5;0;0;0;0;.00nan;0;0
1247;18104;10;0;0;0;0;.00nan;0;0
1247;19823;5;91;31;2;29;.935;3600000;0
1247;27488;10;36;35;6;29;.829;3600000;0
1248;928;20;0;0;0;0;.00nan;0;0
1248;5385;17;0;0;0;0;.00nan;0;0
1248;18078;20;75;23;2;21;.913;3600000;0
1248;34006;17;60;30;3;27;.900;3541000;0
1249;717;0;0;0;0;0;.00nan;0;0
1249;1074;0;98;35;1;34;.971;3600000;0
1249;2058;28;92;37;2;35;.946;3581000;0
1249;26824;28;0;0;0;0;.00nan;0;0
1250;323;9;69;41;3;38;.927;3525000;0
1250;2423;15;92;30;1;29;.967;3600000;0
1250;20853;9;0;0;0;0;.00nan;0;0
1250;31858;15;0;0;0;0;.00nan;0;0
1251;233;29;0;0;0;0;.00nan;0;0
1251;15464;32;0;0;0;0;.00nan;0;0
1251;18351;29;83;35;2;33;.943;3600000;0
1251;31643;32;84;29;1;28;.966;3600000;0
1252;61;31;0;0;0;0;.00nan;0;0
1252;1821;3;48;24;3;21;.875;1082000;0
1252;2054;3;42;37;8;29;.784;2518000;0
1252;34797;31;84;29;2;27;.931;3600000;0
1253;51;21;56;35;5;30;.857;3600000;0
1253;10103;24;78;25;2;23;.920;3600000;0
1253;13979;24;0;0;0;0;.00nan;0;0
1253;25843;21;0;0;0;0;.00nan;0;0
1254;445;12;63;21;2;19;.905;3600000;0
1254;1572;4838;0;0;0;0;.00nan;0;0
1254;2328;4838;70;32;3;29;.906;3573000;0
1254;34786;12;0;0;0;0;.00nan;0;0
1255;335;18;0;0;0;0;.00nan;0;0
1255;544;19;0;0;0;0;.00nan;0;0
1255;5001;18;58;26;4;22;.846;3526000;0
1255;31124;19;78;25;2;23;.920;3600000;0
1256;1796;16;58;17;2;15;.882;3600000;0
1256;3281;26;0;0;0;0;.00nan;0;0
1256;14321;16;0;0;0;0;.00nan;0;0
1256;32754;26;83;42;4;38;.905;3579000;0
1257;724;11;0;0;0;0;.00nan;0;0
1257;1913;30;0;0;0;0;.00nan;0;0
1257;4826;30;77;34;3;31;.912;3600000;0
1257;21522;11;46;24;4;20;.833;3563000;0
1258;738;27;0;0;0;0;.00nan;0;0
1258;15505;8;0;0;0;0;.00nan;0;0
1258;16006;8;56;33;5;28;.848;3600000;0
1258;26623;27;70;27;2;25;.926;3600000;0
1259;61;31;0;0;0;0;.00nan;0;0
1259;233;29;28;14;4;10;.714;926000;0
1259;18351;29;32;28;6;22;.786;2674000;0
1259;34797;31;64;28;3;25;.893;3600000;0
1260;51;21;0;0;0;0;.00nan;0;0
1260;323;9;0;0;0;0;.00nan;0;0
1260;20853;9;82;33;2;31;.939;3561000;0
1260;25843;21;82;26;1;25;.962;3600000;0
1261;928;20;75;45;5;40;.889;3900000;0
1261;10103;24;77;22;1;21;.955;1962000;0
1261;13979;24;42;22;4;18;.818;1938000;0
1261;18078;20;0;0;0;0;.00nan;0;0
1262;4450;5;54;33;4;29;.879;3550000;0
1262;18104;10;84;48;3;45;.938;3600000;0
1262;19823;5;0;0;0;0;.00nan;0;0
1262;27488;10;0;0;0;0;.00nan;0;0
1263;1251;14;90;38;3;35;.921;3570000;0
1263;2423;15;76;31;2;29;.935;3600000;0
1263;25584;14;0;0;0;0;.00nan;0;0
1263;31858;15;0;0;0;0;.00nan;0;0
1264;1821;3;68;44;5;39;.886;3654000;0
1264;2054;3;0;0;0;0;.00nan;0;0
1264;27739;22;0;0;0;0;.00nan;0;0
1264;28026;22;38;20;4;16;.800;3654000;0
1265;823;23;54;33;5;28;.848;3600000;0
1265;10274;23;0;0;0;0;.00nan;0;0
1265;13842;34;49;12;2;10;.833;2234000;0
1265;15502;34;8;15;6;9;.600;1366000;0
1266;262;35;0;0;0;0;.00nan;0;0
1266;1430;35;59;39;6;33;.846;3600000;0
1266;15464;32;23;30;8;22;.733;3600000;0
1266;31643;32;0;0;0;0;.00nan;0;0
1267;1614;25;52;26;4;22;.846;3554000;0
1267;4506;33;61;22;2;20;.909;3600000;0
1267;5182;25;0;0;0;0;.00nan;0;0
1267;34740;33;0;0;0;0;.00nan;0;0
1268;500;4182;95;17;0;17;1.000;3600000;0
1268;738;27;87;61;6;55;.902;3600000;0
1268;25521;4182;0;0;0;0;.00nan;0;0
1268;26623;27;0;0;0;0;.00nan;0;0
1269;1796;16;68;19;1;18;.947;3600000;0
1269;1913;30;79;42;3;39;.929;3600000;0
1269;4826;30;0;0;0;0;.00nan;0;0
1269;14321;16;0;0;0;0;.00nan;0;0
1270;1251;14;0;0;0;0;.00nan;0;0
1270;15505;8;0;0;0;0;.00nan;0;0
1270;16006;8;100;48;2;46;.958;3600000;0
1270;25584;14;61;25;4;21;.840;3600000;0
1271;61;31;0;0;0;0;.00nan;0;0
1271;4450;5;0;0;0;0;.00nan;0;0
1271;19823;5;72;24;2;22;.917;3563000;0
1271;34797;31;95;34;1;33;.971;3600000;0
1272;717;0;0;0;0;0;.00nan;0;0
1272;1074;0;90;32;1;31;.969;3600000;0
1272;5385;17;74;26;2;24;.923;3600000;0
1272;34006;17;0;0;0;0;.00nan;0;0
1273;51;21;75;29;2;27;.931;3600000;0
1273;2058;28;0;0;0;0;.00nan;0;0
1273;25843;21;0;0;0;0;.00nan;0;0
1273;26824;28;72;36;4;32;.889;3554000;0
1274;323;9;92;44;3;41;.932;3900000;0
1274;1821;3;0;0;0;0;.00nan;0;0
1274;2054;3;91;39;3;36;.923;3900000;0
1274;20853;9;0;0;0;0;.00nan;0;0
1275;233;29;0;0;0;0;.00nan;0;0
1275;13842;34;52;31;4;27;.871;3591000;0
1275;15502;34;0;0;0;0;.00nan;0;0
1275;18351;29;68;26;2;24;.923;3600000;0
1276;10103;24;44;25;4;21;.840;3600000;0
1276;13979;24;0;0;0;0;.00nan;0;0
1276;18104;10;100;38;0;38;1.000;3600000;0
1276;27488;10;0;0;0;0;.00nan;0;0
1277;823;23;0;0;0;0;.00nan;0;0
1277;2423;15;47;32;5;27;.844;3558000;0
1277;10274;23;60;33;4;29;.879;3600000;0
1277;31858;15;0;0;0;0;.00nan;0;0
1278;928;20;0;0;0;0;.00nan;0;0
1278;18078;20;78;28;2;26;.929;3600000;0
1278;27739;22;0;0;0;0;.00nan;0;0
1278;28026;22;53;30;4;26;.867;3522000;0
1279;544;19;57;27;3;24;.889;3600000;0
1279;15464;32;0;0;0;0;.00nan;0;0
1279;31124;19;0;0;0;0;.00nan;0;0
1279;31643;32;50;30;5;25;.833;3544000;0
1280;445;12;0;0;0;0;.00nan;0;0
1280;500;4182;56;36;5;31;.861;3600000;0
1280;25521;4182;0;0;0;0;.00nan;0;0
1280;34786;12;92;29;1;28;.966;3600000;0
1281;262;35;63;29;3;26;.897;3600000;0
1281;1430;35;0;0;0;0;.00nan;0;0
1281;3281;26;75;50;5;45;.900;3572000;0
1281;32754;26;0;0;0;0;.00nan;0;0
1282;1614;25;74;35;3;32;.914;3793000;0
1282;1796;16;86;47;4;43;.915;3793000;0
1282;5182;25;0;0;0;0;.00nan;0;0
1282;14321;16;0;0;0;0;.00nan;0;0
1283;335;18;100;23;0;23;1.000;3600000;0
1283;1572;4838;94;45;2;43;.956;3565000;0
1283;2328;4838;0;0;0;0;.00nan;0;0
1283;5001;18;0;0;0;0;.00nan;0;0
1284;738;27;0;0;0;0;.00nan;0;0
1284;1913;30;0;0;0;0;.00nan;0;0
1284;4826;30;73;32;3;29;.906;3558000;0
1284;26623;27;73;20;1;19;.950;3600000;0
1285;500;4182;73;27;1;26;.963;3600000;0
1285;15505;8;0;0;0;0;.00nan;0;0
1285;16006;8;56;23;3;20;.870;3590000;0
1285;25521;4182;0;0;0;0;.00nan;0;0
1286;445;12;74;23;1;22;.957;3600000;0
1286;3281;26;72;55;6;49;.891;3302000;0
1286;32754;26;45;4;1;3;.750;298000;0
1286;34786;12;0;0;0;0;.00nan;0;0
1287;1251;14;62;23;3;20;.870;3781000;0
1287;4506;33;86;40;2;38;.950;3781000;0
1287;25584;14;0;0;0;0;.00nan;0;0
1287;34740;33;0;0;0;0;.00nan;0;0
1288;724;11;68;16;1;15;.938;3600000;0
1288;1572;4838;0;0;0;0;.00nan;0;0
1288;2328;4838;61;30;3;27;.900;3551000;0
1288;21522;11;0;0;0;0;.00nan;0;0
1289;4450;5;0;0;0;0;.00nan;0;0
1289;5385;17;61;7;0;7;1.000;635000;0
1289;19823;5;53;16;2;14;.875;3600000;0
1289;34006;17;37;47;8;39;.830;2965000;0
1290;61;31;0;0;0;0;.00nan;0;0
1290;2058;28;76;37;5;32;.865;3845000;0
1290;26824;28;0;0;0;0;.00nan;0;0
1290;34797;31;70;38;4;34;.895;3845000;0
1291;233;29;0;0;0;0;.00nan;0;0
1291;928;20;0;0;0;0;.00nan;0;0
1291;18078;20;65;36;4;32;.889;3600000;0
1291;18351;29;68;25;1;24;.960;3600000;0
1292;13842;34;78;51;5;46;.902;3600000;0
1292;15502;34;0;0;0;0;.00nan;0;0
1292;27739;22;0;0;0;0;.00nan;0;0
1292;28026;22;60;28;3;25;.893;3600000;0
1293;51;21;80;37;3;34;.919;3540000;0
1293;10103;24;83;28;1;27;.964;3600000;0
1293;13979;24;0;0;0;0;.00nan;0;0
1293;25843;21;0;0;0;0;.00nan;0;0
1294;262;35;75;43;4;39;.907;3731000;0
1294;544;19;62;39;5;34;.872;3731000;0
1294;1430;35;0;0;0;0;.00nan;0;0
1294;31124;19;0;0;0;0;.00nan;0;0
1295;1614;25;88;40;3;37;.925;3544000;0
1295;5182;25;0;0;0;0;.00nan;0;0
1295;15464;32;0;0;0;0;.00nan;0;0
1295;31643;32;82;36;2;34;.944;3600000;0
1296;738;27;0;0;0;0;.00nan;0;0
1296;823;23;100;28;0;28;1.000;3600000;0
1296;10274;23;0;0;0;0;.00nan;0;0
1296;26623;27;95;39;1;38;.974;3600000;0
1297;5385;17;35;29;5;24;.828;3600000;0
1297;15505;8;0;0;0;0;.00nan;0;0
1297;16006;8;89;29;1;28;.966;3600000;0
1297;34006;17;0;0;0;0;.00nan;0;0
1298;1821;3;0;0;0;0;.00nan;0;0
1298;2054;3;96;31;1;30;.968;3600000;0
1298;4450;5;68;42;4;38;.905;3600000;0
1298;19823;5;0;0;0;0;.00nan;0;0
1299;61;31;80;49;4;45;.918;3600000;0
1299;717;0;0;0;0;0;.00nan;0;0
1299;1074;0;89;26;1;25;.962;3600000;0
1299;34797;31;0;0;0;0;.00nan;0;0
1300;51;21;0;0;0;0;.00nan;0;0
1300;323;9;69;32;2;30;.938;3900000;0
1300;20853;9;0;0;0;0;.00nan;0;0
1300;25843;21;58;21;2;19;.905;3900000;0
1301;18104;10;43;33;5;28;.848;3600000;0
1301;27488;10;0;0;0;0;.00nan;0;0
1301;27739;22;88;43;2;41;.953;3600000;0
1301;28026;22;0;0;0;0;.00nan;0;0
1302;1251;14;75;30;2;28;.933;3600000;0
1302;2058;28;60;8;0;8;1.000;703000;0
1302;25584;14;0;0;0;0;.00nan;0;0
1302;26824;28;52;42;6;36;.857;2897000;0
1303;2423;15;84;25;1;24;.960;3900000;0
1303;10103;24;97;42;1;41;.976;3900000;0
1303;13979;24;0;0;0;0;.00nan;0;0
1303;31858;15;0;0;0;0;.00nan;0;0
1304;233;29;100;26;0;26;1.000;3600000;0
1304;13842;34;0;0;0;0;.00nan;0;0
1304;15502;34;76;29;2;27;.931;3577000;0
1304;18351;29;0;0;0;0;.00nan;0;0
1305;500;4182;53;26;4;22;.846;3765000;0
1305;1796;16;0;0;0;0;.00nan;0;0
1305;14321;16;81;35;3;32;.914;3765000;0
1305;25521;4182;0;0;0;0;.00nan;0;0
1306;445;12;0;0;0;0;.00nan;0;0
1306;1913;30;0;0;0;0;.00nan;0;0
1306;4826;30;97;36;1;35;.972;3547000;0
1306;34786;12;92;18;0;18;1.000;3600000;0
1307;262;35;0;0;0;0;.00nan;0;0
1307;1430;35;91;39;2;37;.949;3600000;0
1307;1614;25;0;0;0;0;.00nan;0;0
1307;5182;25;56;29;3;26;.897;3575000;0
1308;544;19;0;0;0;0;.00nan;0;0
1308;4506;33;74;33;3;30;.909;3900000;0
1308;31124;19;86;37;3;34;.919;3900000;0
1308;34740;33;0;0;0;0;.00nan;0;0
1309;335;18;84;24;1;23;.958;3600000;0
1309;724;11;65;39;4;35;.897;3600000;0
1309;5001;18;0;0;0;0;.00nan;0;0
1309;21522;11;0;0;0;0;.00nan;0;0
1310;3281;26;95;35;1;34;.971;3600000;0
1310;15464;32;41;30;5;25;.833;3600000;0
1310;31643;32;0;0;0;0;.00nan;0;0
1310;32754;26;0;0;0;0;.00nan;0;0
1311;738;27;62;37;4;33;.892;3600000;0
1311;1572;4838;34;28;6;22;.786;3119000;0
1311;2328;4838;49;1;0;1;1.000;424000;0
1311;26623;27;0;0;0;0;.00nan;0;0
2701;445;12;0;0;0;0;.00nan;0;0
2701;4450;5;0;0;0;0;.00nan;0;0
2701;19823;5;69;28;3;25;.893;3900000;0
2701;34786;12;58;28;3;25;.893;3900000;0
2703;500;4182;42;15;3;12;.800;3600000;0
2703;1572;4838;0;0;0;0;.00nan;0;0
2703;2328;4838;66;36;4;32;.889;3600000;0
2703;25521;4182;0;0;0;0;.00nan;0;0
2705;61;31;0;0;0;0;.00nan;0;0
2705;335;18;0;0;0;0;.00nan;0;0
2705;5001;18;68;24;2;22;.917;3600000;0
2705;34797;31;69;46;5;41;.891;3600000;0
2707;544;19;99;33;1;32;.970;3600000;0
2707;18104;10;0;0;0;0;.00nan;0;0
2707;27488;10;60;30;3;27;.900;3538000;0
2707;31124;19;0;0;0;0;.00nan;0;0
2709;1796;16;89;21;0;21;1.000;3600000;0
2709;4506;33;98;40;3;37;.925;3600000;0
2709;15437;16;0;0;0;0;.00nan;0;0
2709;34740;33;0;0;0;0;.00nan;0;0
2711;323;9;0;0;0;0;.00nan;0;0
2711;1614;25;68;34;4;30;.882;3572000;0
2711;5182;25;0;0;0;0;.00nan;0;0
2711;20853;9;67;28;2;26;.929;3600000;0
2713;15505;8;40;36;6;30;.833;3600000;0
2713;25076;8;0;0;0;0;.00nan;0;0
2713;27739;22;0;0;0;0;.00nan;0;0
2713;28026;22;81;22;1;21;.955;3600000;0
2715;823;23;76;35;4;31;.886;3900000;0
2715;10274;23;0;0;0;0;.00nan;0;0
2715;16006;20;49;30;4;26;.867;3900000;0
2715;18078;20;0;0;0;0;.00nan;0;0
2717;1251;14;38;15;3;12;.800;586000;0
2717;1821;3;0;0;0;0;.00nan;0;0
2717;2054;3;97;23;0;23;1.000;3600000;0
2717;25584;14;59;33;3;30;.909;3014000;0
2719;51;21;54;21;3;18;.857;3600000;0
2719;13842;34;69;40;4;36;.900;3594000;0
2719;15502;34;0;0;0;0;.00nan;0;0
2719;25843;21;0;0;0;0;.00nan;0;0
2721;262;35;93;32;1;31;.969;3600000;0
2721;1430;35;0;0;0;0;.00nan;0;0
2721;15464;32;73;31;3;28;.903;3529000;0
2721;31643;32;0;0;0;0;.00nan;0;0
2723;738;27;65;30;3;27;.900;3517000;0
2723;22601;26;69;19;1;18;.947;3600000;0
2723;26623;27;0;0;0;0;.00nan;0;0
2723;32754;26;0;0;0;0;.00nan;0;0
2725;724;11;0;0;0;0;.00nan;0;0
2725;5385;17;0;0;0;0;.00nan;0;0
2725;21522;11;69;18;1;17;.944;3600000;0
2725;34006;17;72;43;4;39;.907;3600000;0
2727;2058;28;100;29;0;29;1.000;3600000;0
2727;2423;15;82;34;2;32;.941;3536000;0
2727;4106;15;0;0;0;0;.00nan;0;0
2727;14061;28;0;0;0;0;.00nan;0;0
2729;1074;0;60;42;6;36;.857;3704000;0
2729;10103;24;35;28;5;23;.821;3704000;0
2729;13979;24;0;0;0;0;.00nan;0;0
2729;31035;0;0;0;0;0;.00nan;0;0
2731;233;29;86;30;1;29;.967;3600000;0
2731;1913;30;0;0;0;0;.00nan;0;0
2731;4826;30;84;34;2;32;.941;3560000;0
2731;18351;29;0;0;0;0;.00nan;0;0
2733;1913;30;54;45;6;39;.867;3600000;0
2733;4826;30;0;0;0;0;.00nan;0;0
2733;10103;24;0;0;0;0;.00nan;0;0
2733;13979;24;58;23;3;20;.870;3600000;0
2735;61;31;100;29;0;29;1.000;3600000;0
2735;544;19;72;46;4;42;.913;3600000;0
2735;31124;19;0;0;0;0;.00nan;0;0
2735;34797;31;0;0;0;0;.00nan;0;0
2737;1821;3;0;0;0;0;.00nan;0;0
2737;2054;3;75;25;2;23;.920;3544000;0
2737;22601;26;100;29;0;29;1.000;3600000;0
2737;32754;26;0;0;0;0;.00nan;0;0
2739;823;23;74;20;1;19;.950;3600000;0
2739;1572;4838;60;25;3;22;.880;3582000;0
2739;2328;4838;0;0;0;0;.00nan;0;0
2739;10274;23;0;0;0;0;.00nan;0;0
2741;724;11;0;0;0;0;.00nan;0;0
2741;1614;25;0;0;0;0;.00nan;0;0
2741;5182;25;59;20;2;18;.900;3556000;0
2741;21522;11;96;43;1;42;.977;3600000;0
2743;1074;0;60;37;4;33;.892;3600000;0
2743;27739;22;89;18;0;18;1.000;3600000;0
2743;28026;22;0;0;0;0;.00nan;0;0
2743;31035;0;0;0;0;0;.00nan;0;0
2745;233;29;0;0;0;0;.00nan;0;0
2745;16006;20;0;0;0;0;.00nan;0;0
2745;18078;20;53;15;2;13;.867;3600000;0
2745;18351;29;56;26;3;23;.885;3592000;0
2747;738;27;76;36;3;33;.917;3600000;0
2747;15505;8;24;30;6;24;.800;3289000;0
2747;25076;8;50;1;0;1;1.000;311000;0
2747;26623;27;0;0;0;0;.00nan;0;0
2749;323;9;96;32;1;31;.969;3900000;0
2749;2423;15;0;0;0;0;.00nan;0;0
2749;4106;15;94;28;1;27;.964;3900000;0
2749;20853;9;0;0;0;0;.00nan;0;0
2751;445;12;0;0;0;0;.00nan;0;0
2751;2058;28;83;30;2;28;.933;3600000;0
2751;14061;28;0;0;0;0;.00nan;0;0
2751;34786;12;64;26;3;23;.885;3575000;0
2753;335;18;0;0;0;0;.00nan;0;0
2753;5001;18;59;19;2;17;.895;3600000;0
2753;15464;32;62;37;4;33;.892;3600000;0
2753;31643;32;0;0;0;0;.00nan;0;0
2755;51;21;43;26;4;22;.846;3600000;0
2755;13842;34;48;21;3;18;.857;3600000;0
2755;15502;34;0;0;0;0;.00nan;0;0
2755;25843;21;0;0;0;0;.00nan;0;0
2757;4450;5;0;0;0;0;.00nan;0;0
2757;4506;33;71;42;4;38;.905;3600000;0
2757;19823;5;72;19;1;18;.947;3600000;0
2757;34740;33;0;0;0;0;.00nan;0;0
2759;262;35;0;0;0;0;.00nan;0;0
2759;1251;14;90;32;1;31;.969;3600000;0
2759;1430;35;72;39;4;35;.897;3600000;0
2759;25584;14;0;0;0;0;.00nan;0;0
2761;500;4182;60;42;5;37;.881;3600000;0
2761;18104;10;66;26;2;24;.923;3600000;0
2761;25521;4182;0;0;0;0;.00nan;0;0
2761;27488;10;0;0;0;0;.00nan;0;0
2763;1796;16;58;22;3;19;.864;3600000;0
2763;5385;17;0;0;0;0;.00nan;0;0
2763;15437;16;0;0;0;0;.00nan;0;0
2763;34006;17;81;39;4;35;.897;3600000;0
2765;1251;14;0;0;0;0;.00nan;0;0
2765;1614;25;72;23;2;21;.913;3600000;0
2765;5182;25;0;0;0;0;.00nan;0;0
2765;25584;14;55;32;4;28;.875;3581000;0
2767;724;11;51;29;5;24;.828;3600000;0
2767;2058;28;0;0;0;0;.00nan;0;0
2767;14061;28;85;38;2;36;.947;3600000;0
2767;21522;11;0;0;0;0;.00nan;0;0
2769;335;18;81;47;4;43;.915;3585000;0
2769;738;27;0;0;0;0;.00nan;0;0
2769;5001;18;0;0;0;0;.00nan;0;0
2769;26623;27;71;27;3;24;.889;3600000;0
2771;262;35;42;28;5;23;.821;3600000;0
2771;1430;35;0;0;0;0;.00nan;0;0
2771;1572;4838;0;0;0;0;.00nan;0;0
2771;2328;4838;77;26;1;25;.962;3600000;0
2773;61;31;23;29;7;22;.759;2999000;0
2773;544;19;0;0;0;0;.00nan;0;0
2773;31124;19;99;42;2;40;.952;3600000;0
2773;34797;31;63;6;0;6;1.000;601000;0
2775;10103;24;55;18;2;16;.889;3772000;0
2775;13979;24;0;0;0;0;.00nan;0;0
2775;15464;32;0;0;0;0;.00nan;0;0
2775;31643;32;94;44;3;41;.932;3772000;0
2777;823;23;0;0;0;0;.00nan;0;0
2777;1913;30;0;0;0;0;.00nan;0;0
2777;4826;30;50;32;5;27;.844;3600000;0
2777;10274;23;79;22;1;21;.955;3600000;0
2779;1074;0;0;0;0;0;.00nan;0;0
2779;22601;26;57;31;4;27;.871;3600000;0
2779;31035;0;92;34;1;33;.971;3600000;0
2779;32754;26;0;0;0;0;.00nan;0;0
2781;4450;5;70;29;3;26;.897;3600000;0
2781;4506;33;0;0;0;0;.00nan;0;0
2781;19823;5;0;0;0;0;.00nan;0;0
2781;34740;33;63;44;5;39;.886;3563000;0
2783;500;4182;0;0;0;0;.00nan;0;0
2783;25521;4182;52;26;4;22;.846;3600000;0
2783;27739;22;0;0;0;0;.00nan;0;0
2783;28026;22;99;39;1;38;.974;3600000;0
2785;5385;17;56;28;4;24;.857;3600000;0
2785;13842;34;0;0;0;0;.00nan;0;0
2785;15502;34;100;32;0;32;1.000;3600000;0
2785;34006;17;0;0;0;0;.00nan;0;0
2787;51;21;0;0;0;0;.00nan;0;0
2787;15505;8;0;0;0;0;.00nan;0;0
2787;25076;8;52;23;3;20;.870;3600000;0
2787;25843;21;58;36;5;31;.861;3561000;0
2789;233;29;97;33;1;32;.970;3600000;0
2789;445;12;52;49;7;42;.857;3600000;0
2789;18351;29;0;0;0;0;.00nan;0;0
2789;34786;12;0;0;0;0;.00nan;0;0
2791;323;9;0;0;0;0;.00nan;0;0
2791;18104;10;0;0;0;0;.00nan;0;0
2791;20853;9;76;43;5;38;.884;3600000;0
2791;27488;10;31;29;6;23;.793;3546000;0
2793;1821;3;80;26;1;25;.962;3600000;0
2793;2054;3;0;0;0;0;.00nan;0;0
2793;16006;20;66;36;3;33;.917;3566000;0
2793;18078;20;0;0;0;0;.00nan;0;0
2795;1796;16;0;0;0;0;.00nan;0;0
2795;2423;15;80;45;4;41;.911;3575000;0
2795;4106;15;0;0;0;0;.00nan;0;0
2795;15437;16;60;21;2;19;.905;3600000;0
2797;5385;17;0;0;0;0;.00nan;0;0
2797;13842;34;0;0;0;0;.00nan;0;0
2797;15502;34;87;32;2;30;.938;3600000;0
2797;34006;17;72;43;5;38;.884;3600000;0
2799;15464;32;68;32;4;28;.875;3584000;0
2799;18104;10;72;33;3;30;.909;3600000;0
2799;27488;10;0;0;0;0;.00nan;0;0
2799;31643;32;0;0;0;0;.00nan;0;0
2801;445;12;0;0;0;0;.00nan;0;0
2801;10103;24;0;0;0;0;.00nan;0;0
2801;13979;24;87;40;2;38;.950;3600000;0
2801;34786;12;66;26;3;23;.885;3545000;0
2803;323;9;85;32;2;30;.938;3600000;0
2803;2058;28;52;29;4;25;.862;3573000;0
2803;14061;28;0;0;0;0;.00nan;0;0
2803;20853;9;0;0;0;0;.00nan;0;0
2805;823;23;0;0;0;0;.00nan;0;0
2805;1821;3;0;0;0;0;.00nan;0;0
2805;2054;3;81;39;4;35;.897;3577000;0
2805;10274;23;43;14;3;11;.786;3600000;0
2807;335;18;100;32;0;32;1.000;3600000;0
2807;1572;4838;0;0;0;0;.00nan;0;0
2807;2328;4838;70;24;2;22;.917;3600000;0
2807;5001;18;0;0;0;0;.00nan;0;0
2809;1913;30;59;28;4;24;.857;3553000;0
2809;4826;30;0;0;0;0;.00nan;0;0
2809;16006;20;0;0;0;0;.00nan;0;0
2809;18078;20;64;25;2;23;.920;3600000;0
2811;61;31;0;0;0;0;.00nan;0;0
2811;1796;16;53;22;3;19;.864;3600000;0
2811;15437;16;0;0;0;0;.00nan;0;0
2811;34797;31;87;47;4;43;.915;3580000;0
2813;724;11;0;0;0;0;.00nan;0;0
2813;4506;33;76;36;3;33;.917;3600000;0
2813;21522;11;58;29;4;25;.862;3570000;0
2813;34740;33;0;0;0;0;.00nan;0;0
2815;1614;25;100;34;0;34;1.000;3600000;0
2815;2423;15;65;32;3;29;.906;3600000;0
2815;4106;15;0;0;0;0;.00nan;0;0
2815;5182;25;0;0;0;0;.00nan;0;0
2817;51;21;0;0;0;0;.00nan;0;0
2817;15505;8;0;0;0;0;.00nan;0;0
2817;25076;8;42;29;5;24;.828;3600000;0
2817;25843;21;76;32;2;30;.938;3600000;0
2819;262;35;0;0;0;0;.00nan;0;0
2819;544;19;84;30;2;28;.933;3724000;0
2819;1430;35;69;32;3;29;.906;3724000;0
2819;31124;19;0;0;0;0;.00nan;0;0
2821;233;29;41;22;5;17;.773;3556000;0
2821;18351;29;0;0;0;0;.00nan;0;0
2821;22601;26;0;0;0;0;.00nan;0;0
2821;32754;26;95;58;4;54;.931;3600000;0
2823;500;4182;90;36;2;34;.944;3600000;0
2823;4450;5;0;0;0;0;.00nan;0;0
2823;19823;5;50;21;3;18;.857;3575000;0
2823;25521;4182;0;0;0;0;.00nan;0;0
2825;1251;14;78;46;5;41;.891;3600000;0
2825;25584;14;0;0;0;0;.00nan;0;0
2825;27739;22;0;0;0;0;.00nan;0;0
2825;28026;22;81;36;2;34;.944;3600000;0
2827;738;27;63;22;2;20;.909;3900000;0
2827;1074;0;82;37;2;35;.946;3900000;0
2827;26623;27;0;0;0;0;.00nan;0;0
2827;31035;0;0;0;0;0;.00nan;0;0
2829;445;12;97;42;4;38;.905;3900000;0
2829;15505;8;82;32;4;28;.875;3900000;0
2829;25076;8;0;0;0;0;.00nan;0;0
2829;34786;12;0;0;0;0;.00nan;0;0
2831;1913;30;0;0;0;0;.00nan;0;0
2831;2423;15;0;0;0;0;.00nan;0;0
2831;4106;15;100;26;0;26;1.000;3600000;0
2831;4826;30;66;21;1;20;.952;3600000;0
2833;233;29;0;0;0;0;.00nan;0;0
2833;13842;34;51;42;6;36;.857;3600000;0
2833;15502;34;0;0;0;0;.00nan;0;0
2833;18351;29;63;31;3;28;.903;3600000;0
2835;738;27;0;0;0;0;.00nan;0;0
2835;16006;20;100;25;0;25;1.000;3600000;0
2835;18078;20;0;0;0;0;.00nan;0;0
2835;26623;27;71;44;5;39;.886;3600000;0
2837;335;18;66;33;3;30;.909;3900000;0
2837;5001;18;0;0;0;0;.00nan;0;0
2837;10103;24;70;28;3;25;.893;3900000;0
2837;13979;24;0;0;0;0;.00nan;0;0
2839;544;19;0;0;0;0;.00nan;0;0
2839;1251;14;0;0;0;0;.00nan;0;0
2839;25584;14;99;56;2;54;.964;3900000;0
2839;31124;19;68;33;2;31;.939;3900000;0
2841;51;21;94;23;0;23;1.000;3600000;0
2841;4450;5;65;16;1;15;.938;3562000;0
2841;19823;5;0;0;0;0;.00nan;0;0
2841;25843;21;0;0;0;0;.00nan;0;0
2843;1572;4838;46;51;8;43;.843;3600000;0
2843;2328;4838;0;0;0;0;.00nan;0;0
2843;27739;22;42;28;5;23;.821;3600000;0
2843;28026;22;0;0;0;0;.00nan;0;0
2845;1074;0;0;0;0;0;.00nan;0;0
2845;15464;32;0;0;0;0;.00nan;0;0
2845;31035;0;46;33;5;28;.848;3546000;0
2845;31643;32;65;30;4;26;.867;3600000;0
2847;262;35;63;24;3;21;.875;3600000;0
2847;1430;35;0;0;0;0;.00nan;0;0
2847;1614;25;100;41;0;41;1.000;3600000;0
2847;5182;25;0;0;0;0;.00nan;0;0
2849;323;9;0;0;0;0;.00nan;0;0
2849;724;11;72;14;1;13;.929;3600000;0
2849;20853;9;63;50;6;44;.880;3600000;0
2849;21522;11;0;0;0;0;.00nan;0;0
2851;500;4182;0;0;0;0;.00nan;0;0
2851;2058;28;0;0;0;0;.00nan;0;0
2851;14061;28;97;45;3;42;.933;3516000;0
2851;25521;4182;91;24;1;23;.958;3600000;0
2853;18104;10;0;0;0;0;.00nan;0;0
2853;22601;26;67;33;3;30;.909;3900000;0
2853;27488;10;63;32;3;29;.906;3900000;0
2853;32754;26;0;0;0;0;.00nan;0;0
2855;61;31;65;43;4;39;.907;3557000;0
2855;1821;3;75;30;3;27;.900;3600000;0
2855;2054;3;0;0;0;0;.00nan;0;0
2855;34797;31;0;0;0;0;.00nan;0;0
2857;4506;33;74;18;1;17;.944;3600000;0
2857;5385;17;56;16;2;14;.875;3560000;0
2857;34006;17;0;0;0;0;.00nan;0;0
2857;34740;33;0;0;0;0;.00nan;0;0
2859;823;23;46;25;4;21;.840;3600000;0
2859;1796;16;0;0;0;0;.00nan;0;0
2859;10274;23;0;0;0;0;.00nan;0;0
2859;15437;16;73;19;1;18;.947;3600000;0
2861;544;19;83;39;2;37;.949;3600000;0
2861;15464;32;44;30;5;25;.833;3600000;0
2861;31124;19;0;0;0;0;.00nan;0;0
2861;31643;32;0;0;0;0;.00nan;0;0
2863;1074;0;98;51;3;48;.941;3557000;0
2863;5385;17;60;20;2;18;.900;3600000;0
2863;31035;0;0;0;0;0;.00nan;0;0
2863;34006;17;0;0;0;0;.00nan;0;0
2865;500;4182;86;20;0;20;1.000;3600000;0
2865;2423;15;0;0;0;0;.00nan;0;0
2865;4106;15;73;32;2;30;.938;3600000;0
2865;25521;4182;0;0;0;0;.00nan;0;0
2867;51;21;94;34;1;33;.971;3557000;0
2867;15505;8;100;31;0;31;1.000;3600000;0
2867;25076;8;0;0;0;0;.00nan;0;0
2867;25843;21;0;0;0;0;.00nan;0;0
2869;445;12;0;0;0;0;.00nan;0;0
2869;4506;33;58;24;2;22;.917;3600000;0
2869;34740;33;0;0;0;0;.00nan;0;0
2869;34786;12;45;38;6;32;.842;3600000;0
2871;823;23;80;27;1;26;.963;3600000;0
2871;10274;23;0;0;0;0;.00nan;0;0
2871;13842;34;0;0;0;0;.00nan;0;0
2871;15502;34;82;41;3;38;.927;3515000;0
2873;1821;3;62;42;5;37;.881;3576000;0
2873;2054;3;0;0;0;0;.00nan;0;0
2873;2058;28;86;47;4;43;.915;3600000;0
2873;14061;28;0;0;0;0;.00nan;0;0
2875;262;35;100;33;0;33;1.000;3600000;0
2875;1251;14;0;0;0;0;.00nan;0;0
2875;1430;35;0;0;0;0;.00nan;0;0
2875;25584;14;63;22;2;20;.909;3563000;0
2877;16006;20;79;24;1;23;.958;3600000;0
2877;18078;20;0;0;0;0;.00nan;0;0
2877;22601;26;0;0;0;0;.00nan;0;0
2877;32754;26;41;41;7;34;.829;3600000;0
2879;335;18;0;0;0;0;.00nan;0;0
2879;4450;5;0;0;0;0;.00nan;0;0
2879;5001;18;82;30;2;28;.933;3545000;0
2879;19823;5;77;19;1;18;.947;3600000;0
2881;323;9;0;0;0;0;.00nan;0;0
2881;1796;16;85;18;0;18;1.000;3600000;0
2881;15437;16;0;0;0;0;.00nan;0;0
2881;20853;9;59;34;4;30;.882;3600000;0
2883;61;31;0;0;0;0;.00nan;0;0
2883;233;29;42;9;2;7;.778;738000;0
2883;18351;29;32;35;7;28;.800;2862000;0
2883;34797;31;79;29;2;27;.931;3600000;0
2885;724;11;54;5;0;5;1.000;234000;0
2885;21522;11;37;25;4;21;.840;3607000;0
2885;27739;22;0;0;0;0;.00nan;0;0
2885;28026;22;51;31;5;26;.839;3841000;0
2887;738;27;0;0;0;0;.00nan;0;0
2887;1572;4838;0;0;0;0;.00nan;0;0
2887;2328;4838;83;32;3;29;.906;3900000;0
2887;26623;27;83;41;3;38;.927;3900000;0
2889;1614;25;65;36;4;32;.889;3577000;0
2889;5182;25;0;0;0;0;.00nan;0;0
2889;10103;24;0;0;0;0;.00nan;0;0
2889;13979;24;71;27;3;24;.889;3600000;0
2891;1913;30;99;42;1;41;.976;3600000;0
2891;4826;30;0;0;0;0;.00nan;0;0
2891;18104;10;50;18;2;16;.889;3543000;0
2891;27488;10;0;0;0;0;.00nan;0;0
2893;500;4182;71;21;1;20;.952;3600000;0
2893;18104;10;0;0;0;0;.00nan;0;0
2893;25521;4182;0;0;0;0;.00nan;0;0
2893;27488;10;75;30;2;28;.933;3546000;0
2895;1572;4838;90;31;1;30;.968;3600000;0
2895;2328;4838;0;0;0;0;.00nan;0;0
2895;16006;20;0;0;0;0;.00nan;0;0
2895;18078;20;38;23;4;19;.826;3600000;0
2897;233;29;24;30;6;24;.800;3033000;0
2897;1796;16;100;26;0;26;1.000;3600000;0
2897;15437;16;0;0;0;0;.00nan;0;0
2897;18351;29;58;6;0;6;1.000;567000;0
2899;1821;3;0;0;0;0;.00nan;0;0
2899;2054;3;75;35;3;32;.914;3565000;0
2899;4450;5;63;15;1;14;.933;3600000;0
2899;19823;5;0;0;0;0;.00nan;0;0
2901;51;21;0;0;0;0;.00nan;0;0
2901;1614;25;0;0;0;0;.00nan;0;0
2901;5182;25;48;24;4;20;.833;3600000;0
2901;25843;21;69;31;3;28;.903;3600000;0
2903;1074;0;0;0;0;0;.00nan;0;0
2903;1913;30;0;0;0;0;.00nan;0;0
2903;4826;30;85;38;4;34;.895;3655000;0
2903;31035;0;72;34;3;31;.912;3655000;0
2905;544;19;0;0;0;0;.00nan;0;0
2905;724;11;63;32;4;28;.875;3600000;0
2905;4435;11;0;0;0;0;.00nan;0;0
2905;31124;19;57;39;5;34;.872;3542000;0
2907;335;18;96;34;1;33;.971;3600000;0
2907;445;12;92;36;2;34;.944;3551000;0
2907;5001;18;0;0;0;0;.00nan;0;0
2907;34786;12;0;0;0;0;.00nan;0;0
2909;5385;17;48;0;0;0;.00nan;272000;0
2909;10103;24;36;19;4;15;.789;3600000;0
2909;13979;24;0;0;0;0;.00nan;0;0
2909;34006;17;57;45;6;39;.867;3277000;0
2911;823;23;0;0;0;0;.00nan;0;0
2911;4506;33;95;39;2;37;.949;3600000;0
2911;10274;23;74;25;1;24;.960;3600000;0
2911;34740;33;0;0;0;0;.00nan;0;0
2913;323;9;75;49;5;44;.898;3600000;0
2913;2423;15;81;22;1;21;.955;3600000;0
2913;4106;15;0;0;0;0;.00nan;0;0
2913;20853;9;0;0;0;0;.00nan;0;0
2915;15464;32;0;0;0;0;.00nan;0;0
2915;27739;22;71;38;3;35;.921;3900000;0
2915;28026;22;0;0;0;0;.00nan;0;0
2915;31643;32;71;34;3;31;.912;3900000;0
2917;15505;8;56;25;3;22;.880;3573000;0
2917;22601;26;90;41;2;39;.951;3600000;0
2917;25076;8;0;0;0;0;.00nan;0;0
2917;32754;26;0;0;0;0;.00nan;0;0
2919;1251;14;50;24;3;21;.875;3576000;0
2919;13842;34;96;45;2;43;.956;3600000;0
2919;15502;34;0;0;0;0;.00nan;0;0
2919;25584;14;0;0;0;0;.00nan;0;0
2921;61;31;62;24;3;21;.875;3600000;0
2921;2058;28;0;0;0;0;.00nan;0;0
2921;14061;28;65;41;5;36;.878;3600000;0
2921;34797;31;0;0;0;0;.00nan;0;0
2923;262;35;43;20;4;16;.800;3600000;0
2923;738;27;96;35;1;34;.971;3600000;0
2923;1430;35;0;0;0;0;.00nan;0;0
2923;26623;27;0;0;0;0;.00nan;0;0
1312;780;52;0;0;0;0;.00nan;0;0
1312;28772;53;67;30;3;27;.900;3600000;0
1312;31156;53;0;0;0;0;.00nan;0;0
1312;32146;52;46;28;4;24;.857;3544000;0
1313;1486;43;0;0;0;0;.00nan;0;0
1313;2900;36;72;22;1;21;.955;3600000;0
1313;3625;43;46;25;4;21;.840;3600000;0
1313;14874;36;0;0;0;0;.00nan;0;0
1314;6081;56;54;34;5;29;.853;3674000;0
1314;23493;51;46;24;4;20;.833;3674000;0
1314;26824;56;0;0;0;0;.00nan;0;0
1314;31822;51;0;0;0;0;.00nan;0;0
1315;37;46;0;0;0;0;.00nan;0;0
1315;2553;46;54;33;5;28;.848;3526000;0
1315;34788;42;56;23;3;20;.870;3600000;0
1315;37416;42;0;0;0;0;.00nan;0;0
1316;1051;44;68;33;4;29;.879;3900000;0
1316;3281;44;0;0;0;0;.00nan;0;0
1316;14351;40;0;0;0;0;.00nan;0;0
1316;26840;40;44;29;4;25;.862;3900000;0
1317;3626;48;0;0;0;0;.00nan;0;0
1317;4716;4619;0;0;0;0;.00nan;0;0
1317;23255;4619;58;27;3;24;.889;3900000;0
1317;38547;48;84;40;3;37;.925;3900000;0
1318;1592;63;77;29;2;27;.931;3552000;0
1318;2296;37;0;0;0;0;.00nan;0;0
1318;5883;37;85;26;1;25;.962;3600000;0
1318;26967;63;0;0;0;0;.00nan;0;0
1319;2796;59;0;0;0;0;.00nan;0;0
1319;8046;57;0;0;0;0;.00nan;0;0
1319;27474;57;51;41;6;35;.854;3600000;0
1319;31858;59;45;30;5;25;.833;3600000;0
1320;4338;65;0;0;0;0;.00nan;0;0
1320;4987;65;57;36;5;31;.861;3516000;0
1320;19640;41;0;0;0;0;.00nan;0;0
1320;23075;41;73;30;3;27;.900;3600000;0
1321;1486;43;66;34;3;31;.912;3598000;0
1321;2900;36;0;0;0;0;.00nan;0;0
1321;3625;43;0;0;0;0;.00nan;0;0
1321;14874;36;74;26;2;24;.923;3600000;0
1322;6081;56;0;0;0;0;.00nan;0;0
1322;23493;51;0;0;0;0;.00nan;0;0
1322;26824;56;85;36;2;34;.944;3600000;0
1322;31822;51;88;17;0;17;1.000;3600000;0
1323;37;46;33;20;4;16;.800;1082000;0
1323;2553;46;81;27;1;26;.963;2518000;0
1323;4447;54;0;0;0;0;.00nan;0;0
1323;31126;54;58;17;2;15;.882;3600000;0
1324;3847;38;0;0;0;0;.00nan;0;0
1324;31021;38;98;37;1;36;.973;3600000;0
1324;31408;52;0;0;0;0;.00nan;0;0
1324;32146;52;73;34;3;31;.912;3552000;0
1325;5137;58;0;0;0;0;.00nan;0;0
1325;14321;58;89;30;1;29;.967;3600000;0
1325;28772;53;0;0;0;0;.00nan;0;0
1325;31156;53;80;39;3;36;.923;3529000;0
1326;5146;64;0;0;0;0;.00nan;0;0
1326;28845;64;100;34;0;34;1.000;3600000;0
1326;34788;42;0;0;0;0;.00nan;0;0
1326;37416;42;85;36;2;34;.944;3514000;0
1327;3;50;78;32;2;30;.938;3600000;0
1327;376;45;67;12;0;12;1.000;1239000;0
1327;2198;45;29;25;5;20;.800;2361000;0
1327;5048;50;0;0;0;0;.00nan;0;0
1328;2152;49;78;25;1;24;.960;3600000;0
1328;4435;49;0;0;0;0;.00nan;0;0
1328;6572;62;89;40;2;38;.950;3543000;0
1328;26919;62;0;0;0;0;.00nan;0;0
1329;1051;44;0;0;0;0;.00nan;0;0
1329;3281;44;99;38;1;37;.974;3600000;0
1329;14351;40;68;31;3;28;.903;3547000;0
1329;26840;40;0;0;0;0;.00nan;0;0
1330;2016;61;69;18;1;17;.944;3600000;0
1330;7049;47;38;25;5;20;.800;3600000;0
1330;30971;61;0;0;0;0;.00nan;0;0
1330;33654;47;0;0;0;0;.00nan;0;0
1331;3847;38;0;0;0;0;.00nan;0;0
1331;28772;53;96;23;0;23;1.000;3600000;0
1331;31021;38;47;24;4;20;.833;3600000;0
1331;31156;53;0;0;0;0;.00nan;0;0
1332;4338;65;51;23;3;20;.870;3545000;0
1332;4987;65;0;0;0;0;.00nan;0;0
1332;8046;57;81;34;2;32;.941;3600000;0
1332;27474;57;0;0;0;0;.00nan;0;0
1333;2163;39;0;0;0;0;.00nan;0;0
1333;5298;55;0;0;0;0;.00nan;0;0
1333;9238;39;53;31;5;26;.839;3548000;0
1333;34770;55;81;36;3;33;.917;3600000;0
1334;2796;59;56;29;4;25;.862;3600000;0
1334;19640;41;27;24;5;19;.792;3600000;0
1334;23075;41;0;0;0;0;.00nan;0;0
1334;31858;59;0;0;0;0;.00nan;0;0
1335;5137;58;99;39;1;38;.974;3600000;0
1335;14321;58;0;0;0;0;.00nan;0;0
1335;31408;52;50;21;4;17;.810;3600000;0
1335;32146;52;0;0;0;0;.00nan;0;0
1336;1592;63;0;0;0;0;.00nan;0;0
1336;2296;37;26;27;6;21;.778;3600000;0
1336;5883;37;0;0;0;0;.00nan;0;0
1336;26967;63;63;31;3;28;.903;3600000;0
1337;3;50;0;0;0;0;.00nan;0;0
1337;376;45;92;17;0;17;1.000;3600000;0
1337;2198;45;0;0;0;0;.00nan;0;0
1337;5048;50;74;32;4;28;.875;3600000;0
1338;7049;47;0;0;0;0;.00nan;0;0
1338;20717;60;66;26;2;24;.923;3600000;0
1338;33654;47;87;47;3;44;.936;3555000;0
1338;35536;60;0;0;0;0;.00nan;0;0
1339;2016;61;0;0;0;0;.00nan;0;0
1339;2152;49;0;0;0;0;.00nan;0;0
1339;4435;49;73;27;2;25;.926;3600000;0
1339;30971;61;82;41;3;38;.927;3574000;0
1340;3626;48;0;0;0;0;.00nan;0;0
1340;4716;4619;37;27;5;22;.815;3600000;0
1340;23255;4619;0;0;0;0;.00nan;0;0
1340;38547;48;99;26;0;26;1.000;3600000;0
1341;2016;61;0;0;0;0;.00nan;0;0
1341;2152;49;0;0;0;0;.00nan;0;0
1341;4435;49;53;23;3;20;.870;3600000;0
1341;30971;61;61;36;5;31;.861;3600000;0
1342;2296;37;0;0;0;0;.00nan;0;0
1342;5883;37;82;24;1;23;.958;3600000;0
1342;23493;51;0;0;0;0;.00nan;0;0
1342;31822;51;84;30;2;28;.933;3581000;0
1343;4338;65;0;0;0;0;.00nan;0;0
1343;4987;65;57;32;4;28;.875;3876000;0
1343;19640;41;0;0;0;0;.00nan;0;0
1343;23075;41;70;31;3;28;.903;3876000;0
1344;3847;38;0;0;0;0;.00nan;0;0
1344;5298;55;51;2;0;2;1.000;277000;0
1344;31021;38;74;25;2;23;.920;3600000;0
1344;34770;55;29;32;7;25;.781;3323000;0
1345;1486;43;42;33;5;28;.848;3789000;0
1345;3625;43;0;0;0;0;.00nan;0;0
1345;6081;56;56;35;4;31;.886;3771000;0
1345;26824;56;0;0;0;0;.00nan;0;0
1346;2796;59;0;0;0;0;.00nan;0;0
1346;28772;53;90;29;1;28;.966;3600000;0
1346;31156;53;0;0;0;0;.00nan;0;0
1346;31858;59;58;38;4;34;.895;3600000;0
1347;5137;58;41;3;1;2;.667;270000;0
1347;14321;58;25;27;6;21;.778;3330000;0
1347;31408;52;0;0;0;0;.00nan;0;0
1347;32146;52;71;24;2;22;.917;3600000;0
1348;2163;39;96;20;0;20;1.000;3600000;0
1348;2900;36;70;22;1;21;.955;3560000;0
1348;9238;39;0;0;0;0;.00nan;0;0
1348;14874;36;0;0;0;0;.00nan;0;0
1349;37;46;91;31;1;30;.968;3900000;0
1349;2296;37;0;0;0;0;.00nan;0;0
1349;2553;46;0;0;0;0;.00nan;0;0
1349;5883;37;86;28;1;27;.964;3900000;0
1350;4447;54;53;24;3;21;.875;3585000;0
1350;5146;64;0;0;0;0;.00nan;0;0
1350;28845;64;80;27;2;25;.926;3600000;0
1350;31126;54;0;0;0;0;.00nan;0;0
1351;3;50;95;49;3;46;.939;3900000;0
1351;5048;50;0;0;0;0;.00nan;0;0
1351;34788;42;76;39;3;36;.923;3900000;0
1351;37416;42;0;0;0;0;.00nan;0;0
1352;4716;4619;93;41;2;39;.951;3900000;0
1352;20717;60;90;37;2;35;.946;3900000;0
1352;23255;4619;0;0;0;0;.00nan;0;0
1352;35536;60;0;0;0;0;.00nan;0;0
1353;2152;49;88;32;2;30;.938;3600000;0
1353;4435;49;0;0;0;0;.00nan;0;0
1353;7049;47;75;39;3;36;.923;3556000;0
1353;33654;47;0;0;0;0;.00nan;0;0
1354;6572;62;0;0;0;0;.00nan;0;0
1354;14351;40;0;0;0;0;.00nan;0;0
1354;26840;40;67;30;3;27;.900;3566000;0
1354;26919;62;89;25;1;24;.960;3600000;0
1355;2016;61;67;29;3;26;.897;3600000;0
1355;3626;48;0;0;0;0;.00nan;0;0
1355;30971;61;0;0;0;0;.00nan;0;0
1355;38547;48;54;34;5;29;.853;3594000;0
1356;1592;63;0;0;0;0;.00nan;0;0
1356;2163;39;71;20;1;19;.950;3600000;0
1356;9238;39;0;0;0;0;.00nan;0;0
1356;26967;63;67;50;6;44;.880;3600000;0
1357;4338;65;68;38;4;34;.895;3558000;0
1357;4987;65;0;0;0;0;.00nan;0;0
1357;19640;41;86;33;3;30;.909;3600000;0
1357;23075;41;0;0;0;0;.00nan;0;0
1358;5137;58;0;0;0;0;.00nan;0;0
1358;14321;58;42;24;4;20;.833;3516000;0
1358;31408;52;67;22;2;20;.909;3600000;0
1358;32146;52;0;0;0;0;.00nan;0;0
1359;2900;36;0;0;0;0;.00nan;0;0
1359;5298;55;86;31;1;30;.968;3600000;0
1359;14874;36;45;34;5;29;.853;3600000;0
1359;34770;55;0;0;0;0;.00nan;0;0
1360;1486;43;0;0;0;0;.00nan;0;0
1360;3625;43;99;34;1;33;.971;3600000;0
1360;6081;56;0;0;0;0;.00nan;0;0
1360;26824;56;77;29;2;27;.931;3585000;0
1361;3;50;0;0;0;0;.00nan;0;0
1361;5048;50;59;39;4;35;.897;3900000;0
1361;34788;42;0;0;0;0;.00nan;0;0
1361;37416;42;63;35;4;31;.886;3900000;0
1362;3847;38;100;27;0;27;1.000;3600000;0
1362;23493;51;0;0;0;0;.00nan;0;0
1362;31021;38;0;0;0;0;.00nan;0;0
1362;31822;51;56;37;5;32;.865;3600000;0
1363;8046;57;65;39;4;35;.897;3554000;0
1363;27474;57;0;0;0;0;.00nan;0;0
1363;28772;53;0;0;0;0;.00nan;0;0
1363;31156;53;56;21;2;19;.905;3600000;0
1364;4447;54;0;0;0;0;.00nan;0;0
1364;5146;64;61;30;3;27;.900;3600000;0
1364;28845;64;0;0;0;0;.00nan;0;0
1364;31126;54;51;32;5;27;.844;3549000;0
1365;2152;49;0;0;0;0;.00nan;0;0
1365;4435;49;78;24;1;23;.958;3600000;0
1365;6572;62;82;35;2;33;.943;3549000;0
1365;26919;62;0;0;0;0;.00nan;0;0
1366;4716;4619;0;0;0;0;.00nan;0;0
1366;20717;60;0;0;0;0;.00nan;0;0
1366;23255;4619;76;28;2;26;.929;3600000;0
1366;35536;60;33;30;6;24;.800;3600000;0
1367;7049;47;0;0;0;0;.00nan;0;0
1367;14351;40;31;32;6;26;.813;3600000;0
1367;26840;40;0;0;0;0;.00nan;0;0
1367;33654;47;60;19;2;17;.895;3600000;0
1368;376;45;44;23;4;19;.826;3600000;0
1368;1051;44;50;26;4;22;.846;2398000;0
1368;2198;45;0;0;0;0;.00nan;0;0
1368;3281;44;44;11;2;9;.818;1183000;0
1369;23493;51;40;40;6;34;.850;3600000;0
1369;31408;52;0;0;0;0;.00nan;0;0
1369;31822;51;0;0;0;0;.00nan;0;0
1369;32146;52;62;23;2;21;.913;3600000;0
1370;37;46;0;0;0;0;.00nan;0;0
1370;2296;37;71;40;4;36;.900;3590000;0
1370;2553;46;49;24;3;21;.875;3600000;0
1370;5883;37;0;0;0;0;.00nan;0;0
1371;3847;38;77;37;3;34;.919;3540000;0
1371;5137;58;73;19;1;18;.947;3600000;0
1371;14321;58;0;0;0;0;.00nan;0;0
1371;31021;38;0;0;0;0;.00nan;0;0
1372;2796;59;55;4;0;4;1.000;395000;0
1372;8046;57;0;0;0;0;.00nan;0;0
1372;27474;57;85;37;2;35;.946;3600000;0
1372;31858;59;54;38;6;32;.842;3205000;0
1373;1486;43;70;34;3;31;.912;3900000;0
1373;1592;63;65;30;3;27;.900;3900000;0
1373;3625;43;0;0;0;0;.00nan;0;0
1373;26967;63;0;0;0;0;.00nan;0;0
1374;376;45;0;0;0;0;.00nan;0;0
1374;1051;44;0;0;0;0;.00nan;0;0
1374;2198;45;68;33;3;30;.909;3569000;0
1374;3281;44;90;32;2;30;.938;3600000;0
1375;2016;61;60;38;5;33;.868;3543000;0
1375;3626;48;0;0;0;0;.00nan;0;0
1375;30971;61;0;0;0;0;.00nan;0;0
1375;38547;48;53;29;4;25;.862;3600000;0
1376;2900;36;0;0;0;0;.00nan;0;0
1376;4338;65;91;31;1;30;.968;3600000;0
1376;4987;65;0;0;0;0;.00nan;0;0
1376;14874;36;43;19;3;16;.842;3600000;0
1377;2163;39;82;24;2;22;.917;3900000;0
1377;6081;56;0;0;0;0;.00nan;0;0
1377;9238;39;0;0;0;0;.00nan;0;0
1377;26824;56;89;30;2;28;.933;3900000;0
1378;37;46;0;0;0;0;.00nan;0;0
1378;2553;46;89;26;1;25;.962;3600000;0
1378;5146;64;0;0;0;0;.00nan;0;0
1378;28845;64;35;32;6;26;.813;3600000;0
1379;2796;59;0;0;0;0;.00nan;0;0
1379;8046;57;0;0;0;0;.00nan;0;0
1379;27474;57;49;38;5;33;.868;3600000;0
1379;31858;59;59;13;1;12;.923;3600000;0
1380;1592;63;28;32;7;25;.781;3306000;0
1380;23493;51;78;26;1;25;.962;3600000;0
1380;26967;63;48;0;0;0;.00nan;294000;0
1380;31822;51;0;0;0;0;.00nan;0;0
1381;4716;4619;0;0;0;0;.00nan;0;0
1381;7049;47;86;53;5;48;.906;3578000;0
1381;23255;4619;43;23;4;19;.826;3600000;0
1381;33654;47;0;0;0;0;.00nan;0;0
1382;376;45;48;28;4;24;.857;3600000;0
1382;2198;45;0;0;0;0;.00nan;0;0
1382;34788;42;0;0;0;0;.00nan;0;0
1382;37416;42;78;24;1;23;.958;3600000;0
1383;3626;48;0;0;0;0;.00nan;0;0
1383;7049;47;76;36;3;33;.917;3900000;0
1383;33654;47;0;0;0;0;.00nan;0;0
1383;38547;48;54;26;3;23;.885;3900000;0
1384;2796;59;0;0;0;0;.00nan;0;0
1384;28772;53;63;38;5;33;.868;3590000;0
1384;31156;53;0;0;0;0;.00nan;0;0
1384;31858;59;52;22;3;19;.864;3600000;0
1385;1486;43;48;24;3;21;.875;3514000;0
1385;2900;36;91;29;1;28;.966;3600000;0
1385;3625;43;0;0;0;0;.00nan;0;0
1385;14874;36;0;0;0;0;.00nan;0;0
1386;5298;55;0;0;0;0;.00nan;0;0
1386;8046;57;72;29;3;26;.897;3900000;0
1386;27474;57;0;0;0;0;.00nan;0;0
1386;34770;55;76;41;3;38;.927;3900000;0
1387;1592;63;68;26;2;24;.923;3581000;0
1387;6081;56;0;0;0;0;.00nan;0;0
1387;26824;56;99;38;1;37;.974;3600000;0
1387;26967;63;0;0;0;0;.00nan;0;0
1388;2163;39;0;0;0;0;.00nan;0;0
1388;9238;39;50;26;4;22;.846;3600000;0
1388;23493;51;0;0;0;0;.00nan;0;0
1388;31822;51;93;35;1;34;.971;3600000;0
1389;3847;38;0;0;0;0;.00nan;0;0
1389;19640;41;0;0;0;0;.00nan;0;0
1389;23075;41;62;26;3;23;.885;3659000;0
1389;31021;38;79;42;4;38;.905;3659000;0
1390;4447;54;0;0;0;0;.00nan;0;0
1390;5146;64;71;31;2;29;.935;3567000;0
1390;28845;64;0;0;0;0;.00nan;0;0
1390;31126;54;87;17;0;17;1.000;3600000;0
1391;4716;4619;0;0;0;0;.00nan;0;0
1391;20717;60;0;0;0;0;.00nan;0;0
1391;23255;4619;87;37;2;35;.946;3600000;0
1391;35536;60;62;35;4;31;.886;3568000;0
1392;1051;44;87;34;1;33;.971;3600000;0
1392;3281;44;0;0;0;0;.00nan;0;0
1392;6572;62;57;28;3;25;.893;3565000;0
1392;26919;62;0;0;0;0;.00nan;0;0
1393;2016;61;0;0;0;0;.00nan;0;0
1393;2152;49;0;0;0;0;.00nan;0;0
1393;4435;49;20;28;7;21;.750;3600000;0
1393;30971;61;78;25;1;24;.960;3600000;0
1394;2163;39;78;44;4;40;.909;3566000;0
1394;9238;39;0;0;0;0;.00nan;0;0
1394;23493;51;65;18;1;17;.944;3600000;0
1394;31822;51;0;0;0;0;.00nan;0;0
1395;3;50;84;28;1;27;.964;3600000;0
1395;2296;37;0;0;0;0;.00nan;0;0
1395;5048;50;0;0;0;0;.00nan;0;0
1395;5883;37;61;33;4;29;.879;3600000;0
1396;1592;63;0;0;0;0;.00nan;0;0
1396;6081;56;38;28;5;23;.821;3600000;0
1396;26824;56;0;0;0;0;.00nan;0;0
1396;26967;63;89;39;2;37;.949;3600000;0
1397;19640;41;55;32;4;28;.875;3553000;0
1397;23075;41;0;0;0;0;.00nan;0;0
1397;28772;53;0;0;0;0;.00nan;0;0
1397;31156;53;64;25;2;23;.920;3600000;0
1398;3847;38;69;19;1;18;.947;3600000;0
1398;31021;38;0;0;0;0;.00nan;0;0
1398;31408;52;0;0;0;0;.00nan;0;0
1398;32146;52;59;27;3;24;.889;3523000;0
1399;1486;43;0;0;0;0;.00nan;0;0
1399;3625;43;81;38;3;35;.921;3578000;0
1399;4338;65;87;32;1;31;.969;3600000;0
1399;4987;65;0;0;0;0;.00nan;0;0
1400;37;46;68;33;3;30;.909;3551000;0
1400;2553;46;0;0;0;0;.00nan;0;0
1400;4447;54;74;24;2;22;.917;3600000;0
1400;31126;54;0;0;0;0;.00nan;0;0
1401;2900;36;0;0;0;0;.00nan;0;0
1401;8046;57;59;6;0;6;1.000;1293000;0
1401;14874;36;41;22;4;18;.818;3600000;0
1401;27474;57;25;26;6;20;.769;2307000;0
1402;2796;59;81;32;2;30;.938;3600000;0
1402;5137;58;0;0;0;0;.00nan;0;0
1402;14321;58;58;35;5;30;.857;3600000;0
1402;31858;59;0;0;0;0;.00nan;0;0
1403;376;45;58;21;3;18;.857;3600000;0
1403;2198;45;0;0;0;0;.00nan;0;0
1403;34788;42;60;35;4;31;.886;3568000;0
1403;37416;42;0;0;0;0;.00nan;0;0
1404;4716;4619;74;31;3;28;.903;3555000;0
1404;14351;40;82;24;2;22;.917;3600000;0
1404;23255;4619;0;0;0;0;.00nan;0;0
1404;26840;40;0;0;0;0;.00nan;0;0
1405;1051;44;0;0;0;0;.00nan;0;0
1405;3281;44;97;31;1;30;.968;3600000;0
1405;6572;62;0;0;0;0;.00nan;0;0
1405;26919;62;72;23;2;21;.913;3553000;0
1406;3626;48;73;35;3;32;.914;3558000;0
1406;7049;47;0;0;0;0;.00nan;0;0
1406;33654;47;83;21;1;20;.952;3600000;0
1406;38547;48;0;0;0;0;.00nan;0;0
1407;2016;61;82;40;3;37;.925;3600000;0
1407;2152;49;88;21;0;21;1.000;3600000;0
1407;4435;49;0;0;0;0;.00nan;0;0
1407;30971;61;0;0;0;0;.00nan;0;0
1408;5137;58;0;0;0;0;.00nan;0;0
1408;14321;58;77;13;0;13;1.000;3600000;0
1408;19640;41;0;0;0;0;.00nan;0;0
1408;23075;41;81;38;2;36;.947;3518000;0
1409;28772;53;47;27;4;23;.852;3572000;0
1409;31156;53;0;0;0;0;.00nan;0;0
1409;31408;52;60;22;3;19;.864;3600000;0
1409;32146;52;0;0;0;0;.00nan;0;0
1410;3;50;0;0;0;0;.00nan;0;0
1410;2296;37;100;35;0;35;1.000;3600000;0
1410;5048;50;58;17;2;15;.882;3568000;0
1410;5883;37;0;0;0;0;.00nan;0;0
1411;37;46;0;0;0;0;.00nan;0;0
1411;2553;46;72;23;2;21;.913;3600000;0
1411;5146;64;59;34;4;30;.882;3564000;0
1411;28845;64;0;0;0;0;.00nan;0;0
1412;1486;43;100;39;1;38;.974;3600000;0
1412;3625;43;0;0;0;0;.00nan;0;0
1412;4338;65;0;0;0;0;.00nan;0;0
1412;4987;65;76;30;2;28;.933;3565000;0
1413;14351;40;0;0;0;0;.00nan;0;0
1413;20717;60;13;29;8;21;.724;3600000;0
1413;26840;40;93;28;1;27;.964;3600000;0
1413;35536;60;0;0;0;0;.00nan;0;0
1414;376;45;0;0;0;0;.00nan;0;0
1414;2198;45;70;31;2;29;.935;3900000;0
1414;4716;4619;72;28;2;26;.929;3900000;0
1414;23255;4619;0;0;0;0;.00nan;0;0
1415;2796;59;0;0;0;0;.00nan;0;0
1415;8046;57;52;28;4;24;.857;3573000;0
1415;27474;57;0;0;0;0;.00nan;0;0
1415;31858;59;70;33;3;30;.909;3600000;0
1416;2163;39;0;0;0;0;.00nan;0;0
1416;6081;56;41;19;4;15;.789;2286000;0
1416;9238;39;45;24;4;20;.833;3600000;0
1416;26824;56;37;8;2;6;.750;1314000;0
1417;376;45;80;30;2;28;.933;3900000;0
1417;2198;45;0;0;0;0;.00nan;0;0
1417;4716;4619;0;0;0;0;.00nan;0;0
1417;23255;4619;100;42;2;40;.952;3900000;0
1418;14351;40;36;22;5;17;.773;3562000;0
1418;20717;60;0;0;0;0;.00nan;0;0
1418;26840;40;0;0;0;0;.00nan;0;0
1418;35536;60;64;28;3;25;.893;3600000;0
1419;2152;49;60;36;4;32;.889;3600000;0
1419;3626;48;0;0;0;0;.00nan;0;0
1419;4435;49;0;0;0;0;.00nan;0;0
1419;38547;48;94;36;1;35;.972;3600000;0
1420;28772;53;0;0;0;0;.00nan;0;0
1420;31156;53;99;38;1;37;.974;3600000;0
1420;31408;52;0;0;0;0;.00nan;0;0
1420;33661;52;61;23;2;21;.913;3543000;0
1421;2900;36;0;0;0;0;.00nan;0;0
1421;5298;55;60;29;3;26;.897;3709000;0
1421;14874;36;66;36;4;32;.889;3709000;0
1421;34770;55;0;0;0;0;.00nan;0;0
1422;1486;43;58;23;3;20;.870;3545000;0
1422;3625;43;0;0;0;0;.00nan;0;0
1422;6081;56;92;42;2;40;.952;3600000;0
1422;26824;56;0;0;0;0;.00nan;0;0
1423;3;50;75;25;1;24;.960;3600000;0
1423;37;46;60;34;4;30;.882;3600000;0
1423;2553;46;0;0;0;0;.00nan;0;0
1423;5048;50;0;0;0;0;.00nan;0;0
1424;2796;59;0;0;0;0;.00nan;0;0
1424;3847;38;0;0;0;0;.00nan;0;0
1424;31021;38;82;33;2;31;.939;3573000;0
1424;31858;59;78;28;2;26;.929;3600000;0
1425;4338;65;75;29;2;27;.931;3600000;0
1425;4987;65;0;0;0;0;.00nan;0;0
1425;5137;58;0;0;0;0;.00nan;0;0
1425;15437;58;46;26;4;22;.846;3561000;0
1426;1592;63;0;0;0;0;.00nan;0;0
1426;2163;39;0;0;0;0;.00nan;0;0
1426;9238;39;50;17;3;14;.824;3600000;0
1426;26967;63;46;31;4;27;.871;3571000;0
1427;2296;37;82;34;3;31;.912;3600000;0
1427;4447;54;69;17;1;16;.941;3001000;0
1427;5883;37;0;0;0;0;.00nan;0;0
1427;31126;54;26;6;3;3;.500;542000;0
1428;6572;62;0;0;0;0;.00nan;0;0
1428;7049;47;0;0;0;0;.00nan;0;0
1428;26919;62;81;42;3;39;.929;3537000;0
1428;33654;47;72;20;1;19;.950;3600000;0
1429;2016;61;68;26;2;24;.923;2967000;0
1429;14351;40;0;0;0;0;.00nan;0;0
1429;26840;40;87;30;2;28;.933;3600000;0
1429;30971;61;19;7;4;3;.429;633000;0
1430;1051;44;83;32;2;30;.938;3600000;0
1430;3281;44;0;0;0;0;.00nan;0;0
1430;3626;48;53;3;0;3;1.000;316000;0
1430;38547;48;31;28;6;22;.786;3284000;0
1431;376;45;0;0;0;0;.00nan;0;0
1431;2198;45;64;32;3;29;.906;3575000;0
1431;20717;60;0;0;0;0;.00nan;0;0
1431;35536;60;63;20;2;18;.900;3600000;0
1432;8046;57;100;36;2;34;.944;3900000;0
1432;19640;41;0;0;0;0;.00nan;0;0
1432;23075;41;75;30;2;28;.933;3900000;0
1432;27474;57;0;0;0;0;.00nan;0;0
1433;2796;59;0;0;0;0;.00nan;0;0
1433;28772;53;54;29;4;25;.862;3600000;0
1433;31156;53;0;0;0;0;.00nan;0;0
1433;31858;59;100;45;1;44;.978;3600000;0
1434;5137;58;0;0;0;0;.00nan;0;0
1434;15437;58;88;44;3;41;.932;3600000;0
1434;31408;52;40;35;6;29;.829;3058000;0
1434;33661;52;42;6;1;5;.833;542000;0
1435;3847;38;88;55;4;51;.927;3587000;0
1435;4338;65;0;0;0;0;.00nan;0;0
1435;4987;65;82;28;2;26;.929;3600000;0
1435;31021;38;0;0;0;0;.00nan;0;0
1436;2900;36;69;31;2;29;.935;3600000;0
1436;14874;36;0;0;0;0;.00nan;0;0
1436;23493;51;100;28;0;28;1.000;3600000;0
1436;31822;51;0;0;0;0;.00nan;0;0
1437;1486;43;0;0;0;0;.00nan;0;0
1437;3625;43;87;41;3;38;.927;3529000;0
1437;6081;56;0;0;0;0;.00nan;0;0
1437;26824;56;99;42;1;41;.976;3600000;0
1438;1592;63;99;23;0;23;1.000;3600000;0
1438;5298;55;0;0;0;0;.00nan;0;0
1438;26967;63;0;0;0;0;.00nan;0;0
1438;34770;55;46;34;5;29;.853;3600000;0
1439;3;50;0;0;0;0;.00nan;0;0
1439;4447;54;0;0;0;0;.00nan;0;0
1439;5048;50;90;32;2;30;.938;3600000;0
1439;31126;54;63;27;3;24;.889;3547000;0
1440;37;46;0;0;0;0;.00nan;0;0
1440;2553;46;42;34;6;28;.824;3600000;0
1440;25076;42;78;33;2;31;.939;3600000;0
1440;34788;42;0;0;0;0;.00nan;0;0
1441;2296;37;0;0;0;0;.00nan;0;0
1441;5146;64;0;0;0;0;.00nan;0;0
1441;5883;37;100;33;0;33;1.000;3600000;0
1441;28845;64;63;26;2;24;.923;3600000;0
1442;2016;61;0;0;0;0;.00nan;0;0
1442;14351;40;68;36;4;32;.889;3552000;0
1442;26840;40;0;0;0;0;.00nan;0;0
1442;30971;61;63;28;3;25;.893;3600000;0
1443;2152;49;0;0;0;0;.00nan;0;0
1443;4435;49;67;27;3;24;.889;3600000;0
1443;7049;47;64;31;4;27;.871;3543000;0
1443;33654;47;0;0;0;0;.00nan;0;0
1444;4716;4619;0;0;0;0;.00nan;0;0
1444;6572;62;87;31;1;30;.968;3600000;0
1444;23255;4619;40;29;5;24;.828;3600000;0
1444;26919;62;0;0;0;0;.00nan;0;0
1445;1051;44;89;18;0;18;1.000;3600000;0
1445;3281;44;0;0;0;0;.00nan;0;0
1445;3626;48;64;29;3;26;.897;3600000;0
1445;38547;48;0;0;0;0;.00nan;0;0
1446;8046;57;0;0;0;0;.00nan;0;0
1446;19640;41;67;28;3;25;.893;3600000;0
1446;23075;41;0;0;0;0;.00nan;0;0
1446;27474;57;74;41;4;37;.902;3564000;0
1447;28772;53;0;0;0;0;.00nan;0;0
1447;31156;53;74;50;4;46;.920;3600000;0
1447;31408;52;0;0;0;0;.00nan;0;0
1447;32146;52;93;34;1;33;.971;3600000;0
1448;4338;65;80;31;2;29;.935;3600000;0
1448;4987;65;0;0;0;0;.00nan;0;0
1448;5137;58;51;59;8;51;.864;3600000;0
1448;15437;58;0;0;0;0;.00nan;0;0
1449;4447;54;80;28;1;27;.964;3600000;0
1449;5146;64;63;35;4;31;.886;3600000;0
1449;28845;64;0;0;0;0;.00nan;0;0
1449;31126;54;0;0;0;0;.00nan;0;0
1450;5298;55;46;38;6;32;.842;3559000;0
1450;23493;51;63;36;4;32;.889;3600000;0
1450;31822;51;0;0;0;0;.00nan;0;0
1450;34770;55;0;0;0;0;.00nan;0;0
1451;2296;37;81;34;2;32;.941;3600000;0
1451;5883;37;0;0;0;0;.00nan;0;0
1451;25076;42;0;0;0;0;.00nan;0;0
1451;34788;42;65;40;4;36;.900;3600000;0
1452;2152;49;59;22;2;20;.909;3600000;0
1452;4435;49;0;0;0;0;.00nan;0;0
1452;4716;4619;70;32;3;29;.906;3600000;0
1452;23255;4619;0;0;0;0;.00nan;0;0
1453;376;45;52;25;4;21;.840;3600000;0
1453;2198;45;0;0;0;0;.00nan;0;0
1453;20717;60;48;31;6;25;.806;2517000;0
1453;35536;60;62;9;0;9;1.000;1083000;0
1454;4338;65;0;0;0;0;.00nan;0;0
1454;4987;65;73;32;3;29;.906;3900000;0
1454;8046;57;68;37;3;34;.919;3900000;0
1454;27474;57;0;0;0;0;.00nan;0;0
1455;2900;36;0;0;0;0;.00nan;0;0
1455;14874;36;50;23;3;20;.870;3546000;0
1455;31408;52;0;0;0;0;.00nan;0;0
1455;32146;52;65;25;2;23;.920;3600000;0
1456;3847;38;0;0;0;0;.00nan;0;0
1456;5137;58;0;0;0;0;.00nan;0;0
1456;15437;58;57;33;4;29;.879;3600000;0
1456;31021;38;78;23;1;22;.957;3600000;0
1457;2163;39;30;16;5;11;.688;938000;0
1457;2796;59;0;0;0;0;.00nan;0;0
1457;9238;39;64;24;2;22;.917;2662000;0
1457;31858;59;68;25;1;24;.960;3600000;0
1458;6081;56;0;0;0;0;.00nan;0;0
1458;23493;51;100;33;0;33;1.000;3600000;0
1458;26824;56;50;21;3;18;.857;3571000;0
1458;31822;51;0;0;0;0;.00nan;0;0
1459;2296;37;0;0;0;0;.00nan;0;0
1459;4447;54;39;43;7;36;.837;3600000;0
1459;5883;37;70;32;3;29;.906;3600000;0
1459;31126;54;0;0;0;0;.00nan;0;0
1460;3;50;65;31;3;28;.903;3550000;0
1460;5048;50;0;0;0;0;.00nan;0;0
1460;25076;42;0;0;0;0;.00nan;0;0
1460;34788;42;79;30;2;28;.933;3600000;0
1461;7049;47;0;0;0;0;.00nan;0;0
1461;14351;40;35;32;6;26;.813;3600000;0
1461;26840;40;0;0;0;0;.00nan;0;0
1461;33654;47;80;32;2;30;.938;3600000;0
1462;3626;48;0;0;0;0;.00nan;0;0
1462;6572;62;0;0;0;0;.00nan;0;0
1462;26919;62;83;35;2;33;.943;3600000;0
1462;38547;48;51;31;4;27;.871;3538000;0
1463;2900;36;74;29;2;27;.931;3600000;0
1463;5298;55;79;24;1;23;.958;3600000;0
1463;14874;36;0;0;0;0;.00nan;0;0
1463;34770;55;0;0;0;0;.00nan;0;0
1464;23493;51;89;46;4;42;.913;3600000;0
1464;31408;52;0;0;0;0;.00nan;0;0
1464;31822;51;0;0;0;0;.00nan;0;0
1464;32146;52;62;22;3;19;.864;3600000;0
1465;37;46;69;24;1;23;.958;3600000;0
1465;2296;37;0;0;0;0;.00nan;0;0
1465;2553;46;0;0;0;0;.00nan;0;0
1465;5883;37;60;39;5;34;.872;3600000;0
1466;3847;38;0;0;0;0;.00nan;0;0
1466;8046;57;100;40;2;38;.950;3600000;0
1466;27474;57;0;0;0;0;.00nan;0;0
1466;31021;38;41;31;6;25;.806;3600000;0
1467;2796;59;0;0;0;0;.00nan;0;0
1467;19640;41;0;0;0;0;.00nan;0;0
1467;23075;41;50;38;5;33;.868;3600000;0
1467;31858;59;98;34;1;33;.971;3600000;0
1468;5137;58;0;0;0;0;.00nan;0;0
1468;15437;58;47;28;4;24;.857;3600000;0
1468;28772;53;52;37;5;32;.865;3560000;0
1468;31156;53;0;0;0;0;.00nan;0;0
1469;1486;43;26;27;6;21;.778;3534000;0
1469;2163;39;0;0;0;0;.00nan;0;0
1469;3625;43;0;0;0;0;.00nan;0;0
1469;9238;39;67;39;4;35;.897;3600000;0
1470;5146;64;22;41;9;32;.780;2948000;0
1470;25076;42;0;0;0;0;.00nan;0;0
1470;28845;64;41;4;1;3;.750;652000;0
1470;34788;42;80;25;1;24;.960;3600000;0
1471;376;45;36;30;6;24;.800;2830000;0
1471;2198;45;48;9;2;7;.778;770000;0
1471;4716;4619;34;28;5;23;.821;3600000;0
1471;10698;4619;0;0;0;0;.00nan;0;0
1472;1051;44;71;36;3;33;.917;3600000;0
1472;2152;49;100;26;0;26;1.000;3600000;0
1472;3281;44;0;0;0;0;.00nan;0;0
1472;4435;49;0;0;0;0;.00nan;0;0
1473;6572;62;76;34;3;31;.912;3600000;0
1473;7049;47;0;0;0;0;.00nan;0;0
1473;26919;62;0;0;0;0;.00nan;0;0
1473;33654;47;65;42;5;37;.881;3551000;0
1474;3626;48;0;0;0;0;.00nan;0;0
1474;14351;40;0;0;0;0;.00nan;0;0
1474;26840;40;71;44;5;39;.886;3646000;0
1474;38547;48;41;21;4;17;.810;3646000;0
1475;2016;61;78;25;2;23;.920;3900000;0
1475;20717;60;0;0;0;0;.00nan;0;0
1475;30971;61;0;0;0;0;.00nan;0;0
1475;35536;60;92;39;2;37;.949;3891000;0
1476;5298;55;86;23;1;22;.957;3600000;0
1476;23493;51;0;0;0;0;.00nan;0;0
1476;31822;51;64;37;4;33;.892;3600000;0
1476;34770;55;0;0;0;0;.00nan;0;0
1477;2796;59;0;0;0;0;.00nan;0;0
1477;19640;41;48;33;4;29;.879;3600000;0
1477;23075;41;0;0;0;0;.00nan;0;0
1477;31858;59;78;22;2;20;.909;3600000;0
1478;1486;43;0;0;0;0;.00nan;0;0
1478;2163;39;72;32;3;29;.906;3600000;0
1478;3625;43;88;25;1;24;.960;3600000;0
1478;9238;39;0;0;0;0;.00nan;0;0
1479;2900;36;0;0;0;0;.00nan;0;0
1479;4338;65;100;41;1;40;.976;3600000;0
1479;4987;65;0;0;0;0;.00nan;0;0
1479;14874;36;71;40;3;37;.925;3540000;0
1480;6081;56;51;32;5;27;.844;3543000;0
1480;26824;56;0;0;0;0;.00nan;0;0
1480;31408;52;24;5;3;2;.400;394000;0
1480;32146;52;74;26;1;25;.962;3206000;0
1481;37;46;0;0;0;0;.00nan;0;0
1481;2296;37;73;31;2;29;.935;3637000;0
1481;2553;46;68;26;3;23;.885;3637000;0
1481;5883;37;0;0;0;0;.00nan;0;0
1482;3;50;62;23;2;21;.913;3600000;0
1482;4447;54;59;21;2;19;.905;2457000;0
1482;5048;50;0;0;0;0;.00nan;0;0
1482;31126;54;20;9;4;5;.556;1143000;0
1483;3847;38;78;27;3;24;.889;3900000;0
1483;28772;53;0;0;0;0;.00nan;0;0
1483;31021;38;0;0;0;0;.00nan;0;0
1483;31156;53;86;36;3;33;.917;3900000;0
1484;5137;58;60;38;4;34;.895;3560000;0
1484;8046;57;0;0;0;0;.00nan;0;0
1484;15437;58;0;0;0;0;.00nan;0;0
1484;27474;57;71;27;2;25;.926;3600000;0
1485;1592;63;75;19;1;18;.947;3600000;0
1485;5146;64;0;0;0;0;.00nan;0;0
1485;26967;63;0;0;0;0;.00nan;0;0
1485;28845;64;83;33;2;31;.939;3578000;0
1486;376;45;0;0;0;0;.00nan;0;0
1486;2198;45;75;20;1;19;.950;3600000;0
1486;4716;4619;0;0;0;0;.00nan;0;0
1486;10698;4619;73;30;2;28;.933;3588000;0
1487;3626;48;100;32;0;32;1.000;3600000;0
1487;14351;40;88;35;2;33;.943;3560000;0
1487;26840;40;0;0;0;0;.00nan;0;0
1487;38547;48;0;0;0;0;.00nan;0;0
1488;1051;44;0;0;0;0;.00nan;0;0
1488;2152;49;73;25;1;24;.960;3600000;0
1488;3281;44;65;31;4;27;.871;3600000;0
1488;4435;49;0;0;0;0;.00nan;0;0
1489;6572;62;0;0;0;0;.00nan;0;0
1489;7049;47;95;28;1;27;.964;3600000;0
1489;26919;62;65;19;2;17;.895;3573000;0
1489;33654;47;0;0;0;0;.00nan;0;0
1490;5298;55;0;0;0;0;.00nan;0;0
1490;6081;56;0;0;0;0;.00nan;0;0
1490;26824;56;63;32;3;29;.906;3570000;0
1490;34770;55;75;28;2;26;.929;3600000;0
1491;1592;63;0;0;0;0;.00nan;0;0
1491;5146;64;85;31;2;29;.935;3600000;0
1491;26967;63;83;40;3;37;.925;3575000;0
1491;28845;64;0;0;0;0;.00nan;0;0
1492;3;50;0;0;0;0;.00nan;0;0
1492;4447;54;0;0;0;0;.00nan;0;0
1492;5048;50;100;34;0;34;1.000;3600000;0
1492;31126;54;36;23;5;18;.783;3600000;0
1493;4338;65;100;31;0;31;1.000;3600000;0
1493;4987;65;0;0;0;0;.00nan;0;0
1493;19640;41;0;0;0;0;.00nan;0;0
1493;23075;41;49;40;5;35;.875;3600000;0
1494;2016;61;0;0;0;0;.00nan;0;0
1494;20717;60;0;0;0;0;.00nan;0;0
1494;30971;61;77;25;1;24;.960;3600000;0
1494;35536;60;50;44;5;39;.886;3600000;0
1495;37;46;77;24;1;23;.958;3600000;0
1495;2553;46;0;0;0;0;.00nan;0;0
1495;5146;64;43;26;4;22;.846;3600000;0
1495;28845;64;0;0;0;0;.00nan;0;0
1496;28772;53;78;30;3;27;.900;3900000;0
1496;31156;53;0;0;0;0;.00nan;0;0
1496;31408;52;0;0;0;0;.00nan;0;0
1496;32146;52;71;30;3;27;.900;3900000;0
1497;1592;63;60;41;4;37;.902;3578000;0
1497;23493;51;67;28;3;25;.893;3600000;0
1497;26967;63;0;0;0;0;.00nan;0;0
1497;31822;51;0;0;0;0;.00nan;0;0
1498;1486;43;80;37;4;33;.892;3544000;0
1498;2900;36;73;32;3;29;.906;3600000;0
1498;3625;43;0;0;0;0;.00nan;0;0
1498;14874;36;0;0;0;0;.00nan;0;0
1499;8046;57;0;0;0;0;.00nan;0;0
1499;19640;41;0;0;0;0;.00nan;0;0
1499;23075;41;94;35;2;33;.943;3900000;0
1499;27474;57;87;33;2;31;.939;3900000;0
1500;2163;39;0;0;0;0;.00nan;0;0
1500;5298;55;0;0;0;0;.00nan;0;0
1500;9238;39;85;18;0;18;1.000;3600000;0
1500;34770;55;90;40;3;37;.925;3600000;0
1501;7049;47;0;0;0;0;.00nan;0;0
1501;20717;60;0;0;0;0;.00nan;0;0
1501;33654;47;58;22;3;19;.864;3578000;0
1501;35536;60;100;46;2;44;.957;3600000;0
1502;2296;37;0;0;0;0;.00nan;0;0
1502;4447;54;0;0;0;0;.00nan;0;0
1502;5883;37;62;28;2;26;.929;3579000;0
1502;31126;54;100;47;1;46;.979;3600000;0
1503;1486;43;85;27;1;26;.963;3600000;0
1503;2900;36;0;0;0;0;.00nan;0;0
1503;3625;43;0;0;0;0;.00nan;0;0
1503;14874;36;43;30;5;25;.833;3600000;0
1504;2841;41;0;0;0;0;.00nan;0;0
1504;5298;55;0;0;0;0;.00nan;0;0
1504;19640;41;58;30;3;27;.900;3600000;0
1504;34770;55;42;44;7;37;.841;3600000;0
1505;3847;38;68;12;0;12;1.000;1267000;0
1505;28772;53;51;2;0;2;1.000;488000;0
1505;31021;38;40;22;4;18;.818;2333000;0
1505;31156;53;36;32;6;26;.813;3044000;0
1506;2796;59;0;0;0;0;.00nan;0;0
1506;5137;58;0;0;0;0;.00nan;0;0
1506;15437;58;100;36;0;36;1.000;3600000;0
1506;31858;59;49;26;4;22;.846;3600000;0
1507;2163;39;0;0;0;0;.00nan;0;0
1507;8046;57;79;27;1;26;.963;3600000;0
1507;9238;39;55;18;2;16;.889;3550000;0
1507;27474;57;0;0;0;0;.00nan;0;0
1508;2296;37;76;33;3;30;.909;3875000;0
1508;4447;54;94;39;3;36;.923;3900000;0
1508;5883;37;0;0;0;0;.00nan;0;0
1508;31126;54;0;0;0;0;.00nan;0;0
1509;5146;64;67;37;4;33;.892;3600000;0
1509;25076;42;0;0;0;0;.00nan;0;0
1509;28845;64;0;0;0;0;.00nan;0;0
1509;34788;42;100;35;0;35;1.000;3600000;0
1510;37;46;63;35;5;30;.857;3600000;0
1510;376;45;100;35;0;35;1.000;3600000;0
1510;2198;45;0;0;0;0;.00nan;0;0
1510;2553;46;0;0;0;0;.00nan;0;0
1511;3;50;0;0;0;0;.00nan;0;0
1511;1051;44;81;32;2;30;.938;3600000;0
1511;3281;44;0;0;0;0;.00nan;0;0
1511;5048;50;40;29;5;24;.828;3600000;0
1512;3626;48;81;39;3;36;.923;3600000;0
1512;4716;4619;45;26;4;22;.846;3577000;0
1512;10698;4619;0;0;0;0;.00nan;0;0
1512;38547;48;0;0;0;0;.00nan;0;0
1513;6572;62;80;27;1;26;.963;3112000;0
1513;20717;60;0;0;0;0;.00nan;0;0
1513;26919;62;24;5;3;2;.400;437000;0
1513;35536;60;71;25;2;23;.920;3600000;0
1514;2016;61;54;20;3;17;.850;3600000;0
1514;7049;47;0;0;0;0;.00nan;0;0
1514;30971;61;0;0;0;0;.00nan;0;0
1514;33654;47;70;35;4;31;.886;3600000;0
1515;1592;63;0;0;0;0;.00nan;0;0
1515;8046;57;0;0;0;0;.00nan;0;0
1515;27474;57;67;20;2;18;.900;3600000;0
1515;34814;63;55;50;7;43;.860;3600000;0
1516;6572;62;0;0;0;0;.00nan;0;0
1516;20717;60;47;31;4;27;.871;3547000;0
1516;26919;62;77;25;2;23;.920;3600000;0
1516;35536;60;0;0;0;0;.00nan;0;0
1517;4338;65;43;31;5;26;.839;3600000;0
1517;4987;65;0;0;0;0;.00nan;0;0
1517;28772;53;100;32;0;32;1.000;3600000;0
1517;31156;53;0;0;0;0;.00nan;0;0
1518;2163;39;100;28;0;28;1.000;3600000;0
1518;5298;55;85;32;1;31;.969;3565000;0
1518;9238;39;0;0;0;0;.00nan;0;0
1518;34770;55;0;0;0;0;.00nan;0;0
1519;714;51;0;0;0;0;.00nan;0;0
1519;6081;56;34;28;6;22;.786;2762000;0
1519;26824;56;59;7;0;7;1.000;838000;0
1519;31822;51;75;31;3;28;.903;3600000;0
1520;2796;59;0;0;0;0;.00nan;0;0
1520;3847;38;23;23;6;17;.739;3600000;0
1520;31021;38;0;0;0;0;.00nan;0;0
1520;31858;59;90;22;0;22;1.000;3600000;0
1521;5137;58;0;0;0;0;.00nan;0;0
1521;15437;58;55;26;3;23;.885;3600000;0
1521;31408;52;63;44;5;39;.886;3516000;0
1521;32146;52;0;0;0;0;.00nan;0;0
1522;5146;64;0;0;0;0;.00nan;0;0
1522;25076;42;0;0;0;0;.00nan;0;0
1522;28845;64;84;44;3;41;.932;3600000;0
1522;34788;42;69;37;4;33;.892;3600000;0
1523;37;46;0;0;0;0;.00nan;0;0
1523;2198;45;68;28;2;26;.929;3600000;0
1523;2553;46;62;45;5;40;.889;3600000;0
1523;34815;45;0;0;0;0;.00nan;0;0
1524;3626;48;90;25;0;25;1.000;3061000;0
1524;4716;4619;0;0;0;0;.00nan;0;0
1524;10698;4619;43;27;5;22;.815;3596000;0
1524;38547;48;39;9;3;6;.667;539000;0
1525;3;50;68;33;4;29;.879;3900000;0
1525;1051;44;0;0;0;0;.00nan;0;0
1525;3281;44;43;24;4;20;.833;3900000;0
1525;5048;50;0;0;0;0;.00nan;0;0
1526;5137;58;55;24;3;21;.875;3513000;0
1526;15437;58;0;0;0;0;.00nan;0;0
1526;31408;52;0;0;0;0;.00nan;0;0
1526;32146;52;74;22;1;21;.955;3600000;0
1527;2296;37;0;0;0;0;.00nan;0;0
1527;4447;54;0;0;0;0;.00nan;0;0
1527;5883;37;97;40;2;38;.950;3900000;0
1527;31126;54;85;34;2;32;.941;3900000;0
1528;1486;43;67;23;2;21;.913;3600000;0
1528;3625;43;0;0;0;0;.00nan;0;0
1528;26967;63;68;36;3;33;.917;3581000;0
1528;34814;63;0;0;0;0;.00nan;0;0
1529;2841;41;0;0;0;0;.00nan;0;0
1529;4338;65;75;28;2;26;.929;3600000;0
1529;4987;65;0;0;0;0;.00nan;0;0
1529;19640;41;53;36;5;31;.861;3600000;0
1530;2152;49;76;22;1;21;.955;3600000;0
1530;4435;49;0;0;0;0;.00nan;0;0
1530;14351;40;0;0;0;0;.00nan;0;0
1530;26840;40;60;44;5;39;.886;3600000;0
1531;2016;61;72;22;1;21;.955;3600000;0
1531;7049;47;0;0;0;0;.00nan;0;0
1531;30971;61;0;0;0;0;.00nan;0;0
1531;33654;47;50;26;3;23;.885;3578000;0
1532;2152;49;0;0;0;0;.00nan;0;0
1532;4435;49;83;28;1;27;.964;3900000;0
1532;14351;40;97;42;1;41;.976;3900000;0
1532;26840;40;0;0;0;0;.00nan;0;0
1533;2796;59;0;0;0;0;.00nan;0;0
1533;2841;41;0;0;0;0;.00nan;0;0
1533;19640;41;81;26;1;25;.962;3600000;0
1533;31858;59;65;26;3;23;.885;3591000;0
1534;5137;58;0;0;0;0;.00nan;0;0
1534;15437;58;83;32;2;30;.938;3580000;0
1534;31408;52;77;27;1;26;.963;3600000;0
1534;32146;52;0;0;0;0;.00nan;0;0
1535;3847;38;0;0;0;0;.00nan;0;0
1535;4338;65;87;30;1;29;.967;3600000;0
1535;4987;65;0;0;0;0;.00nan;0;0
1535;31021;38;55;31;4;27;.871;3600000;0
1536;2796;59;73;35;3;32;.914;3600000;0
1536;2841;41;62;37;5;32;.865;3560000;0
1536;19640;41;0;0;0;0;.00nan;0;0
1536;31858;59;0;0;0;0;.00nan;0;0
1537;2900;36;90;31;1;30;.968;3600000;0
1537;6081;56;50;36;5;31;.861;3600000;0
1537;14874;36;0;0;0;0;.00nan;0;0
1537;26824;56;0;0;0;0;.00nan;0;0
1538;2163;39;86;30;2;28;.933;3600000;0
1538;5298;55;0;0;0;0;.00nan;0;0
1538;9238;39;0;0;0;0;.00nan;0;0
1538;34770;55;47;39;6;33;.846;3600000;0
1539;37;46;0;0;0;0;.00nan;0;0
1539;2553;46;65;22;2;20;.909;3600000;0
1539;4447;54;0;0;0;0;.00nan;0;0
1539;31126;54;60;30;3;27;.900;3600000;0
1540;6572;62;0;0;0;0;.00nan;0;0
1540;20717;60;0;0;0;0;.00nan;0;0
1540;26919;62;93;41;2;39;.951;3569000;0
1540;35536;60;69;19;1;18;.947;3600000;0
1541;5137;58;0;0;0;0;.00nan;0;0
1541;15437;58;95;27;1;26;.963;3600000;0
1541;28772;53;90;35;2;33;.943;3549000;0
1541;31156;53;0;0;0;0;.00nan;0;0
1542;3847;38;28;19;5;14;.737;1760000;0
1542;31021;38;72;17;1;16;.941;1840000;0
1542;31408;52;0;0;0;0;.00nan;0;0
1542;32146;52;65;31;3;28;.903;3600000;0
1543;2900;36;0;0;0;0;.00nan;0;0
1543;8046;57;62;38;5;33;.868;3550000;0
1543;14874;36;51;21;3;18;.857;3600000;0
1543;27474;57;0;0;0;0;.00nan;0;0
1544;1486;43;72;24;1;23;.958;3600000;0
1544;3625;43;0;0;0;0;.00nan;0;0
1544;26967;63;78;32;2;30;.938;3600000;0
1544;34814;63;0;0;0;0;.00nan;0;0
1545;714;51;53;10;1;9;.900;1204000;0
1545;6081;56;0;0;0;0;.00nan;0;0
1545;26824;56;57;15;2;13;.867;3600000;0
1545;31822;51;37;20;4;16;.800;2396000;0
1546;37;46;58;34;4;30;.882;3521000;0
1546;2553;46;0;0;0;0;.00nan;0;0
1546;5146;64;0;0;0;0;.00nan;0;0
1546;28845;64;74;30;2;28;.933;3600000;0
1547;2163;39;0;0;0;0;.00nan;0;0
1547;4338;65;89;49;4;45;.918;3526000;0
1547;4987;65;0;0;0;0;.00nan;0;0
1547;9238;39;75;36;2;34;.944;3600000;0
1548;4447;54;0;0;0;0;.00nan;0;0
1548;25076;42;0;0;0;0;.00nan;0;0
1548;31126;54;52;29;4;25;.862;3743000;0
1548;34788;42;49;31;5;26;.839;3749000;0
1549;6572;62;0;0;0;0;.00nan;0;0
1549;20717;60;51;26;4;22;.846;3900000;0
1549;26919;62;73;42;4;38;.905;3900000;0
1549;35536;60;0;0;0;0;.00nan;0;0
1550;1051;44;0;0;0;0;.00nan;0;0
1550;2016;61;63;22;2;20;.909;3600000;0
1550;3281;44;74;33;3;30;.909;3570000;0
1550;30971;61;0;0;0;0;.00nan;0;0
1551;4716;4619;91;22;0;22;1.000;3600000;0
1551;10698;4619;0;0;0;0;.00nan;0;0
1551;14351;40;0;0;0;0;.00nan;0;0
1551;26840;40;90;41;3;38;.927;3600000;0
1552;2152;49;81;32;2;30;.938;3600000;0
1552;4435;49;0;0;0;0;.00nan;0;0
1552;7049;47;0;0;0;0;.00nan;0;0
1552;33654;47;75;46;5;41;.891;3600000;0
1553;5137;58;76;31;2;29;.935;3546000;0
1553;15437;58;0;0;0;0;.00nan;0;0
1553;28772;53;0;0;0;0;.00nan;0;0
1553;31156;53;96;31;1;30;.968;3600000;0
1554;2198;45;35;38;7;31;.816;3201000;0
1554;2296;37;0;0;0;0;.00nan;0;0
1554;5883;37;75;38;3;35;.921;3600000;0
1554;34815;45;53;3;0;3;1.000;399000;0
1555;1486;43;0;0;0;0;.00nan;0;0
1555;3625;43;74;22;2;20;.909;3600000;0
1555;26967;63;0;0;0;0;.00nan;0;0
1555;34814;63;73;43;4;39;.907;3565000;0
1556;3;50;26;21;6;15;.714;2384000;0
1556;3626;48;0;0;0;0;.00nan;0;0
1556;5048;50;59;5;0;5;1.000;1216000;0
1556;38547;48;85;34;2;32;.941;3600000;0
1557;4716;4619;25;13;4;9;.692;3600000;0
1557;10698;4619;0;0;0;0;.00nan;0;0
1557;14351;40;51;38;5;33;.868;3585000;0
1557;26840;40;0;0;0;0;.00nan;0;0
1558;2841;41;0;0;0;0;.00nan;0;0
1558;5298;55;48;38;6;32;.842;3580000;0
1558;19640;41;43;22;4;18;.818;3600000;0
1558;34770;55;0;0;0;0;.00nan;0;0
1559;2796;59;0;0;0;0;.00nan;0;0
1559;3847;38;0;0;0;0;.00nan;0;0
1559;31021;38;100;40;2;38;.950;3900000;0
1559;31858;59;48;13;2;11;.846;3900000;0
1560;2163;39;75;41;4;37;.902;3552000;0
1560;2900;36;86;34;2;32;.941;3600000;0
1560;9238;39;0;0;0;0;.00nan;0;0
1560;14874;36;0;0;0;0;.00nan;0;0
1561;714;51;0;0;0;0;.00nan;0;0
1561;6081;56;80;31;2;29;.935;3543000;0
1561;26824;56;0;0;0;0;.00nan;0;0
1561;31822;51;86;30;1;29;.967;3600000;0
1562;8046;57;0;0;0;0;.00nan;0;0
1562;27474;57;55;27;3;24;.889;3580000;0
1562;31408;52;92;38;2;36;.947;3600000;0
1562;32146;52;0;0;0;0;.00nan;0;0
1563;5146;64;91;30;1;29;.967;3600000;0
1563;25076;42;96;43;2;41;.953;3554000;0
1563;28845;64;0;0;0;0;.00nan;0;0
1563;34788;42;0;0;0;0;.00nan;0;0
1564;2152;49;0;0;0;0;.00nan;0;0
1564;4435;49;65;31;3;28;.903;3600000;0
1564;20717;60;0;0;0;0;.00nan;0;0
1564;35536;60;55;27;4;23;.852;3589000;0
1565;1051;44;100;33;0;33;1.000;3600000;0
1565;2016;61;0;0;0;0;.00nan;0;0
1565;3281;44;0;0;0;0;.00nan;0;0
1565;30971;61;56;33;5;28;.848;3600000;0
1566;6572;62;53;38;5;33;.868;3573000;0
1566;7049;47;64;32;3;29;.906;3600000;0
1566;26919;62;0;0;0;0;.00nan;0;0
1566;33654;47;0;0;0;0;.00nan;0;0
1567;2841;41;48;22;3;19;.864;3600000;0
1567;5298;55;54;33;4;29;.879;3042000;0
1567;19640;41;0;0;0;0;.00nan;0;0
1567;34770;55;32;10;3;7;.700;558000;0
1568;2198;45;72;29;2;27;.931;3600000;0
1568;2296;37;73;34;3;31;.912;3563000;0
1568;5883;37;0;0;0;0;.00nan;0;0
1568;34815;45;0;0;0;0;.00nan;0;0
1569;37;46;60;17;2;15;.882;3600000;0
1569;2553;46;0;0;0;0;.00nan;0;0
1569;5146;64;74;15;0;15;1.000;1360000;0
1569;28845;64;41;24;5;19;.792;2240000;0
1570;3;50;58;19;3;16;.842;3900000;0
1570;3626;48;93;44;3;41;.932;3900000;0
1570;5048;50;0;0;0;0;.00nan;0;0
1570;38547;48;0;0;0;0;.00nan;0;0
1571;4338;65;100;28;0;28;1.000;3600000;0
1571;4987;65;0;0;0;0;.00nan;0;0
1571;8046;57;73;38;4;34;.895;3600000;0
1571;27474;57;0;0;0;0;.00nan;0;0
1572;4447;54;63;22;2;20;.909;3600000;0
1572;25076;42;49;6;1;5;.833;262000;0
1572;31126;54;0;0;0;0;.00nan;0;0
1572;34788;42;44;28;4;24;.857;3338000;0
1573;2016;61;58;19;2;17;.895;3600000;0
1573;2152;49;45;49;7;42;.857;3600000;0
1573;4435;49;0;0;0;0;.00nan;0;0
1573;30971;61;0;0;0;0;.00nan;0;0
1574;5137;58;0;0;0;0;.00nan;0;0
1574;15437;58;61;28;3;25;.893;3596000;0
1574;28772;53;81;24;1;23;.958;3600000;0
1574;31156;53;0;0;0;0;.00nan;0;0
1575;5298;55;89;37;2;35;.946;3600000;0
1575;6081;56;78;37;3;34;.919;3543000;0
1575;26824;56;0;0;0;0;.00nan;0;0
1575;34770;55;0;0;0;0;.00nan;0;0
1576;4338;65;68;29;2;27;.931;3600000;0
1576;4987;65;0;0;0;0;.00nan;0;0
1576;8046;57;71;38;4;34;.895;3571000;0
1576;27474;57;0;0;0;0;.00nan;0;0
1577;2163;39;0;0;0;0;.00nan;0;0
1577;2900;36;0;0;0;0;.00nan;0;0
1577;9238;39;44;26;4;22;.846;3600000;0
1577;14874;36;53;44;6;38;.864;3600000;0
1578;376;45;100;43;2;41;.953;3900000;0
1578;2198;45;0;0;0;0;.00nan;0;0
1578;23493;51;64;22;2;20;.909;3900000;0
1578;31822;51;0;0;0;0;.00nan;0;0
1579;4447;54;0;0;0;0;.00nan;0;0
1579;25076;42;0;0;0;0;.00nan;0;0
1579;31126;54;71;32;4;28;.875;3548000;0
1579;34788;42;59;24;3;21;.875;3600000;0
1580;7049;47;46;32;4;28;.875;3001000;0
1580;14351;40;0;0;0;0;.00nan;0;0
1580;26840;40;57;32;4;28;.875;3600000;0
1580;33654;47;36;11;3;8;.727;599000;0
1581;2016;61;0;0;0;0;.00nan;0;0
1581;2152;49;0;0;0;0;.00nan;0;0
1581;4435;49;74;34;3;31;.912;3580000;0
1581;30971;61;69;20;1;19;.950;3600000;0
1582;3;50;75;20;1;19;.950;3710000;0
1582;5048;50;0;0;0;0;.00nan;0;0
1582;5146;64;87;34;2;32;.941;3710000;0
1582;28845;64;0;0;0;0;.00nan;0;0
1583;2796;59;0;0;0;0;.00nan;0;0
1583;2900;36;60;42;5;37;.881;3585000;0
1583;14874;36;0;0;0;0;.00nan;0;0
1583;31858;59;58;24;3;21;.875;3600000;0
1584;1486;43;75;27;2;25;.926;3600000;0
1584;3625;43;0;0;0;0;.00nan;0;0
1584;4447;54;0;0;0;0;.00nan;0;0
1584;31126;54;46;28;4;24;.857;3600000;0
1585;376;45;0;0;0;0;.00nan;0;0
1585;2198;45;50;40;6;34;.850;3607000;0
1585;23493;51;61;35;5;30;.857;3607000;0
1585;31822;51;0;0;0;0;.00nan;0;0
1586;37;46;0;0;0;0;.00nan;0;0
1586;2553;46;64;30;3;27;.900;3600000;0
1586;25076;42;0;0;0;0;.00nan;0;0
1586;34788;42;48;30;5;25;.833;3600000;0
1587;3847;38;0;0;0;0;.00nan;0;0
1587;28772;53;0;0;0;0;.00nan;0;0
1587;31021;38;48;33;5;28;.848;3532000;0
1587;31156;53;77;30;3;27;.900;3600000;0
1588;8046;57;59;32;3;29;.906;3888000;0
1588;19640;41;0;0;0;0;.00nan;0;0
1588;23075;41;97;47;3;44;.936;3900000;0
1588;27474;57;0;0;0;0;.00nan;0;0
1589;2163;39;0;0;0;0;.00nan;0;0
1589;5137;58;0;0;0;0;.00nan;0;0
1589;9238;39;100;33;0;33;1.000;3600000;0
1589;15437;58;48;27;3;24;.889;3600000;0
1590;1051;44;71;39;5;34;.872;3600000;0
1590;3281;44;0;0;0;0;.00nan;0;0
1590;4716;4619;100;17;0;17;1.000;3600000;0
1590;10698;4619;0;0;0;0;.00nan;0;0
1591;3626;48;0;0;0;0;.00nan;0;0
1591;7049;47;0;0;0;0;.00nan;0;0
1591;33654;47;87;31;1;30;.968;3600000;0
1591;38547;48;54;30;4;26;.867;3600000;0
1592;6572;62;0;0;0;0;.00nan;0;0
1592;14351;40;0;0;0;0;.00nan;0;0
1592;26840;40;100;33;0;33;1.000;3600000;0
1592;26919;62;60;32;4;28;.875;3600000;0
1593;5137;58;42;25;4;21;.840;3600000;0
1593;15437;58;0;0;0;0;.00nan;0;0
1593;26967;63;52;39;5;34;.872;3600000;0
1593;34814;63;0;0;0;0;.00nan;0;0
1594;2796;59;0;0;0;0;.00nan;0;0
1594;19640;41;80;33;2;31;.939;3600000;0
1594;23075;41;0;0;0;0;.00nan;0;0
1594;31858;59;67;31;3;28;.903;3593000;0
1595;3847;38;80;46;4;42;.913;3666000;0
1595;31021;38;0;0;0;0;.00nan;0;0
1595;31408;52;0;0;0;0;.00nan;0;0
1595;32146;52;46;32;5;27;.844;3666000;0
1596;2163;39;87;22;1;21;.955;3900000;0
1596;2900;36;0;0;0;0;.00nan;0;0
1596;9238;39;0;0;0;0;.00nan;0;0
1596;14874;36;76;25;1;24;.960;3900000;0
1597;1486;43;0;0;0;0;.00nan;0;0
1597;3625;43;84;32;2;30;.938;3900000;0
1597;4447;54;86;33;2;31;.939;3856000;0
1597;31126;54;0;0;0;0;.00nan;0;0
1598;2296;37;0;0;0;0;.00nan;0;0
1598;5883;37;73;28;3;25;.893;3600000;0
1598;6081;56;0;0;0;0;.00nan;0;0
1598;26824;56;50;34;5;29;.853;3570000;0
1599;37;46;79;47;4;43;.915;3610000;0
1599;2553;46;0;0;0;0;.00nan;0;0
1599;25076;42;29;17;5;12;.706;3610000;0
1599;34788;42;0;0;0;0;.00nan;0;0
1600;3;50;94;28;1;27;.964;3600000;0
1600;5048;50;0;0;0;0;.00nan;0;0
1600;5146;64;0;0;0;0;.00nan;0;0
1600;28845;64;57;37;4;33;.892;3600000;0
1601;4338;65;70;26;2;24;.923;3600000;0
1601;4987;65;0;0;0;0;.00nan;0;0
1601;8046;57;0;0;0;0;.00nan;0;0
1601;27474;57;57;35;4;31;.886;3578000;0
1602;5298;55;68;24;2;22;.917;3547000;0
1602;28772;53;100;38;1;37;.974;3600000;0
1602;31156;53;0;0;0;0;.00nan;0;0
1602;34770;55;0;0;0;0;.00nan;0;0
1603;6572;62;85;31;1;30;.968;3600000;0
1603;14351;40;0;0;0;0;.00nan;0;0
1603;26840;40;38;26;5;21;.808;3600000;0
1603;26919;62;0;0;0;0;.00nan;0;0
1604;1051;44;0;0;0;0;.00nan;0;0
1604;3281;44;41;27;5;22;.815;3520000;0
1604;4716;4619;58;28;3;25;.893;3600000;0
1604;10698;4619;0;0;0;0;.00nan;0;0
1605;2152;49;75;27;2;25;.926;3600000;0
1605;4435;49;0;0;0;0;.00nan;0;0
1605;7049;47;72;35;4;31;.886;3576000;0
1605;33654;47;0;0;0;0;.00nan;0;0
1606;2016;61;86;17;0;17;1.000;3600000;0
1606;20717;60;75;37;3;34;.919;3600000;0
1606;30971;61;0;0;0;0;.00nan;0;0
1606;35536;60;0;0;0;0;.00nan;0;0
1607;19640;41;0;0;0;0;.00nan;0;0
1607;23075;41;73;29;2;27;.931;3600000;0
1607;31408;52;71;16;1;15;.938;3600000;0
1607;32146;52;0;0;0;0;.00nan;0;0
1608;2796;59;0;0;0;0;.00nan;0;0
1608;4338;65;0;0;0;0;.00nan;0;0
1608;4987;65;58;22;2;20;.909;3600000;0
1608;31858;59;66;35;4;31;.886;3574000;0
1609;2296;37;63;32;3;29;.906;3586000;0
1609;5883;37;0;0;0;0;.00nan;0;0
1609;6081;56;73;31;2;29;.935;3600000;0
1609;26824;56;0;0;0;0;.00nan;0;0
1610;3847;38;0;0;0;0;.00nan;0;0
1610;5298;55;0;0;0;0;.00nan;0;0
1610;31021;38;49;34;5;29;.853;3600000;0
1610;34770;55;100;29;0;29;1.000;3600000;0
1611;23493;51;84;37;3;34;.919;3872000;0
1611;26967;63;0;0;0;0;.00nan;0;0
1611;31822;51;0;0;0;0;.00nan;0;0
1611;34814;63;90;33;2;31;.939;3872000;0
1612;3;50;0;0;0;0;.00nan;0;0
1612;5048;50;51;24;3;21;.875;3900000;0
1612;5146;64;66;35;3;32;.914;3878000;0
1612;28845;64;0;0;0;0;.00nan;0;0
1613;2016;61;76;33;2;31;.939;3535000;0
1613;20717;60;0;0;0;0;.00nan;0;0
1613;30971;61;0;0;0;0;.00nan;0;0
1613;35536;60;99;23;0;23;1.000;3600000;0
1614;37;46;0;0;0;0;.00nan;0;0
1614;1486;43;75;35;3;32;.914;3566000;0
1614;2553;46;70;23;2;21;.913;3600000;0
1614;3625;43;0;0;0;0;.00nan;0;0
1615;2152;49;96;20;0;20;1.000;3600000;0
1615;4435;49;0;0;0;0;.00nan;0;0
1615;7049;47;98;48;1;47;.979;3561000;0
1615;33654;47;0;0;0;0;.00nan;0;0
1616;6081;56;0;0;0;0;.00nan;0;0
1616;26824;56;72;34;3;31;.912;3600000;0
1616;28772;53;100;31;0;31;1.000;3600000;0
1616;31156;53;0;0;0;0;.00nan;0;0
1617;1486;43;0;0;0;0;.00nan;0;0
1617;2900;36;86;31;2;29;.935;3548000;0
1617;3625;43;97;30;1;29;.967;3600000;0
1617;14874;36;0;0;0;0;.00nan;0;0
1618;2796;59;0;0;0;0;.00nan;0;0
1618;4338;65;39;26;5;21;.808;3600000;0
1618;4987;65;0;0;0;0;.00nan;0;0
1618;31858;59;84;32;2;30;.938;3600000;0
1619;2163;39;0;0;0;0;.00nan;0;0
1619;5298;55;0;0;0;0;.00nan;0;0
1619;9238;39;77;27;2;25;.926;3700000;0
1619;34770;55;57;23;3;20;.870;3700000;0
1620;714;51;50;22;3;19;.864;3582000;0
1620;2296;37;0;0;0;0;.00nan;0;0
1620;5883;37;66;24;2;22;.917;3600000;0
1620;31822;51;0;0;0;0;.00nan;0;0
1621;3;50;92;20;0;20;1.000;3600000;0
1621;5048;50;0;0;0;0;.00nan;0;0
1621;25076;42;0;0;0;0;.00nan;0;0
1621;34788;42;48;18;3;15;.833;3600000;0
1622;376;45;57;30;4;26;.867;3600000;0
1622;2198;45;0;0;0;0;.00nan;0;0
1622;5146;64;90;28;1;27;.964;3600000;0
1622;28845;64;0;0;0;0;.00nan;0;0
1623;8046;57;0;0;0;0;.00nan;0;0
1623;27474;57;63;44;5;39;.886;3600000;0
1623;28772;53;91;28;2;26;.929;3600000;0
1623;31156;53;0;0;0;0;.00nan;0;0
1624;2900;36;42;32;5;27;.844;3551000;0
1624;14874;36;0;0;0;0;.00nan;0;0
1624;19640;41;81;41;3;38;.927;3600000;0
1624;23075;41;0;0;0;0;.00nan;0;0
1625;1486;43;50;32;5;27;.844;3549000;0
1625;3625;43;0;0;0;0;.00nan;0;0
1625;5298;55;72;39;4;35;.897;3600000;0
1625;34770;55;0;0;0;0;.00nan;0;0
1626;3847;38;0;0;0;0;.00nan;0;0
1626;6081;56;0;0;0;0;.00nan;0;0
1626;26824;56;60;34;4;30;.882;3528000;0
1626;31021;38;68;25;2;23;.920;3600000;0
1627;5137;58;0;0;0;0;.00nan;0;0
1627;15437;58;66;31;3;28;.903;3600000;0
1627;26967;63;35;10;3;7;.700;282000;0
1627;34814;63;84;28;1;27;.964;3318000;0
1628;714;51;0;0;0;0;.00nan;0;0
1628;2163;39;0;0;0;0;.00nan;0;0
1628;9238;39;45;19;3;16;.842;3567000;0
1628;31822;51;86;38;2;36;.947;3600000;0
1629;37;46;62;27;3;24;.889;3543000;0
1629;2296;37;0;0;0;0;.00nan;0;0
1629;2553;46;0;0;0;0;.00nan;0;0
1629;5883;37;74;28;2;26;.929;3600000;0
1630;3;50;72;28;2;26;.929;3600000;0
1630;4447;54;0;0;0;0;.00nan;0;0
1630;5048;50;0;0;0;0;.00nan;0;0
1630;31126;54;56;28;4;24;.857;3600000;0
1631;3626;48;0;0;0;0;.00nan;0;0
1631;25076;42;61;22;2;20;.909;3543000;0
1631;34788;42;0;0;0;0;.00nan;0;0
1631;38547;48;86;33;1;32;.970;3600000;0
1632;1051;44;55;25;3;22;.880;3560000;0
1632;3281;44;0;0;0;0;.00nan;0;0
1632;14351;40;0;0;0;0;.00nan;0;0
1632;26840;40;95;38;1;37;.974;3600000;0
1633;4716;4619;27;14;4;10;.714;1122000;0
1633;7049;47;86;33;1;32;.970;3600000;0
1633;10698;4619;78;20;0;20;1.000;2478000;0
1633;33654;47;0;0;0;0;.00nan;0;0
1634;4435;49;0;0;0;0;.00nan;0;0
1634;6572;62;0;0;0;0;.00nan;0;0
1634;26919;62;49;31;4;27;.871;3577000;0
1634;38817;49;47;19;3;16;.842;3600000;0
1635;2016;61;92;42;3;39;.929;3600000;0
1635;20717;60;0;0;0;0;.00nan;0;0
1635;30971;61;0;0;0;0;.00nan;0;0
1635;35536;60;62;41;5;36;.878;3531000;0
1636;2900;36;0;0;0;0;.00nan;0;0
1636;14874;36;43;26;4;22;.846;3600000;0
1636;19640;41;0;0;0;0;.00nan;0;0
1636;23075;41;93;18;0;18;1.000;3600000;0
1637;2796;59;0;0;0;0;.00nan;0;0
1637;4338;65;75;31;3;28;.903;3721000;0
1637;4987;65;0;0;0;0;.00nan;0;0
1637;31858;59;73;28;2;26;.929;3721000;0
1638;26967;63;67;22;2;20;.909;3600000;0
1638;31408;52;0;0;0;0;.00nan;0;0
1638;32146;52;66;32;3;29;.906;3600000;0
1638;34814;63;0;0;0;0;.00nan;0;0
1639;37;46;0;0;0;0;.00nan;0;0
1639;2296;37;60;28;3;25;.893;3900000;0
1639;2553;46;64;35;3;32;.914;3900000;0
1639;5883;37;0;0;0;0;.00nan;0;0
1640;3;50;0;0;0;0;.00nan;0;0
1640;4447;54;49;31;4;27;.871;3900000;0
1640;5048;50;48;30;4;26;.867;3900000;0
1640;31126;54;0;0;0;0;.00nan;0;0
1641;3626;48;100;45;1;44;.978;3600000;0
1641;25076;42;0;0;0;0;.00nan;0;0
1641;34788;42;48;19;3;16;.842;3600000;0
1641;38547;48;0;0;0;0;.00nan;0;0
1642;1486;43;0;0;0;0;.00nan;0;0
1642;3625;43;70;30;3;27;.900;3900000;0
1642;8046;57;87;45;3;42;.933;3900000;0
1642;27474;57;0;0;0;0;.00nan;0;0
1643;3847;38;100;42;1;41;.976;3600000;0
1643;5137;58;67;34;3;31;.912;3522000;0
1643;15437;58;0;0;0;0;.00nan;0;0
1643;31021;38;0;0;0;0;.00nan;0;0
1644;376;45;0;0;0;0;.00nan;0;0
1644;2198;45;85;36;3;33;.917;3600000;0
1644;5146;64;99;33;2;31;.939;3600000;0
1644;28845;64;0;0;0;0;.00nan;0;0
1645;1051;44;0;0;0;0;.00nan;0;0
1645;3281;44;61;21;2;19;.905;3600000;0
1645;14351;40;55;23;3;20;.870;3564000;0
1645;26840;40;0;0;0;0;.00nan;0;0
1646;4716;4619;82;21;1;20;.952;3600000;0
1646;7049;47;0;0;0;0;.00nan;0;0
1646;10698;4619;0;0;0;0;.00nan;0;0
1646;33654;47;58;26;3;23;.885;3513000;0
1647;4435;49;56;20;2;18;.900;3600000;0
1647;6572;62;33;25;5;20;.800;3600000;0
1647;26919;62;0;0;0;0;.00nan;0;0
1647;38817;49;0;0;0;0;.00nan;0;0
1648;6081;56;46;38;5;33;.868;3600000;0
1648;26628;56;0;0;0;0;.00nan;0;0
1648;31408;52;80;26;1;25;.962;3600000;0
1648;32146;52;0;0;0;0;.00nan;0;0
1649;3847;38;0;0;0;0;.00nan;0;0
1649;26967;63;53;24;3;21;.875;3600000;0
1649;31021;38;56;30;4;26;.867;3600000;0
1649;34814;63;0;0;0;0;.00nan;0;0
1650;8046;57;0;0;0;0;.00nan;0;0
1650;27474;57;67;22;1;21;.955;3600000;0
1650;28772;53;63;36;5;31;.861;3600000;0
1650;31156;53;0;0;0;0;.00nan;0;0
1651;2796;59;78;24;1;23;.958;3600000;0
1651;5137;58;0;0;0;0;.00nan;0;0
1651;15437;58;82;34;2;32;.941;3549000;0
1651;31858;59;0;0;0;0;.00nan;0;0
1652;714;51;0;0;0;0;.00nan;0;0
1652;4338;65;0;0;0;0;.00nan;0;0
1652;4987;65;38;29;5;24;.828;3600000;0
1652;31822;51;73;24;1;23;.958;3600000;0
1653;376;45;95;34;1;33;.971;3600000;0
1653;2198;45;0;0;0;0;.00nan;0;0
1653;5146;64;0;0;0;0;.00nan;0;0
1653;28845;64;57;26;3;23;.885;3559000;0
1654;2016;61;0;0;0;0;.00nan;0;0
1654;20717;60;99;38;2;36;.947;3600000;0
1654;30971;61;54;30;4;26;.867;3561000;0
1654;35536;60;0;0;0;0;.00nan;0;0
1655;2163;39;0;0;0;0;.00nan;0;0
1655;9238;39;66;30;3;27;.900;3600000;0
1655;19640;41;0;0;0;0;.00nan;0;0
1655;23075;41;53;29;4;25;.862;3547000;0
1656;3;50;100;31;0;31;1.000;3600000;0
1656;4447;54;0;0;0;0;.00nan;0;0
1656;5048;50;0;0;0;0;.00nan;0;0
1656;31126;54;44;28;4;24;.857;3600000;0
1657;1051;44;0;0;0;0;.00nan;0;0
1657;3281;44;72;32;3;29;.906;3600000;0
1657;3626;48;0;0;0;0;.00nan;0;0
1657;38547;48;67;34;4;30;.882;3600000;0
1658;2163;39;39;22;4;18;.818;3539000;0
1658;9238;39;0;0;0;0;.00nan;0;0
1658;19640;41;79;31;2;29;.935;3600000;0
1658;23075;41;0;0;0;0;.00nan;0;0
1659;2900;36;0;0;0;0;.00nan;0;0
1659;14874;36;86;16;0;16;1.000;3600000;0
1659;26967;63;0;0;0;0;.00nan;0;0
1659;34814;63;73;29;2;27;.931;3522000;0
1660;6081;56;47;31;4;27;.871;3529000;0
1660;8046;57;81;25;2;23;.920;3600000;0
1660;26628;56;0;0;0;0;.00nan;0;0
1660;27474;57;0;0;0;0;.00nan;0;0
1661;1051;44;82;30;2;28;.933;3600000;0
1661;3281;44;0;0;0;0;.00nan;0;0
1661;3626;48;75;38;3;35;.921;3592000;0
1661;38547;48;0;0;0;0;.00nan;0;0
1662;7049;47;93;31;1;30;.968;3600000;0
1662;14351;40;0;0;0;0;.00nan;0;0
1662;26840;40;30;35;8;27;.771;3600000;0
1662;33654;47;0;0;0;0;.00nan;0;0
1663;2016;61;0;0;0;0;.00nan;0;0
1663;6572;62;0;0;0;0;.00nan;0;0
1663;26919;62;43;34;5;29;.853;3600000;0
1663;30971;61;86;32;2;30;.938;3600000;0
1664;4716;4619;51;30;4;26;.867;3557000;0
1664;10698;4619;0;0;0;0;.00nan;0;0
1664;20717;60;68;28;3;25;.893;3600000;0
1664;35536;60;0;0;0;0;.00nan;0;0
1665;2296;37;0;0;0;0;.00nan;0;0
1665;5146;64;55;29;3;26;.897;3546000;0
1665;5883;37;86;35;2;33;.943;3600000;0
1665;28845;64;0;0;0;0;.00nan;0;0
1666;1486;43;81;31;2;29;.935;3608000;0
1666;3625;43;0;0;0;0;.00nan;0;0
1666;5298;55;88;27;1;26;.963;3608000;0
1666;34770;55;0;0;0;0;.00nan;0;0
1667;8046;57;0;0;0;0;.00nan;0;0
1667;27474;57;59;38;5;33;.868;3600000;0
1667;28772;53;0;0;0;0;.00nan;0;0
1667;31156;53;57;33;4;29;.879;3600000;0
1668;2900;36;0;0;0;0;.00nan;0;0
1668;6081;56;70;29;2;27;.931;3600000;0
1668;14874;36;60;34;4;30;.882;3574000;0
1668;26628;56;0;0;0;0;.00nan;0;0
1669;1486;43;0;0;0;0;.00nan;0;0
1669;3625;43;68;29;4;25;.862;3900000;0
1669;5298;55;0;0;0;0;.00nan;0;0
1669;34770;55;74;38;4;34;.895;3850000;0
1670;3847;38;0;0;0;0;.00nan;0;0
1670;23493;51;88;43;2;41;.953;3600000;0
1670;31021;38;80;26;1;25;.962;3600000;0
1670;31822;51;0;0;0;0;.00nan;0;0
1671;4338;65;73;35;3;32;.914;3600000;0
1671;4987;65;0;0;0;0;.00nan;0;0
1671;5137;58;0;0;0;0;.00nan;0;0
1671;15437;58;81;31;2;29;.935;3600000;0
1672;4447;54;61;33;4;29;.879;3515000;0
1672;5146;64;0;0;0;0;.00nan;0;0
1672;28845;64;72;30;2;28;.933;3600000;0
1672;31126;54;0;0;0;0;.00nan;0;0
1673;376;45;67;34;3;31;.912;3900000;0
1673;2198;45;0;0;0;0;.00nan;0;0
1673;25076;42;0;0;0;0;.00nan;0;0
1673;34788;42;78;29;3;26;.897;3900000;0
1674;3;50;49;23;3;20;.870;3553000;0
1674;2296;37;0;0;0;0;.00nan;0;0
1674;5048;50;0;0;0;0;.00nan;0;0
1674;5883;37;79;28;2;26;.929;3600000;0
1675;2152;49;100;28;0;28;1.000;3600000;0
1675;4435;49;0;0;0;0;.00nan;0;0
1675;20717;60;69;30;2;28;.933;3528000;0
1675;35536;60;0;0;0;0;.00nan;0;0
1676;6572;62;83;31;2;29;.935;3600000;0
1676;7049;47;71;30;4;26;.867;3557000;0
1676;26919;62;0;0;0;0;.00nan;0;0
1676;33654;47;0;0;0;0;.00nan;0;0
1677;4716;4619;80;26;1;25;.962;3600000;0
1677;10698;4619;0;0;0;0;.00nan;0;0
1677;14351;40;0;0;0;0;.00nan;0;0
1677;26840;40;61;24;2;22;.917;3554000;0
1678;19640;41;0;0;0;0;.00nan;0;0
1678;23075;41;66;36;4;32;.889;3600000;0
1678;31408;52;0;0;0;0;.00nan;0;0
1678;32146;52;51;35;5;30;.857;3551000;0
1679;2796;59;0;0;0;0;.00nan;0;0
1679;4338;65;0;0;0;0;.00nan;0;0
1679;4987;65;72;20;1;19;.950;3600000;0
1679;31858;59;67;36;3;33;.917;3580000;0
1680;2900;36;53;25;3;22;.880;3600000;0
1680;14874;36;0;0;0;0;.00nan;0;0
1680;23493;51;0;0;0;0;.00nan;0;0
1680;31822;51;58;37;4;33;.892;3600000;0
1681;3847;38;74;28;2;26;.929;3600000;0
1681;6081;56;0;0;0;0;.00nan;0;0
1681;26628;56;36;32;6;26;.813;3600000;0
1681;31021;38;0;0;0;0;.00nan;0;0
1682;37;46;0;0;0;0;.00nan;0;0
1682;2553;46;82;34;3;31;.912;3600000;0
1682;26967;63;0;0;0;0;.00nan;0;0
1682;34814;63;46;25;4;21;.840;3596000;0
1683;3;50;0;0;0;0;.00nan;0;0
1683;2296;37;0;0;0;0;.00nan;0;0
1683;5048;50;97;29;0;29;1.000;3600000;0
1683;5883;37;75;33;2;31;.939;3569000;0
1684;2163;39;0;0;0;0;.00nan;0;0
1684;8046;57;62;40;5;35;.875;3600000;0
1684;9238;39;32;29;6;23;.793;3548000;0
1684;27474;57;0;0;0;0;.00nan;0;0
1685;5137;58;61;23;2;21;.913;3600000;0
1685;15437;58;0;0;0;0;.00nan;0;0
1685;28772;53;48;38;6;32;.842;2938000;0
1685;31156;53;50;1;0;1;1.000;662000;0
1686;4447;54;0;0;0;0;.00nan;0;0
1686;5146;64;56;26;3;23;.885;3600000;0
1686;28845;64;0;0;0;0;.00nan;0;0
1686;31126;54;35;19;4;15;.789;3547000;0
1687;376;45;0;0;0;0;.00nan;0;0
1687;2198;45;40;33;5;28;.848;3600000;0
1687;25076;42;51;24;4;20;.833;3600000;0
1687;34788;42;0;0;0;0;.00nan;0;0
1688;1051;44;81;30;2;28;.933;3600000;0
1688;2152;49;67;25;1;24;.960;3600000;0
1688;3281;44;0;0;0;0;.00nan;0;0
1688;4435;49;0;0;0;0;.00nan;0;0
1689;4716;4619;0;0;0;0;.00nan;0;0
1689;10698;4619;94;31;2;29;.935;3600000;0
1689;14351;40;25;32;7;25;.781;3197000;0
1689;26840;40;50;1;0;1;1.000;403000;0
1690;6572;62;0;0;0;0;.00nan;0;0
1690;20717;60;53;19;3;16;.842;3900000;0
1690;26919;62;97;49;3;46;.939;3900000;0
1690;35536;60;0;0;0;0;.00nan;0;0
1691;2016;61;0;0;0;0;.00nan;0;0
1691;3626;48;57;40;5;35;.875;3600000;0
1691;30971;61;38;18;4;14;.778;3600000;0
1691;38547;48;0;0;0;0;.00nan;0;0
1692;19640;41;85;25;1;24;.960;3600000;0
1692;23075;41;0;0;0;0;.00nan;0;0
1692;31408;52;60;18;2;16;.889;3550000;0
1692;32146;52;0;0;0;0;.00nan;0;0
1693;5137;58;0;0;0;0;.00nan;0;0
1693;15437;58;100;32;0;32;1.000;3600000;0
1693;28772;53;0;0;0;0;.00nan;0;0
1693;31156;53;50;35;5;30;.857;3600000;0
1694;37;46;50;28;4;24;.857;3900000;0
1694;2553;46;0;0;0;0;.00nan;0;0
1694;26967;63;68;36;4;32;.889;3900000;0
1694;34814;63;0;0;0;0;.00nan;0;0
1695;2163;39;82;30;2;28;.933;3600000;0
1695;4338;65;74;45;5;40;.889;3600000;0
1695;4987;65;0;0;0;0;.00nan;0;0
1695;9238;39;0;0;0;0;.00nan;0;0
1696;2016;61;0;0;0;0;.00nan;0;0
1696;3626;48;0;0;0;0;.00nan;0;0
1696;30971;61;52;27;4;23;.852;3595000;0
1696;38547;48;60;40;5;35;.875;3638000;0
1697;2796;59;62;11;0;11;1.000;1140000;0
1697;26967;63;61;22;2;20;.909;3600000;0
1697;31858;59;33;17;4;13;.765;2396000;0
1697;34814;63;0;0;0;0;.00nan;0;0
1698;5298;55;74;28;2;26;.929;3576000;0
1698;6081;56;0;0;0;0;.00nan;0;0
1698;14061;56;94;33;1;32;.970;3600000;0
1698;34770;55;0;0;0;0;.00nan;0;0
1699;4447;54;0;0;0;0;.00nan;0;0
1699;25076;42;0;0;0;0;.00nan;0;0
1699;31126;54;9;35;9;26;.743;3600000;0
1699;34788;42;84;41;3;38;.927;3600000;0
1700;376;45;69;40;4;36;.900;3519000;0
1700;2198;45;0;0;0;0;.00nan;0;0
1700;2296;37;0;0;0;0;.00nan;0;0
1700;5883;37;60;21;2;19;.905;3600000;0
1701;4716;4619;76;29;2;27;.931;3600000;0
1701;10698;4619;0;0;0;0;.00nan;0;0
1701;20717;60;34;27;5;22;.815;3600000;0
1701;35536;60;0;0;0;0;.00nan;0;0
1702;376;45;0;0;0;0;.00nan;0;0
1702;2198;45;60;25;3;22;.880;3561000;0
1702;2296;37;0;0;0;0;.00nan;0;0
1702;5883;37;73;25;2;23;.920;3600000;0
1703;28772;53;36;16;4;12;.750;1150000;0
1703;31156;53;58;26;3;23;.885;2450000;0
1703;31408;52;0;0;0;0;.00nan;0;0
1703;32146;52;74;31;3;28;.903;3600000;0
1704;4338;65;72;40;5;35;.875;3600000;0
1704;4987;65;0;0;0;0;.00nan;0;0
1704;8046;57;0;0;0;0;.00nan;0;0
1704;27474;57;100;27;0;27;1.000;3600000;0
1705;2900;36;88;37;2;35;.946;3600000;0
1705;3847;38;43;18;3;15;.833;3553000;0
1705;14874;36;0;0;0;0;.00nan;0;0
1705;31021;38;0;0;0;0;.00nan;0;0
1706;1486;43;65;28;3;25;.893;3600000;0
1706;3625;43;0;0;0;0;.00nan;0;0
1706;5146;64;0;0;0;0;.00nan;0;0
1706;28845;64;53;26;4;22;.846;3547000;0
1707;37;46;0;0;0;0;.00nan;0;0
1707;2553;46;47;25;4;21;.840;3600000;0
1707;4447;54;45;37;7;30;.811;2875000;0
1707;31126;54;55;5;0;5;1.000;725000;0
1708;907;39;0;0;0;0;.00nan;0;0
1708;2796;59;0;0;0;0;.00nan;0;0
1708;9238;39;59;29;4;25;.862;3889000;0
1708;31858;59;67;37;4;33;.892;3900000;0
1709;4716;4619;0;0;0;0;.00nan;0;0
1709;10698;4619;78;20;1;19;.950;3600000;0
1709;20717;60;76;33;2;31;.939;3544000;0
1709;35536;60;0;0;0;0;.00nan;0;0
1710;6572;62;100;41;0;41;1.000;3600000;0
1710;14351;40;0;0;0;0;.00nan;0;0
1710;26840;40;98;41;1;40;.976;3547000;0
1710;26919;62;0;0;0;0;.00nan;0;0
1711;2152;49;73;33;2;31;.939;3600000;0
1711;3626;48;100;44;1;43;.977;3600000;0
1711;4435;49;0;0;0;0;.00nan;0;0
1711;38547;48;0;0;0;0;.00nan;0;0
1712;1051;44;79;17;1;16;.941;3600000;0
1712;2016;61;63;32;4;28;.875;3600000;0
1712;3281;44;0;0;0;0;.00nan;0;0
1712;30971;61;0;0;0;0;.00nan;0;0
1713;751;64;0;0;0;0;.00nan;0;0
1713;1486;43;0;0;0;0;.00nan;0;0
1713;3625;43;84;34;3;31;.912;3600000;0
1713;5146;64;39;29;5;24;.828;3580000;0
1714;1051;44;0;0;0;0;.00nan;0;0
1714;2016;61;0;0;0;0;.00nan;0;0
1714;3281;44;79;32;3;29;.906;3548000;0
1714;30971;61;67;26;2;24;.923;3600000;0
1715;6081;56;0;0;0;0;.00nan;0;0
1715;14061;56;99;42;1;41;.976;3600000;0
1715;26967;63;0;0;0;0;.00nan;0;0
1715;34814;63;77;25;2;23;.920;3547000;0
1716;37;46;0;0;0;0;.00nan;0;0
1716;1486;43;86;34;2;32;.941;3600000;0
1716;2553;46;48;28;4;24;.857;3538000;0
1716;3625;43;0;0;0;0;.00nan;0;0
1717;3;50;58;19;2;17;.895;3591000;0
1717;5048;50;0;0;0;0;.00nan;0;0
1717;25076;42;85;28;1;27;.964;3600000;0
1717;34788;42;0;0;0;0;.00nan;0;0
1718;2796;59;0;0;0;0;.00nan;0;0
1718;4338;65;61;37;5;32;.865;3600000;0
1718;4987;65;0;0;0;0;.00nan;0;0
1718;31858;59;78;36;2;34;.944;3600000;0
1719;907;39;0;0;0;0;.00nan;0;0
1719;5298;55;0;0;0;0;.00nan;0;0
1719;9238;39;67;19;2;17;.895;3600000;0
1719;34770;55;42;35;5;30;.857;3600000;0
1720;2152;49;84;25;2;23;.920;3600000;0
1720;4435;49;0;0;0;0;.00nan;0;0
1720;6572;62;65;37;4;33;.892;3595000;0
1720;26919;62;0;0;0;0;.00nan;0;0
1721;7049;47;0;0;0;0;.00nan;0;0
1721;20717;60;0;0;0;0;.00nan;0;0
1721;33654;47;63;41;4;37;.902;3600000;0
1721;35536;60;76;19;1;18;.947;3600000;0
1722;5137;58;0;0;0;0;.00nan;0;0
1722;15437;58;71;32;3;29;.906;3600000;0
1722;31408;52;0;0;0;0;.00nan;0;0
1722;32146;52;100;22;0;22;1.000;3600000;0
1723;3847;38;0;0;0;0;.00nan;0;0
1723;26967;63;54;23;3;20;.870;3543000;0
1723;31021;38;59;20;2;18;.900;3600000;0
1723;34814;63;0;0;0;0;.00nan;0;0
1724;2900;36;0;0;0;0;.00nan;0;0
1724;6081;56;0;0;0;0;.00nan;0;0
1724;14061;56;76;34;3;31;.912;3543000;0
1724;14874;36;54;18;2;16;.889;3600000;0
1725;5137;58;86;17;0;17;1.000;3600000;0
1725;5298;55;54;10;1;9;.900;715000;0
1725;15437;58;0;0;0;0;.00nan;0;0
1725;34770;55;41;39;6;33;.846;2885000;0
1726;28772;53;0;0;0;0;.00nan;0;0
1726;31156;53;55;21;3;18;.857;3600000;0
1726;31408;52;0;0;0;0;.00nan;0;0
1726;32146;52;40;31;6;25;.806;3600000;0
1727;2796;59;0;0;0;0;.00nan;0;0
1727;4338;65;99;42;1;41;.976;3600000;0
1727;4987;65;0;0;0;0;.00nan;0;0
1727;31858;59;36;24;5;19;.792;3600000;0
1728;3;50;100;25;0;25;1.000;3600000;0
1728;4716;4619;55;34;4;30;.882;3600000;0
1728;5048;50;0;0;0;0;.00nan;0;0
1728;23255;4619;0;0;0;0;.00nan;0;0
1729;1486;43;0;0;0;0;.00nan;0;0
1729;3625;43;97;32;2;30;.938;3600000;0
1729;8046;57;0;0;0;0;.00nan;0;0
1729;27474;57;79;42;3;39;.929;3600000;0
1730;907;39;0;0;0;0;.00nan;0;0
1730;3847;38;89;30;1;29;.967;3600000;0
1730;9238;39;66;28;3;25;.893;3561000;0
1730;31021;38;0;0;0;0;.00nan;0;0
1731;2900;36;71;38;3;35;.921;3600000;0
1731;14874;36;0;0;0;0;.00nan;0;0
1731;23493;51;87;16;0;16;1.000;3600000;0
1731;31822;51;0;0;0;0;.00nan;0;0
1732;2152;49;86;31;1;30;.968;3600000;0
1732;4435;49;0;0;0;0;.00nan;0;0
1732;7049;47;67;31;2;29;.935;3600000;0
1732;33654;47;0;0;0;0;.00nan;0;0
1733;3626;48;49;23;4;19;.826;3600000;0
1733;6572;62;0;0;0;0;.00nan;0;0
1733;26919;62;34;25;5;20;.800;3557000;0
1733;38547;48;0;0;0;0;.00nan;0;0
1734;14351;40;0;0;0;0;.00nan;0;0
1734;20717;60;98;21;0;21;1.000;3600000;0
1734;26840;40;81;27;2;25;.926;3583000;0
1734;35536;60;0;0;0;0;.00nan;0;0
1735;6081;56;0;0;0;0;.00nan;0;0
1735;14061;56;99;41;2;39;.951;3600000;0
1735;26967;63;73;36;3;33;.917;3600000;0
1735;34814;63;0;0;0;0;.00nan;0;0
1736;4447;54;0;0;0;0;.00nan;0;0
1736;25076;42;0;0;0;0;.00nan;0;0
1736;31126;54;51;34;4;30;.882;3559000;0
1736;34788;42;85;36;2;34;.944;3600000;0
1737;2016;61;0;0;0;0;.00nan;0;0
1737;2296;37;0;0;0;0;.00nan;0;0
1737;5883;37;73;36;4;32;.889;3543000;0
1737;30971;61;67;27;3;24;.889;3600000;0
1738;3847;38;45;35;6;29;.829;3600000;0
1738;28772;53;0;0;0;0;.00nan;0;0
1738;31021;38;0;0;0;0;.00nan;0;0
1738;31156;53;69;22;2;20;.909;3600000;0
1739;3;50;39;35;6;29;.829;3600000;0
1739;4716;4619;75;25;3;22;.880;3600000;0
1739;5048;50;0;0;0;0;.00nan;0;0
1739;23255;4619;0;0;0;0;.00nan;0;0
1740;14351;40;0;0;0;0;.00nan;0;0
1740;20717;60;58;26;3;23;.885;3558000;0
1740;26840;40;83;38;2;36;.947;3600000;0
1740;35536;60;0;0;0;0;.00nan;0;0
1741;5298;55;0;0;0;0;.00nan;0;0
1741;8046;57;0;0;0;0;.00nan;0;0
1741;27474;57;100;29;0;29;1.000;3600000;0
1741;34770;55;50;22;3;19;.864;3600000;0
1742;2016;61;74;28;2;26;.929;3600000;0
1742;2296;37;31;20;5;15;.750;2262000;0
1742;5883;37;42;10;2;8;.800;1338000;0
1742;30971;61;0;0;0;0;.00nan;0;0
1743;1486;43;67;43;5;38;.884;3600000;0
1743;2796;59;0;0;0;0;.00nan;0;0
1743;3625;43;0;0;0;0;.00nan;0;0
1743;31858;59;72;31;2;29;.935;3600000;0
1744;37;46;77;22;1;21;.955;3879000;0
1744;2553;46;0;0;0;0;.00nan;0;0
1744;4447;54;100;32;0;32;1.000;3879000;0
1744;31126;54;0;0;0;0;.00nan;0;0
1745;751;64;0;0;0;0;.00nan;0;0
1745;5146;64;64;28;3;25;.893;3549000;0
1745;25076;42;97;30;1;29;.967;3600000;0
1745;34788;42;0;0;0;0;.00nan;0;0
1746;376;45;59;27;3;24;.889;3600000;0
1746;2198;45;0;0;0;0;.00nan;0;0
1746;19640;41;0;0;0;0;.00nan;0;0
1746;23075;41;62;32;4;28;.875;3550000;0
1747;1051;44;28;32;6;26;.813;3243000;0
1747;3281;44;48;0;0;0;.00nan;357000;0
1747;6572;62;82;30;2;28;.933;3600000;0
1747;26919;62;0;0;0;0;.00nan;0;0
1748;2152;49;90;22;1;21;.955;3600000;0
1748;3626;48;0;0;0;0;.00nan;0;0
1748;4435;49;0;0;0;0;.00nan;0;0
1748;38547;48;64;43;4;39;.907;3600000;0
1749;2163;39;0;0;0;0;.00nan;0;0
1749;5137;58;76;28;1;27;.964;3900000;0
1749;9238;39;86;29;1;28;.966;3900000;0
1749;15437;58;0;0;0;0;.00nan;0;0
1750;6081;56;0;0;0;0;.00nan;0;0
1750;14061;56;93;35;3;32;.914;3600000;0
1750;26967;63;0;0;0;0;.00nan;0;0
1750;34814;63;51;25;4;21;.840;3591000;0
1751;1486;43;0;0;0;0;.00nan;0;0
1751;2796;59;74;25;2;23;.920;3900000;0
1751;3625;43;73;34;2;32;.941;3900000;0
1751;31858;59;0;0;0;0;.00nan;0;0
1752;37;46;47;37;6;31;.838;3317000;0
1752;2553;46;53;3;0;3;1.000;283000;0
1752;4447;54;73;32;3;29;.906;3600000;0
1752;31126;54;0;0;0;0;.00nan;0;0
1753;751;64;100;37;1;36;.973;3600000;0
1753;5146;64;0;0;0;0;.00nan;0;0
1753;25076;42;0;0;0;0;.00nan;0;0
1753;34788;42;77;34;2;32;.941;3560000;0
1754;376;45;0;0;0;0;.00nan;0;0
1754;2198;45;54;24;3;21;.875;3551000;0
1754;19640;41;79;37;2;35;.946;3600000;0
1754;23075;41;0;0;0;0;.00nan;0;0
1755;3626;48;100;43;1;42;.977;3900000;0
1755;7049;47;84;27;1;26;.963;3900000;0
1755;33654;47;0;0;0;0;.00nan;0;0
1755;38547;48;0;0;0;0;.00nan;0;0
1756;2163;39;0;0;0;0;.00nan;0;0
1756;9238;39;74;27;2;25;.926;3565000;0
1756;28772;53;91;34;1;33;.971;3600000;0
1756;31156;53;0;0;0;0;.00nan;0;0
1757;4338;65;66;26;2;24;.923;3900000;0
1757;4987;65;0;0;0;0;.00nan;0;0
1757;31408;52;0;0;0;0;.00nan;0;0
1757;32146;52;100;37;2;35;.946;3900000;0
1758;3;50;67;23;2;21;.913;3600000;0
1758;2296;37;0;0;0;0;.00nan;0;0
1758;5048;50;0;0;0;0;.00nan;0;0
1758;5883;37;57;38;5;33;.868;3600000;0
1759;3847;38;0;0;0;0;.00nan;0;0
1759;5137;58;0;0;0;0;.00nan;0;0
1759;15437;58;53;23;3;20;.870;3521000;0
1759;31021;38;96;37;1;36;.973;3600000;0
1760;37;46;0;0;0;0;.00nan;0;0
1760;751;64;0;0;0;0;.00nan;0;0
1760;2553;46;95;23;0;23;1.000;3600000;0
1760;5146;64;72;21;1;20;.952;3567000;0
1761;14351;40;17;6;4;2;.333;649000;0
1761;20717;60;84;27;1;26;.963;3600000;0
1761;26840;40;60;30;3;27;.900;2951000;0
1761;35536;60;0;0;0;0;.00nan;0;0
1762;1051;44;62;26;3;23;.885;3600000;0
1762;3281;44;0;0;0;0;.00nan;0;0
1762;6572;62;65;35;4;31;.886;3600000;0
1762;26919;62;0;0;0;0;.00nan;0;0
1763;2152;49;47;21;4;17;.810;3591000;0
1763;4435;49;0;0;0;0;.00nan;0;0
1763;7049;47;0;0;0;0;.00nan;0;0
1763;33654;47;85;43;3;40;.930;3600000;0
1764;3;50;74;28;2;26;.929;3560000;0
1764;2296;37;0;0;0;0;.00nan;0;0
1764;5048;50;0;0;0;0;.00nan;0;0
1764;5883;37;69;20;1;19;.950;3600000;0
1765;1051;44;75;31;3;28;.903;3718000;0
1765;3281;44;0;0;0;0;.00nan;0;0
1765;14351;40;0;0;0;0;.00nan;0;0
1765;26840;40;68;35;4;31;.886;3715000;0
1766;3847;38;0;0;0;0;.00nan;0;0
1766;31021;38;80;29;2;27;.931;3550000;0
1766;31408;52;0;0;0;0;.00nan;0;0
1766;32146;52;85;29;1;28;.966;3600000;0
1767;1592;63;83;28;2;26;.929;3600000;0
1767;5298;55;35;29;5;24;.828;3600000;0
1767;26967;63;0;0;0;0;.00nan;0;0
1767;34770;55;0;0;0;0;.00nan;0;0
1768;37;46;0;0;0;0;.00nan;0;0
1768;2553;46;31;18;4;14;.778;3600000;0
1768;4447;54;22;22;6;16;.727;2374000;0
1768;31126;54;53;10;1;9;.900;1226000;0
1769;2163;39;0;0;0;0;.00nan;0;0
1769;6081;56;0;0;0;0;.00nan;0;0
1769;9238;39;68;29;2;27;.931;3600000;0
1769;14061;56;42;35;6;29;.829;3600000;0
1770;5137;58;0;0;0;0;.00nan;0;0
1770;15437;58;57;29;3;26;.897;3574000;0
1770;23493;51;80;31;2;29;.935;3600000;0
1770;31822;51;0;0;0;0;.00nan;0;0
1771;1051;44;0;0;0;0;.00nan;0;0
1771;3281;44;66;21;2;19;.905;3600000;0
1771;14351;40;72;38;3;35;.921;3578000;0
1771;26840;40;0;0;0;0;.00nan;0;0
1772;3626;48;41;25;5;20;.800;3584000;0
1772;6572;62;0;0;0;0;.00nan;0;0
1772;26919;62;99;56;4;52;.929;3600000;0
1772;38547;48;0;0;0;0;.00nan;0;0
1773;2900;36;0;0;0;0;.00nan;0;0
1773;4338;65;78;32;2;30;.938;3600000;0
1773;4987;65;0;0;0;0;.00nan;0;0
1773;14874;36;45;31;5;26;.839;3600000;0
1774;2796;59;0;0;0;0;.00nan;0;0
1774;5298;55;0;0;0;0;.00nan;0;0
1774;31858;59;55;24;3;21;.875;3600000;0
1774;34770;55;50;36;5;31;.861;3543000;0
1775;5137;58;0;0;0;0;.00nan;0;0
1775;6081;56;0;0;0;0;.00nan;0;0
1775;14061;56;66;36;4;32;.889;3900000;0
1775;15437;58;63;41;4;37;.902;3900000;0
1776;1592;63;0;0;0;0;.00nan;0;0
1776;23493;51;59;28;4;24;.857;3600000;0
1776;26967;63;44;40;6;34;.850;3600000;0
1776;31822;51;0;0;0;0;.00nan;0;0
1777;3;50;53;35;6;29;.829;3628000;0
1777;37;46;47;32;5;27;.844;3628000;0
1777;2553;46;0;0;0;0;.00nan;0;0
1777;5048;50;0;0;0;0;.00nan;0;0
1778;3847;38;83;28;1;27;.964;3600000;0
1778;8046;57;0;0;0;0;.00nan;0;0
1778;27474;57;51;35;5;30;.857;3600000;0
1778;31021;38;0;0;0;0;.00nan;0;0
1779;2163;39;0;0;0;0;.00nan;0;0
1779;9238;39;76;25;1;24;.960;3900000;0
1779;28772;53;0;0;0;0;.00nan;0;0
1779;31156;53;99;33;1;32;.970;3900000;0
1780;1486;43;98;37;2;35;.946;3900000;0
1780;3625;43;0;0;0;0;.00nan;0;0
1780;4447;54;0;0;0;0;.00nan;0;0
1780;31126;54;72;23;2;21;.913;3900000;0
1781;751;64;0;0;0;0;.00nan;0;0
1781;5146;64;56;31;4;27;.871;3821000;0
1781;25076;42;0;0;0;0;.00nan;0;0
1781;34788;42;47;27;5;22;.815;3821000;0
1782;376;45;58;29;4;25;.862;3640000;0
1782;2198;45;0;0;0;0;.00nan;0;0
1782;2296;37;0;0;0;0;.00nan;0;0
1782;5883;37;79;39;3;36;.923;3640000;0
1783;6572;62;73;39;4;35;.897;3567000;0
1783;14351;40;0;0;0;0;.00nan;0;0
1783;26840;40;78;28;2;26;.929;3600000;0
1783;26919;62;0;0;0;0;.00nan;0;0
1784;3626;48;31;14;4;10;.714;1027000;0
1784;20717;60;0;0;0;0;.00nan;0;0
1784;35536;60;85;32;1;31;.969;3600000;0
1784;38547;48;52;30;4;26;.867;2573000;0
1785;2016;61;55;5;0;5;1.000;419000;0
1785;7049;47;70;39;4;35;.897;3600000;0
1785;30971;61;28;27;6;21;.778;3150000;0
1785;33654;47;0;0;0;0;.00nan;0;0
1786;1592;63;72;34;3;31;.912;3600000;0
1786;23493;51;95;30;1;29;.967;3600000;0
1786;26967;63;0;0;0;0;.00nan;0;0
1786;31822;51;0;0;0;0;.00nan;0;0
1787;19640;41;0;0;0;0;.00nan;0;0
1787;23075;41;68;38;5;33;.868;3641000;0
1787;31408;52;0;0;0;0;.00nan;0;0
1787;32146;52;76;45;4;41;.911;3633000;0
1788;2796;59;0;0;0;0;.00nan;0;0
1788;4338;65;0;0;0;0;.00nan;0;0
1788;4987;65;98;39;2;37;.949;3600000;0
1788;31858;59;76;34;3;31;.912;3575000;0
1789;2163;39;51;26;3;23;.885;3561000;0
1789;2900;36;67;26;2;24;.923;3600000;0
1789;9238;39;0;0;0;0;.00nan;0;0
1789;14874;36;0;0;0;0;.00nan;0;0
1790;5298;55;61;27;2;25;.926;3600000;0
1790;28772;53;52;32;4;28;.875;3577000;0
1790;31156;53;0;0;0;0;.00nan;0;0
1790;34770;55;0;0;0;0;.00nan;0;0
1791;5137;58;38;23;4;19;.826;3570000;0
1791;6081;56;68;33;3;30;.909;3600000;0
1791;14061;56;0;0;0;0;.00nan;0;0
1791;15437;58;0;0;0;0;.00nan;0;0
1792;4447;54;58;18;3;15;.833;3611000;0
1792;25076;42;60;18;2;16;.889;3611000;0
1792;31126;54;0;0;0;0;.00nan;0;0
1792;34788;42;0;0;0;0;.00nan;0;0
1793;37;46;0;0;0;0;.00nan;0;0
1793;1486;43;0;0;0;0;.00nan;0;0
1793;2553;46;76;45;4;41;.911;3600000;0
1793;3625;43;95;19;0;19;1.000;3600000;0
1794;3;50;0;0;0;0;.00nan;0;0
1794;751;64;56;22;3;19;.864;3900000;0
1794;5048;50;71;32;3;29;.906;3900000;0
1794;5146;64;0;0;0;0;.00nan;0;0
1795;376;45;0;0;0;0;.00nan;0;0
1795;2198;45;93;33;1;32;.970;3861000;0
1795;2296;37;100;31;0;31;1.000;3861000;0
1795;5883;37;0;0;0;0;.00nan;0;0
1796;2152;49;80;43;3;40;.930;3900000;0
1796;4435;49;0;0;0;0;.00nan;0;0
1796;6572;62;0;0;0;0;.00nan;0;0
1796;26919;62;53;29;3;26;.897;3900000;0
1797;1051;44;81;45;4;41;.911;3900000;0
1797;3281;44;0;0;0;0;.00nan;0;0
1797;4716;4619;51;25;4;21;.840;3900000;0
1797;23255;4619;0;0;0;0;.00nan;0;0
1798;3626;48;100;44;1;43;.977;3900000;0
1798;20717;60;86;29;1;28;.966;3900000;0
1798;35536;60;0;0;0;0;.00nan;0;0
1798;38547;48;0;0;0;0;.00nan;0;0
1799;19640;41;34;21;5;16;.762;3896000;0
1799;23075;41;0;0;0;0;.00nan;0;0
1799;31408;52;87;58;5;53;.914;3900000;0
1799;32146;52;0;0;0;0;.00nan;0;0
1800;3847;38;91;31;1;30;.968;3600000;0
1800;8046;57;0;0;0;0;.00nan;0;0
1800;27474;57;66;39;4;35;.897;3600000;0
1800;31021;38;0;0;0;0;.00nan;0;0
1801;751;64;0;0;0;0;.00nan;0;0
1801;1486;43;0;0;0;0;.00nan;0;0
1801;3625;43;52;24;3;21;.875;3840000;0
1801;5146;64;73;42;4;38;.905;3840000;0
1802;2796;59;65;49;5;44;.898;3600000;0
1802;4338;65;74;24;2;22;.917;3600000;0
1802;4987;65;0;0;0;0;.00nan;0;0
1802;31858;59;0;0;0;0;.00nan;0;0
1803;2152;49;0;0;0;0;.00nan;0;0
1803;4435;49;79;11;0;11;1.000;3600000;0
1803;14351;40;0;0;0;0;.00nan;0;0
1803;26840;40;77;46;4;42;.913;3600000;0
1804;1051;44;0;0;0;0;.00nan;0;0
1804;3281;44;36;36;6;30;.833;3600000;0
1804;4716;4619;67;19;1;18;.947;3600000;0
1804;23255;4619;0;0;0;0;.00nan;0;0
1805;2016;61;81;25;1;24;.960;3600000;0
1805;7049;47;69;38;4;34;.895;3600000;0
1805;30971;61;0;0;0;0;.00nan;0;0
1805;33654;47;0;0;0;0;.00nan;0;0
1806;3;50;51;32;4;28;.875;3562000;0
1806;5048;50;0;0;0;0;.00nan;0;0
1806;25076;42;0;0;0;0;.00nan;0;0
1806;34788;42;58;28;3;25;.893;3600000;0
1807;19640;41;69;30;3;27;.900;3562000;0
1807;23075;41;0;0;0;0;.00nan;0;0
1807;28772;53;74;29;2;27;.931;3600000;0
1807;31156;53;0;0;0;0;.00nan;0;0
1808;4338;65;77;31;3;28;.903;3824000;0
1808;4987;65;0;0;0;0;.00nan;0;0
1808;31408;52;0;0;0;0;.00nan;0;0
1808;32146;52;67;31;4;27;.871;3824000;0
1809;6081;56;0;0;0;0;.00nan;0;0
1809;14061;56;100;32;0;32;1.000;3600000;0
1809;26967;63;64;23;2;21;.913;3568000;0
1809;34814;63;0;0;0;0;.00nan;0;0
1810;2163;39;0;0;0;0;.00nan;0;0
1810;5298;55;62;26;3;23;.885;3600000;0
1810;9238;39;55;35;4;31;.886;3600000;0
1810;34770;55;0;0;0;0;.00nan;0;0
1811;2900;36;69;37;4;33;.892;3568000;0
1811;14874;36;0;0;0;0;.00nan;0;0
1811;23493;51;79;32;2;30;.938;3600000;0
1811;31822;51;0;0;0;0;.00nan;0;0
1812;2296;37;75;28;2;26;.929;3600000;0
1812;4447;54;53;37;4;33;.892;3514000;0
1812;5883;37;0;0;0;0;.00nan;0;0
1812;31126;54;0;0;0;0;.00nan;0;0
1813;37;46;0;0;0;0;.00nan;0;0
1813;751;64;0;0;0;0;.00nan;0;0
1813;2553;46;66;39;5;34;.872;3600000;0
1813;5146;64;85;36;2;34;.944;3600000;0
1814;1051;44;68;15;1;14;.933;3600000;0
1814;3281;44;0;0;0;0;.00nan;0;0
1814;20717;60;0;0;0;0;.00nan;0;0
1814;35536;60;89;39;2;37;.949;3563000;0
1815;3626;48;16;7;4;3;.429;471000;0
1815;14351;40;83;25;1;24;.960;3600000;0
1815;26840;40;0;0;0;0;.00nan;0;0
1815;38547;48;67;38;4;34;.895;3129000;0
1816;2900;36;0;0;0;0;.00nan;0;0
1816;5298;55;0;0;0;0;.00nan;0;0
1816;14874;36;66;24;2;22;.917;3569000;0
1816;34770;55;77;24;1;23;.958;3600000;0
1817;37;46;79;30;2;28;.933;3600000;0
1817;2296;37;51;31;4;27;.871;3523000;0
1817;2553;46;0;0;0;0;.00nan;0;0
1817;5883;37;0;0;0;0;.00nan;0;0
1818;3;50;54;38;4;34;.895;3558000;0
1818;751;64;0;0;0;0;.00nan;0;0
1818;5048;50;0;0;0;0;.00nan;0;0
1818;5146;64;58;27;3;24;.889;3600000;0
1819;3847;38;0;0;0;0;.00nan;0;0
1819;28772;53;78;22;2;20;.909;3581000;0
1819;31021;38;99;37;1;36;.973;3600000;0
1819;31156;53;0;0;0;0;.00nan;0;0
1820;2796;59;0;0;0;0;.00nan;0;0
1820;8046;57;0;0;0;0;.00nan;0;0
1820;27474;57;100;37;1;36;.973;3600000;0
1820;31858;59;69;31;2;29;.935;3600000;0
1821;5137;58;0;0;0;0;.00nan;0;0
1821;15437;58;93;24;0;24;1.000;3600000;0
1821;23493;51;76;27;1;26;.963;3565000;0
1821;31822;51;0;0;0;0;.00nan;0;0
1822;2163;39;0;0;0;0;.00nan;0;0
1822;6081;56;0;0;0;0;.00nan;0;0
1822;9238;39;41;22;5;17;.773;3642000;0
1822;14061;56;84;48;4;44;.917;3642000;0
1823;1486;43;86;41;3;38;.927;3896000;0
1823;3625;43;0;0;0;0;.00nan;0;0
1823;25076;42;0;0;0;0;.00nan;0;0
1823;34788;42;72;25;3;22;.880;3900000;0
1824;4447;54;68;24;2;22;.917;3600000;0
1824;4716;4619;49;38;6;32;.842;3600000;0
1824;23255;4619;0;0;0;0;.00nan;0;0
1824;31126;54;0;0;0;0;.00nan;0;0
1825;7049;47;0;0;0;0;.00nan;0;0
1825;14351;40;59;28;4;24;.857;3900000;0
1825;26840;40;0;0;0;0;.00nan;0;0
1825;33654;47;72;35;4;31;.886;3900000;0
1826;2152;49;0;0;0;0;.00nan;0;0
1826;3626;48;76;34;2;32;.941;3900000;0
1826;4435;49;83;37;2;35;.946;3900000;0
1826;38547;48;0;0;0;0;.00nan;0;0
1827;2016;61;0;0;0;0;.00nan;0;0
1827;6572;62;100;36;1;35;.972;3900000;0
1827;26919;62;0;0;0;0;.00nan;0;0
1827;30971;61;62;18;1;17;.944;3900000;0
1828;1051;44;73;35;4;31;.886;3600000;0
1828;3281;44;0;0;0;0;.00nan;0;0
1828;20717;60;0;0;0;0;.00nan;0;0
1828;35536;60;71;19;1;18;.947;3600000;0
1829;3;50;0;0;0;0;.00nan;0;0
1829;751;64;59;37;4;33;.892;3900000;0
1829;5048;50;52;30;4;26;.867;3900000;0
1829;5146;64;0;0;0;0;.00nan;0;0
1830;376;45;0;0;0;0;.00nan;0;0
1830;2198;45;83;48;4;44;.917;3529000;0
1830;19640;41;53;26;3;23;.885;3600000;0
1830;23075;41;0;0;0;0;.00nan;0;0
1831;2163;39;50;33;5;28;.848;3600000;0
1831;6081;56;68;22;2;20;.909;3600000;0
1831;9238;39;0;0;0;0;.00nan;0;0
1831;14061;56;0;0;0;0;.00nan;0;0
1832;23493;51;98;34;2;32;.941;3553000;0
1832;28772;53;0;0;0;0;.00nan;0;0
1832;31156;53;79;23;1;22;.957;3600000;0
1832;31822;51;0;0;0;0;.00nan;0;0
1833;4338;65;69;26;2;24;.923;3900000;0
1833;4987;65;0;0;0;0;.00nan;0;0
1833;26967;63;87;38;2;36;.947;3900000;0
1833;34814;63;0;0;0;0;.00nan;0;0
1834;2900;36;24;5;3;2;.400;492000;0
1834;5298;55;73;36;3;33;.917;3600000;0
1834;14874;36;46;24;4;20;.833;3108000;0
1834;34770;55;0;0;0;0;.00nan;0;0
1835;37;46;0;0;0;0;.00nan;0;0
1835;2296;37;0;0;0;0;.00nan;0;0
1835;2553;46;72;35;4;31;.886;3600000;0
1835;5883;37;47;29;5;24;.828;3600000;0
1836;1486;43;0;0;0;0;.00nan;0;0
1836;3625;43;53;27;4;23;.852;3772000;0
1836;25076;42;67;29;3;26;.897;3772000;0
1836;34788;42;0;0;0;0;.00nan;0;0
1837;2796;59;0;0;0;0;.00nan;0;0
1837;8046;57;0;0;0;0;.00nan;0;0
1837;27474;57;38;34;6;28;.824;3600000;0
1837;31858;59;76;27;2;25;.926;3600000;0
1838;3847;38;99;37;1;36;.973;3600000;0
1838;5137;58;0;0;0;0;.00nan;0;0
1838;15437;58;42;21;3;18;.857;3517000;0
1838;31021;38;0;0;0;0;.00nan;0;0
1839;4447;54;0;0;0;0;.00nan;0;0
1839;4716;4619;0;0;0;0;.00nan;0;0
1839;23255;4619;84;15;0;15;1.000;3600000;0
1839;31126;54;77;27;2;25;.926;3561000;0
1840;7049;47;81;36;2;34;.944;3600000;0
1840;20717;60;66;15;1;14;.933;3600000;0
1840;33654;47;0;0;0;0;.00nan;0;0
1840;35536;60;0;0;0;0;.00nan;0;0
1841;2016;61;55;37;5;32;.865;3600000;0
1841;6572;62;0;0;0;0;.00nan;0;0
1841;26919;62;84;24;1;23;.958;3600000;0
1841;30971;61;0;0;0;0;.00nan;0;0
1842;1051;44;0;0;0;0;.00nan;0;0
1842;3281;44;57;19;2;17;.895;3600000;0
1842;14351;40;0;0;0;0;.00nan;0;0
1842;26840;40;76;48;4;44;.917;3600000;0
1843;2152;49;56;19;2;17;.895;3600000;0
1843;3626;48;69;11;0;11;1.000;804000;0
1843;4435;49;0;0;0;0;.00nan;0;0
1843;38547;48;57;45;6;39;.867;2796000;0
1844;376;45;36;27;6;21;.778;3350000;0
1844;2198;45;50;1;0;1;1.000;223000;0
1844;19640;41;0;0;0;0;.00nan;0;0
1844;23075;41;32;24;5;19;.792;3600000;0
1845;3847;38;54;3;0;3;1.000;600000;0
1845;31021;38;35;31;6;25;.806;2963000;0
1845;31408;52;0;0;0;0;.00nan;0;0
1845;32146;52;39;23;5;18;.783;3600000;0
1846;8046;57;80;40;3;37;.925;3586000;0
1846;26967;63;0;0;0;0;.00nan;0;0
1846;27474;57;0;0;0;0;.00nan;0;0
1846;34814;63;82;39;2;37;.949;3600000;0
1847;2796;59;87;20;0;20;1.000;3600000;0
1847;4338;65;0;0;0;0;.00nan;0;0
1847;4987;65;95;36;2;34;.944;3553000;0
1847;31858;59;0;0;0;0;.00nan;0;0
1848;2900;36;50;21;3;18;.857;3564000;0
1848;6081;56;0;0;0;0;.00nan;0;0
1848;14061;56;81;32;2;30;.938;3600000;0
1848;14874;36;0;0;0;0;.00nan;0;0
1849;751;64;77;26;2;24;.923;3900000;0
1849;5146;64;0;0;0;0;.00nan;0;0
1849;25076;42;0;0;0;0;.00nan;0;0
1849;34788;42;83;27;2;25;.926;3900000;0
1850;3;50;75;30;2;28;.933;3900000;0
1850;4447;54;85;32;2;30;.938;3875000;0
1850;5571;50;0;0;0;0;.00nan;0;0
1850;31126;54;0;0;0;0;.00nan;0;0
1851;2016;61;0;0;0;0;.00nan;0;0
1851;2152;49;68;33;3;30;.909;3600000;0
1851;4435;49;0;0;0;0;.00nan;0;0
1851;30971;61;63;41;5;36;.878;3558000;0
1852;5137;58;0;0;0;0;.00nan;0;0
1852;15437;58;98;47;2;45;.957;3600000;0
1852;19640;41;16;22;6;16;.727;2805000;0
1852;23075;41;38;7;2;5;.714;795000;0
1853;37;46;0;0;0;0;.00nan;0;0
1853;1486;43;0;0;0;0;.00nan;0;0
1853;2553;46;78;38;4;34;.895;3600000;0
1853;3625;43;30;20;5;15;.750;3589000;0
1854;6572;62;0;0;0;0;.00nan;0;0
1854;20717;60;0;0;0;0;.00nan;0;0
1854;26919;62;52;39;5;34;.872;3600000;0
1854;35536;60;70;22;1;21;.955;3600000;0
1855;26967;63;0;0;0;0;.00nan;0;0
1855;28772;53;66;24;2;22;.917;3600000;0
1855;31156;53;0;0;0;0;.00nan;0;0
1855;34814;63;61;28;3;25;.893;3577000;0
1856;2796;59;45;25;4;21;.840;3571000;0
1856;8046;57;0;0;0;0;.00nan;0;0
1856;27474;57;74;30;2;28;.933;3600000;0
1856;31858;59;0;0;0;0;.00nan;0;0
1857;2163;39;0;0;0;0;.00nan;0;0
1857;2900;36;0;0;0;0;.00nan;0;0
1857;9238;39;55;25;3;22;.880;3600000;0
1857;14874;36;100;29;0;29;1.000;3600000;0
1858;5298;55;75;40;4;36;.900;3600000;0
1858;23493;51;70;26;2;24;.923;3600000;0
1858;31822;51;0;0;0;0;.00nan;0;0
1858;34770;55;0;0;0;0;.00nan;0;0
1859;376;45;0;0;0;0;.00nan;0;0
1859;2198;45;52;29;4;25;.862;3600000;0
1859;4447;54;91;33;1;32;.970;3600000;0
1859;31126;54;0;0;0;0;.00nan;0;0
1860;1051;44;91;37;3;34;.919;3600000;0
1860;3281;44;0;0;0;0;.00nan;0;0
1860;7049;47;0;0;0;0;.00nan;0;0
1860;33654;47;38;30;6;24;.800;3600000;0
1861;6572;62;84;25;1;24;.960;3600000;0
1861;14351;40;0;0;0;0;.00nan;0;0
1861;26840;40;67;31;3;28;.903;3546000;0
1861;26919;62;0;0;0;0;.00nan;0;0
1862;5137;58;0;0;0;0;.00nan;0;0
1862;15437;58;42;31;5;26;.839;3582000;0
1862;19640;41;76;31;3;28;.903;3600000;0
1862;23075;41;0;0;0;0;.00nan;0;0
1863;2900;36;0;0;0;0;.00nan;0;0
1863;5298;55;0;0;0;0;.00nan;0;0
1863;14874;36;78;39;3;36;.923;3600000;0
1863;34770;55;54;32;4;28;.875;3559000;0
1864;1486;43;51;28;4;24;.857;3600000;0
1864;2163;39;0;0;0;0;.00nan;0;0
1864;3625;43;0;0;0;0;.00nan;0;0
1864;9238;39;57;22;3;19;.864;3600000;0
1865;6081;56;0;0;0;0;.00nan;0;0
1865;14061;56;61;33;3;30;.909;3883000;0
1865;23493;51;74;42;4;38;.905;3883000;0
1865;31822;51;0;0;0;0;.00nan;0;0
1866;3847;38;35;35;7;28;.800;3600000;0
1866;31021;38;0;0;0;0;.00nan;0;0
1866;31408;52;0;0;0;0;.00nan;0;0
1866;32146;52;77;36;4;32;.889;3600000;0
1867;2796;59;0;0;0;0;.00nan;0;0
1867;26967;63;0;0;0;0;.00nan;0;0
1867;31858;59;73;20;1;19;.950;3600000;0
1867;34814;63;68;39;5;34;.872;3600000;0
1868;376;45;0;0;0;0;.00nan;0;0
1868;2198;45;60;27;3;24;.889;3600000;0
1868;25076;42;0;0;0;0;.00nan;0;0
1868;34788;42;58;25;4;21;.840;3600000;0
1869;3;50;61;34;4;30;.882;3533000;0
1869;4716;4619;0;0;0;0;.00nan;0;0
1869;5571;50;0;0;0;0;.00nan;0;0
1869;23255;4619;100;42;2;40;.952;3600000;0
1870;3626;48;72;43;4;39;.907;3525000;0
1870;14351;40;71;34;2;32;.941;3600000;0
1870;26840;40;0;0;0;0;.00nan;0;0
1870;38547;48;0;0;0;0;.00nan;0;0
1871;1486;43;0;0;0;0;.00nan;0;0
1871;2163;39;61;28;3;25;.893;3900000;0
1871;3625;43;62;23;3;20;.870;3900000;0
1871;9238;39;0;0;0;0;.00nan;0;0
1872;751;64;0;0;0;0;.00nan;0;0
1872;2296;37;0;0;0;0;.00nan;0;0
1872;5146;64;91;35;2;33;.943;3900000;0
1872;5883;37;80;33;2;31;.939;3900000;0
1873;8046;57;0;0;0;0;.00nan;0;0
1873;19640;41;0;0;0;0;.00nan;0;0
1873;23075;41;74;22;1;21;.955;3600000;0
1873;27474;57;51;28;4;24;.857;3600000;0
1874;2796;59;74;26;2;24;.923;3884000;0
1874;26967;63;80;35;3;32;.914;3884000;0
1874;31858;59;0;0;0;0;.00nan;0;0
1874;34814;63;0;0;0;0;.00nan;0;0
1875;3847;38;0;0;0;0;.00nan;0;0
1875;31021;38;67;38;4;34;.895;3574000;0
1875;31408;52;63;27;2;25;.926;3600000;0
1875;32146;52;0;0;0;0;.00nan;0;0
1876;4338;65;76;27;2;25;.926;3600000;0
1876;4987;65;0;0;0;0;.00nan;0;0
1876;28772;53;0;0;0;0;.00nan;0;0
1876;31156;53;59;31;4;27;.871;3529000;0
1877;2900;36;100;30;0;30;1.000;3600000;0
1877;5298;55;36;32;6;26;.813;3600000;0
1877;14874;36;0;0;0;0;.00nan;0;0
1877;34770;55;0;0;0;0;.00nan;0;0
1878;6081;56;89;43;2;41;.953;3600000;0
1878;14061;56;0;0;0;0;.00nan;0;0
1878;23493;51;58;34;4;30;.882;3552000;0
1878;31822;51;0;0;0;0;.00nan;0;0
1879;37;46;0;0;0;0;.00nan;0;0
1879;2553;46;94;41;3;38;.927;3528000;0
1879;4447;54;69;23;2;21;.913;3600000;0
1879;31126;54;0;0;0;0;.00nan;0;0
1880;376;45;55;29;4;25;.862;3599000;0
1880;2198;45;0;0;0;0;.00nan;0;0
1880;25076;42;68;24;2;22;.917;3600000;0
1880;34788;42;0;0;0;0;.00nan;0;0
1881;1051;44;73;26;2;24;.923;3600000;0
1881;2152;49;51;32;5;27;.844;3600000;0
1881;3281;44;0;0;0;0;.00nan;0;0
1881;4435;49;0;0;0;0;.00nan;0;0
1882;3626;48;59;46;5;41;.891;3833000;0
1882;14351;40;0;0;0;0;.00nan;0;0
1882;26840;40;54;32;4;28;.875;3833000;0
1882;38547;48;0;0;0;0;.00nan;0;0
1883;3;50;38;23;5;18;.783;3524000;0
1883;4716;4619;93;42;3;39;.929;3600000;0
1883;5571;50;0;0;0;0;.00nan;0;0
1883;23255;4619;0;0;0;0;.00nan;0;0
1884;7049;47;80;44;4;40;.909;3600000;0
1884;20717;60;0;0;0;0;.00nan;0;0
1884;33654;47;0;0;0;0;.00nan;0;0
1884;35536;60;100;25;0;25;1.000;3600000;0
1885;2016;61;65;23;2;21;.913;3600000;0
1885;6572;62;58;27;3;24;.889;3600000;0
1885;26919;62;0;0;0;0;.00nan;0;0
1885;30971;61;0;0;0;0;.00nan;0;0
1886;8046;57;0;0;0;0;.00nan;0;0
1886;19640;41;89;23;0;23;1.000;3600000;0
1886;23075;41;0;0;0;0;.00nan;0;0
1886;27474;57;43;24;4;20;.833;3600000;0
1887;5137;58;0;0;0;0;.00nan;0;0
1887;15437;58;70;21;1;20;.952;3815000;0
1887;31408;52;0;0;0;0;.00nan;0;0
1887;32146;52;92;38;2;36;.947;3815000;0
1888;4338;65;0;0;0;0;.00nan;0;0
1888;4987;65;68;30;3;27;.900;3600000;0
1888;28772;53;100;27;0;27;1.000;3600000;0
1888;31156;53;0;0;0;0;.00nan;0;0
1889;751;64;43;30;5;25;.833;3600000;0
1889;2296;37;70;23;2;21;.913;3600000;0
1889;5146;64;0;0;0;0;.00nan;0;0
1889;5883;37;0;0;0;0;.00nan;0;0
1890;1051;44;0;0;0;0;.00nan;0;0
1890;2152;49;0;0;0;0;.00nan;0;0
1890;3281;44;100;39;0;39;1.000;3600000;0
1890;4435;49;56;20;2;18;.900;3546000;0
1891;2016;61;48;21;3;18;.857;2590000;0
1891;6572;62;0;0;0;0;.00nan;0;0
1891;26919;62;95;44;2;42;.955;3600000;0
1891;30971;61;15;7;4;3;.429;1010000;0
1892;7049;47;0;0;0;0;.00nan;0;0
1892;20717;60;0;0;0;0;.00nan;0;0
1892;33654;47;60;32;3;29;.906;3581000;0
1892;35536;60;85;28;2;26;.929;3600000;0
1893;2796;59;0;0;0;0;.00nan;0;0
1893;4338;65;78;43;4;39;.907;3600000;0
1893;4987;65;0;0;0;0;.00nan;0;0
1893;31858;59;31;25;5;20;.800;3559000;0
1894;2152;49;74;30;2;28;.933;3600000;0
1894;4435;49;0;0;0;0;.00nan;0;0
1894;20717;60;0;0;0;0;.00nan;0;0
1894;35536;60;67;17;1;16;.941;3600000;0
1895;1486;43;0;0;0;0;.00nan;0;0
1895;2900;36;76;23;1;22;.957;3600000;0
1895;3625;43;86;31;2;29;.935;3600000;0
1895;14874;36;0;0;0;0;.00nan;0;0
1896;3847;38;0;0;0;0;.00nan;0;0
1896;5298;55;0;0;0;0;.00nan;0;0
1896;31021;38;59;28;4;24;.857;3600000;0
1896;34770;55;54;32;5;27;.844;3552000;0
1897;37;46;46;26;4;22;.846;3600000;0
1897;2553;46;0;0;0;0;.00nan;0;0
1897;4447;54;47;32;5;27;.844;3600000;0
1897;31126;54;0;0;0;0;.00nan;0;0
1898;376;45;0;0;0;0;.00nan;0;0
1898;751;64;0;0;0;0;.00nan;0;0
1898;2198;45;70;28;2;26;.929;3600000;0
1898;5146;64;51;21;3;18;.857;3587000;0
1899;3;50;59;30;3;27;.900;3900000;0
1899;5048;50;0;0;0;0;.00nan;0;0
1899;25076;42;0;0;0;0;.00nan;0;0
1899;34788;42;87;40;3;37;.925;3900000;0
1900;1051;44;0;0;0;0;.00nan;0;0
1900;3281;44;74;25;2;23;.920;3600000;0
1900;7049;47;50;27;3;24;.889;3586000;0
1900;33654;47;0;0;0;0;.00nan;0;0
1901;4716;4619;61;22;2;20;.909;3600000;0
1901;6572;62;75;54;5;49;.907;3600000;0
1901;23255;4619;0;0;0;0;.00nan;0;0
1901;26919;62;0;0;0;0;.00nan;0;0
1902;3847;38;0;0;0;0;.00nan;0;0
1902;28772;53;92;37;2;35;.946;3600000;0
1902;31021;38;67;34;3;31;.912;3550000;0
1902;31156;53;0;0;0;0;.00nan;0;0
1903;1486;43;0;0;0;0;.00nan;0;0
1903;2796;59;0;0;0;0;.00nan;0;0
1903;3625;43;79;29;2;27;.931;3559000;0
1903;31858;59;95;36;1;35;.972;3600000;0
1904;5298;55;0;0;0;0;.00nan;0;0
1904;19640;41;53;31;4;27;.871;3511000;0
1904;23075;41;0;0;0;0;.00nan;0;0
1904;34770;55;75;32;2;30;.938;3600000;0
1905;6081;56;0;0;0;0;.00nan;0;0
1905;14061;56;60;25;3;22;.880;3600000;0
1905;26967;63;56;33;4;29;.879;3582000;0
1905;34814;63;0;0;0;0;.00nan;0;0
1906;5137;58;0;0;0;0;.00nan;0;0
1906;8046;57;0;0;0;0;.00nan;0;0
1906;15437;58;42;22;4;18;.818;3600000;0
1906;27474;57;51;37;5;32;.865;3557000;0
1907;2163;39;0;0;0;0;.00nan;0;0
1907;2900;36;0;0;0;0;.00nan;0;0
1907;9238;39;63;28;3;25;.893;3600000;0
1907;14874;36;86;50;4;46;.920;3546000;0
1908;4447;54;0;0;0;0;.00nan;0;0
1908;25076;42;0;0;0;0;.00nan;0;0
1908;31126;54;64;43;5;38;.884;3600000;0
1908;34788;42;66;27;4;23;.852;3600000;0
1909;37;46;0;0;0;0;.00nan;0;0
1909;751;64;0;0;0;0;.00nan;0;0
1909;2553;46;100;27;0;27;1.000;3600000;0
1909;5146;64;64;27;3;24;.889;3600000;0
1910;376;45;0;0;0;0;.00nan;0;0
1910;2198;45;67;45;5;40;.889;3600000;0
1910;23493;51;70;19;1;18;.947;3600000;0
1910;31822;51;0;0;0;0;.00nan;0;0
1911;3;50;83;31;2;29;.935;3600000;0
1911;5048;50;0;0;0;0;.00nan;0;0
1911;6572;62;68;39;4;35;.897;3540000;0
1911;26919;62;0;0;0;0;.00nan;0;0
1912;1051;44;67;25;2;23;.920;3544000;0
1912;3281;44;0;0;0;0;.00nan;0;0
1912;7049;47;100;34;1;33;.971;3600000;0
1912;33654;47;0;0;0;0;.00nan;0;0
1913;2152;49;59;36;5;31;.861;3600000;0
1913;4435;49;0;0;0;0;.00nan;0;0
1913;20717;60;0;0;0;0;.00nan;0;0
1913;35536;60;70;19;1;18;.947;3600000;0
1914;3626;48;89;32;1;31;.969;3600000;0
1914;4716;4619;85;30;2;28;.933;3589000;0
1914;23255;4619;0;0;0;0;.00nan;0;0
1914;38547;48;0;0;0;0;.00nan;0;0
1915;2016;61;80;37;3;34;.919;3600000;0
1915;2296;37;88;23;0;23;1.000;3600000;0
1915;23043;37;0;0;0;0;.00nan;0;0
1915;30971;61;0;0;0;0;.00nan;0;0
1916;2163;39;83;28;1;27;.964;3600000;0
1916;5298;55;82;36;3;33;.917;3600000;0
1916;9238;39;0;0;0;0;.00nan;0;0
1916;34770;55;0;0;0;0;.00nan;0;0
1917;8046;57;0;0;0;0;.00nan;0;0
1917;27474;57;56;25;4;21;.840;3600000;0
1917;28772;53;0;0;0;0;.00nan;0;0
1917;31156;53;99;39;1;38;.974;3600000;0
1918;4338;65;100;34;0;34;1.000;3600000;0
1918;4987;65;0;0;0;0;.00nan;0;0
1918;31408;52;0;0;0;0;.00nan;0;0
1918;32146;52;78;35;2;33;.943;3517000;0
1919;2900;36;91;41;3;38;.927;3844000;0
1919;14874;36;0;0;0;0;.00nan;0;0
1919;19640;41;0;0;0;0;.00nan;0;0
1919;23075;41;41;23;4;19;.826;3844000;0
1920;1486;43;51;23;3;20;.870;3617000;0
1920;2796;59;0;0;0;0;.00nan;0;0
1920;3625;43;0;0;0;0;.00nan;0;0
1920;31858;59;66;25;2;23;.920;3617000;0
1921;6081;56;68;28;3;25;.893;3600000;0
1921;14061;56;0;0;0;0;.00nan;0;0
1921;26967;63;0;0;0;0;.00nan;0;0
1921;34814;63;63;32;4;28;.875;3564000;0
1922;37;46;0;0;0;0;.00nan;0;0
1922;2553;46;69;28;3;25;.893;3600000;0
1922;4447;54;88;32;2;30;.938;3600000;0
1922;31126;54;0;0;0;0;.00nan;0;0
1923;3;50;0;0;0;0;.00nan;0;0
1923;5048;50;80;24;1;23;.958;3600000;0
1923;6572;62;0;0;0;0;.00nan;0;0
1923;26919;62;92;38;2;36;.947;3541000;0
1924;3847;38;69;28;3;25;.893;3600000;0
1924;5137;58;57;41;5;36;.878;3556000;0
1924;15437;58;0;0;0;0;.00nan;0;0
1924;31021;38;0;0;0;0;.00nan;0;0
1925;751;64;62;37;4;33;.892;3600000;0
1925;5146;64;0;0;0;0;.00nan;0;0
1925;25076;42;48;35;5;30;.857;3599000;0
1925;34788;42;0;0;0;0;.00nan;0;0
1926;376;45;57;33;4;29;.879;3900000;0
1926;2198;45;0;0;0;0;.00nan;0;0
1926;23493;51;68;35;4;31;.886;3900000;0
1926;31822;51;0;0;0;0;.00nan;0;0
1927;2152;49;0;0;0;0;.00nan;0;0
1927;4435;49;100;22;0;22;1.000;3600000;0
1927;14351;40;0;0;0;0;.00nan;0;0
1927;26840;40;89;37;2;35;.946;3598000;0
1928;1051;44;0;0;0;0;.00nan;0;0
1928;3281;44;75;38;4;34;.895;3600000;0
1928;7049;47;0;0;0;0;.00nan;0;0
1928;33654;47;44;30;5;25;.833;3600000;0
1929;3626;48;0;0;0;0;.00nan;0;0
1929;4716;4619;0;0;0;0;.00nan;0;0
1929;23255;4619;63;31;3;28;.903;3546000;0
1929;38547;48;78;33;2;31;.939;3600000;0
1930;2016;61;0;0;0;0;.00nan;0;0
1930;2296;37;75;37;3;34;.919;3583000;0
1930;23043;37;0;0;0;0;.00nan;0;0
1930;30971;61;85;28;1;27;.964;3600000;0
1931;4338;65;83;32;2;30;.938;3533000;0
1931;4987;65;0;0;0;0;.00nan;0;0
1931;8046;57;97;24;0;24;1.000;3600000;0
1931;27474;57;0;0;0;0;.00nan;0;0
1932;8046;57;71;26;2;24;.923;3877000;0
1932;27474;57;0;0;0;0;.00nan;0;0
1932;31408;52;0;0;0;0;.00nan;0;0
1932;32146;52;100;40;1;39;.975;3877000;0
1933;4338;65;81;29;2;27;.931;3600000;0
1933;4987;65;0;0;0;0;.00nan;0;0
1933;28772;53;0;0;0;0;.00nan;0;0
1933;31156;53;65;33;3;30;.909;3543000;0
1934;5298;55;73;30;4;26;.867;3900000;0
1934;23493;51;66;27;4;23;.852;3900000;0
1934;31822;51;0;0;0;0;.00nan;0;0
1934;34770;55;0;0;0;0;.00nan;0;0
1935;2900;36;75;34;4;30;.882;3600000;0
1935;6081;56;0;0;0;0;.00nan;0;0
1935;14061;56;79;25;1;24;.960;3600000;0
1935;14874;36;0;0;0;0;.00nan;0;0
1936;2796;59;61;26;4;22;.846;3600000;0
1936;5137;58;0;0;0;0;.00nan;0;0
1936;15437;58;43;33;6;27;.818;3575000;0
1936;31858;59;0;0;0;0;.00nan;0;0
1937;2163;39;0;0;0;0;.00nan;0;0
1937;9238;39;94;31;1;30;.968;3600000;0
1937;19640;41;0;0;0;0;.00nan;0;0
1937;23075;41;76;50;6;44;.880;3600000;0
1938;4447;54;0;0;0;0;.00nan;0;0
1938;25076;42;58;15;1;14;.933;891000;0
1938;31126;54;61;42;4;38;.905;3600000;0
1938;34788;42;17;23;7;16;.696;2709000;0
1939;4716;4619;60;20;2;18;.900;3543000;0
1939;6572;62;96;39;1;38;.974;3600000;0
1939;23255;4619;0;0;0;0;.00nan;0;0
1939;26919;62;0;0;0;0;.00nan;0;0
1940;3626;48;83;46;4;42;.913;3892000;0
1940;20717;60;0;0;0;0;.00nan;0;0
1940;35536;60;48;30;5;25;.833;3892000;0
1940;38547;48;0;0;0;0;.00nan;0;0
1941;1486;43;0;0;0;0;.00nan;0;0
1941;3625;43;58;20;3;17;.850;3633000;0
1941;26967;63;0;0;0;0;.00nan;0;0
1941;34814;63;73;40;4;36;.900;3633000;0
1942;3626;48;0;0;0;0;.00nan;0;0
1942;20717;60;99;19;0;19;1.000;3600000;0
1942;35536;60;0;0;0;0;.00nan;0;0
1942;38547;48;95;43;2;41;.953;3579000;0
1943;2016;61;0;0;0;0;.00nan;0;0
1943;14351;40;100;41;2;39;.951;3900000;0
1943;26840;40;0;0;0;0;.00nan;0;0
1943;30971;61;97;41;2;39;.951;3900000;0
1944;1486;43;45;33;5;28;.848;3600000;0
1944;3625;43;0;0;0;0;.00nan;0;0
1944;4338;65;51;28;4;24;.857;3600000;0
1944;4987;65;0;0;0;0;.00nan;0;0
1945;5298;55;0;0;0;0;.00nan;0;0
1945;23493;51;100;41;0;41;1.000;3600000;0
1945;31822;51;0;0;0;0;.00nan;0;0
1945;34770;55;89;40;3;37;.925;3600000;0
1946;2900;36;0;0;0;0;.00nan;0;0
1946;6081;56;0;0;0;0;.00nan;0;0
1946;14061;56;99;37;1;36;.973;3600000;0
1946;14874;36;48;27;4;23;.852;3600000;0
1947;37;46;0;0;0;0;.00nan;0;0
1947;2152;49;0;0;0;0;.00nan;0;0
1947;2553;46;47;27;5;22;.815;3600000;0
1947;4435;49;79;28;2;26;.929;3600000;0
1948;3847;38;56;30;4;26;.867;3600000;0
1948;26919;57;0;0;0;0;.00nan;0;0
1948;27474;57;84;28;1;27;.964;3600000;0
1948;31021;38;0;0;0;0;.00nan;0;0
1949;2796;59;0;0;0;0;.00nan;0;0
1949;31408;52;0;0;0;0;.00nan;0;0
1949;31858;59;54;30;5;25;.833;3600000;0
1949;32146;52;95;22;0;22;1.000;3600000;0
1950;5137;58;0;0;0;0;.00nan;0;0
1950;15437;58;59;22;2;20;.909;3556000;0
1950;28772;53;100;38;1;37;.974;3600000;0
1950;31156;53;0;0;0;0;.00nan;0;0
1951;2163;39;0;0;0;0;.00nan;0;0
1951;9238;39;68;23;2;21;.913;3600000;0
1951;19640;41;0;0;0;0;.00nan;0;0
1951;23075;41;55;36;5;31;.861;3600000;0
1952;376;45;0;0;0;0;.00nan;0;0
1952;2198;45;97;22;0;22;1.000;3600000;0
1952;2296;37;54;17;2;15;.882;3513000;0
1952;23043;37;0;0;0;0;.00nan;0;0
1953;751;64;78;24;1;23;.958;3600000;0
1953;4447;54;26;28;6;22;.786;3600000;0
1953;5146;64;0;0;0;0;.00nan;0;0
1953;31126;54;0;0;0;0;.00nan;0;0
1954;3;50;86;34;2;32;.941;3600000;0
1954;5048;50;0;0;0;0;.00nan;0;0
1954;25076;42;0;0;0;0;.00nan;0;0
1954;34788;42;78;22;1;21;.955;3600000;0
1955;4716;4619;34;25;5;20;.800;3572000;0
1955;7049;47;0;0;0;0;.00nan;0;0
1955;23255;4619;0;0;0;0;.00nan;0;0
1955;33654;47;89;49;4;45;.918;3600000;0
1956;1051;44;63;29;3;26;.897;3600000;0
1956;3281;44;0;0;0;0;.00nan;0;0
1956;6572;62;100;26;0;26;1.000;3600000;0
1956;11194;62;0;0;0;0;.00nan;0;0
1957;2016;61;94;38;2;36;.947;3600000;0
1957;14351;40;0;0;0;0;.00nan;0;0
1957;26840;40;62;37;4;33;.892;3569000;0
1957;30971;61;0;0;0;0;.00nan;0;0
1958;1486;43;0;0;0;0;.00nan;0;0
1958;3625;43;90;32;1;31;.969;3600000;0
1958;4338;65;0;0;0;0;.00nan;0;0
1958;4987;65;31;28;6;22;.786;3600000;0
1959;2163;39;34;30;6;24;.800;3307000;0
1959;9238;39;56;2;0;2;1.000;262000;0
1959;26967;63;73;16;0;16;1.000;2554000;0
1959;34814;63;51;31;5;26;.839;1046000;0
1960;2796;59;49;40;6;34;.850;3105000;0
1960;3847;38;0;0;0;0;.00nan;0;0
1960;31021;38;35;16;4;12;.750;3600000;0
1960;31858;59;48;0;0;0;.00nan;485000;0
1961;2900;36;80;34;3;31;.912;3900000;0
1961;14874;36;0;0;0;0;.00nan;0;0
1961;19640;41;92;36;3;33;.917;3900000;0
1961;23075;41;0;0;0;0;.00nan;0;0
1962;5137;58;0;0;0;0;.00nan;0;0
1962;5298;55;46;31;5;26;.839;3600000;0
1962;15437;58;98;37;2;35;.946;3600000;0
1962;34770;55;0;0;0;0;.00nan;0;0
1963;6081;56;79;30;2;28;.933;3600000;0
1963;14061;56;0;0;0;0;.00nan;0;0
1963;23493;51;55;33;4;29;.879;3578000;0
1963;31822;51;0;0;0;0;.00nan;0;0
1964;376;45;0;0;0;0;.00nan;0;0
1964;2198;45;44;28;5;23;.821;3600000;0
1964;2296;37;0;0;0;0;.00nan;0;0
1964;23043;37;75;21;1;20;.952;3600000;0
1965;751;64;0;0;0;0;.00nan;0;0
1965;4447;54;52;4;0;4;1.000;544000;0
1965;5146;64;64;25;2;23;.920;3600000;0
1965;31126;54;48;41;6;35;.854;3056000;0
1966;37;46;96;48;2;46;.958;3900000;0
1966;2152;49;76;25;2;23;.920;3900000;0
1966;2553;46;0;0;0;0;.00nan;0;0
1966;4435;49;0;0;0;0;.00nan;0;0
1967;3;50;0;0;0;0;.00nan;0;0
1967;5048;50;41;33;5;28;.848;3600000;0
1967;25076;42;99;42;1;41;.976;3600000;0
1967;34788;42;0;0;0;0;.00nan;0;0
1968;26919;57;0;0;0;0;.00nan;0;0
1968;27474;57;58;26;3;23;.885;3600000;0
1968;31408;52;0;0;0;0;.00nan;0;0
1968;32146;52;56;27;4;23;.852;3578000;0
1969;4716;4619;0;0;0;0;.00nan;0;0
1969;7049;47;64;36;4;32;.889;3593000;0
1969;23255;4619;80;33;2;31;.939;3600000;0
1969;33654;47;0;0;0;0;.00nan;0;0
1970;1051;44;0;0;0;0;.00nan;0;0
1970;3281;44;52;21;3;18;.857;3546000;0
1970;6572;62;100;40;2;38;.950;3600000;0
1970;11194;62;0;0;0;0;.00nan;0;0
1971;3;50;75;8;0;8;1.000;3600000;0
1971;37;46;0;0;0;0;.00nan;0;0
1971;2553;46;90;57;4;53;.930;3600000;0
1971;5048;50;0;0;0;0;.00nan;0;0
1972;5137;58;0;0;0;0;.00nan;0;0
1972;15437;58;92;36;3;33;.917;3513000;0
1972;28772;53;92;32;1;31;.969;3600000;0
1972;38651;53;0;0;0;0;.00nan;0;0
1973;19640;41;0;0;0;0;.00nan;0;0
1973;23075;41;93;43;3;40;.930;3627000;0
1973;31408;52;0;0;0;0;.00nan;0;0
1973;32146;52;65;30;4;26;.867;3664000;0
1974;1486;43;88;28;1;27;.964;3600000;0
1974;3625;43;0;0;0;0;.00nan;0;0
1974;5298;55;0;0;0;0;.00nan;0;0
1974;34770;55;68;35;3;32;.914;3600000;0
1975;2900;36;0;0;0;0;.00nan;0;0
1975;14874;36;78;42;3;39;.929;3900000;0
1975;23493;51;0;0;0;0;.00nan;0;0
1975;31822;51;79;34;3;31;.912;3900000;0
1976;2163;39;0;0;0;0;.00nan;0;0
1976;3847;38;0;0;0;0;.00nan;0;0
1976;9238;39;44;17;3;14;.824;3600000;0
1976;31021;38;91;36;1;35;.972;3600000;0
1977;4338;65;68;18;1;17;.944;3600000;0
1977;4987;65;0;0;0;0;.00nan;0;0
1977;26919;57;0;0;0;0;.00nan;0;0
1977;27474;57;69;31;3;28;.903;3585000;0
1978;2796;59;0;0;0;0;.00nan;0;0
1978;6081;56;0;0;0;0;.00nan;0;0
1978;14061;56;57;53;6;47;.887;3578000;0
1978;34819;59;55;27;4;23;.852;3600000;0
1979;4106;64;32;34;7;27;.794;3600000;0
1979;5146;64;0;0;0;0;.00nan;0;0
1979;25076;42;0;0;0;0;.00nan;0;0
1979;34788;42;79;25;1;24;.960;3600000;0
1980;376;45;0;0;0;0;.00nan;0;0
1980;2198;45;100;42;1;41;.976;3600000;0
1980;4447;54;0;0;0;0;.00nan;0;0
1980;31126;54;44;18;3;15;.833;3563000;0
1981;3;50;83;17;0;17;1.000;3600000;0
1981;37;46;62;39;4;35;.897;3600000;0
1981;5048;50;0;0;0;0;.00nan;0;0
1981;35622;46;0;0;0;0;.00nan;0;0
1982;1051;44;0;0;0;0;.00nan;0;0
1982;3281;44;71;34;3;31;.912;3566000;0
1982;4716;4619;82;34;2;32;.941;3600000;0
1982;23255;4619;0;0;0;0;.00nan;0;0
1983;3626;48;0;0;0;0;.00nan;0;0
1983;7049;47;0;0;0;0;.00nan;0;0
1983;33654;47;90;24;1;23;.958;3600000;0
1983;38547;48;68;36;4;32;.889;3600000;0
1984;6572;62;82;47;4;43;.915;3591000;0
1984;11194;62;0;0;0;0;.00nan;0;0
1984;20717;60;47;17;3;14;.824;3600000;0
1984;35536;60;0;0;0;0;.00nan;0;0
1985;2152;49;0;0;0;0;.00nan;0;0
1985;4435;49;68;28;2;26;.929;3600000;0
1985;14351;40;0;0;0;0;.00nan;0;0
1985;26840;40;51;30;4;26;.867;3581000;0
1986;2016;61;0;0;0;0;.00nan;0;0
1986;2296;37;0;0;0;0;.00nan;0;0
1986;5883;37;70;30;2;28;.933;3600000;0
1986;30971;61;68;37;5;32;.865;3600000;0
1987;2900;36;70;33;3;30;.909;3582000;0
1987;14874;36;0;0;0;0;.00nan;0;0
1987;23493;51;74;32;2;30;.938;3600000;0
1987;31822;51;0;0;0;0;.00nan;0;0
1988;19640;41;61;32;4;28;.875;3600000;0
1988;23075;41;0;0;0;0;.00nan;0;0
1988;31408;52;0;0;0;0;.00nan;0;0
1988;32146;52;91;30;1;29;.967;3600000;0
1989;2163;39;56;27;3;24;.889;3900000;0
1989;9238;39;0;0;0;0;.00nan;0;0
1989;28772;53;0;0;0;0;.00nan;0;0
1989;38651;53;81;36;3;33;.917;3900000;0
1990;4338;65;0;0;0;0;.00nan;0;0
1990;4987;65;100;39;1;38;.974;3600000;0
1990;6081;56;65;22;2;20;.909;3565000;0
1990;14061;56;0;0;0;0;.00nan;0;0
1991;1486;43;0;0;0;0;.00nan;0;0
1991;3625;43;68;33;3;30;.909;3600000;0
1991;5298;55;67;32;4;28;.875;3592000;0
1991;34770;55;0;0;0;0;.00nan;0;0
1992;2796;59;71;21;1;20;.952;3600000;0
1992;26919;57;55;34;5;29;.853;3600000;0
1992;27474;57;0;0;0;0;.00nan;0;0
1992;34819;59;0;0;0;0;.00nan;0;0
1993;3847;38;53;27;3;24;.889;3600000;0
1993;5137;58;55;32;4;28;.875;3549000;0
1993;15437;58;0;0;0;0;.00nan;0;0
1993;31021;38;0;0;0;0;.00nan;0;0
1994;4106;64;0;0;0;0;.00nan;0;0
1994;5146;64;70;29;3;26;.897;3600000;0
1994;25076;42;65;23;2;21;.913;3600000;0
1994;34788;42;0;0;0;0;.00nan;0;0
1995;376;45;67;38;4;34;.895;3546000;0
1995;2198;45;0;0;0;0;.00nan;0;0
1995;4447;54;86;33;2;31;.939;3600000;0
1995;31126;54;0;0;0;0;.00nan;0;0
1996;2152;49;83;35;2;33;.943;3600000;0
1996;4435;49;0;0;0;0;.00nan;0;0
1996;14351;40;62;29;3;26;.897;3600000;0
1996;26840;40;0;0;0;0;.00nan;0;0
1997;1051;44;58;34;4;30;.882;3600000;0
1997;3281;44;0;0;0;0;.00nan;0;0
1997;4716;4619;0;0;0;0;.00nan;0;0
1997;23255;4619;100;22;0;22;1.000;3600000;0
1998;3626;48;89;34;2;32;.941;3592000;0
1998;7049;47;88;27;1;26;.963;3600000;0
1998;33654;47;0;0;0;0;.00nan;0;0
1998;38547;48;0;0;0;0;.00nan;0;0
1999;2016;61;77;39;3;36;.923;3600000;0
1999;2296;37;55;42;6;36;.857;3053000;0
1999;5883;37;57;7;0;7;1.000;547000;0
1999;30971;61;0;0;0;0;.00nan;0;0
2000;4106;64;84;23;1;22;.957;3600000;0
2000;4447;54;0;0;0;0;.00nan;0;0
2000;5146;64;0;0;0;0;.00nan;0;0
2000;31126;54;70;30;2;28;.933;3573000;0
2001;907;39;72;24;2;22;.917;3587000;0
2001;9238;39;0;0;0;0;.00nan;0;0
2001;31408;52;0;0;0;0;.00nan;0;0
2001;32146;52;100;33;1;32;.970;3600000;0
2002;2163;59;0;0;0;0;.00nan;0;0
2002;2796;59;61;31;4;27;.871;3519000;0
2002;19640;41;86;33;2;31;.939;3600000;0
2002;23075;41;0;0;0;0;.00nan;0;0
2003;37;46;52;37;5;32;.865;3574000;0
2003;376;45;0;0;0;0;.00nan;0;0
2003;2198;45;58;26;3;23;.885;3600000;0
2003;35622;46;0;0;0;0;.00nan;0;0
2004;3626;48;58;40;5;35;.875;3590000;0
2004;4716;4619;0;0;0;0;.00nan;0;0
2004;23255;4619;43;15;3;12;.800;3600000;0
2004;38547;48;0;0;0;0;.00nan;0;0
2005;5298;55;64;40;4;36;.900;3600000;0
2005;26967;63;0;0;0;0;.00nan;0;0
2005;34770;55;0;0;0;0;.00nan;0;0
2005;34814;63;86;40;3;37;.925;3600000;0
2006;2163;59;49;24;4;20;.833;3600000;0
2006;2796;59;0;0;0;0;.00nan;0;0
2006;19640;41;0;0;0;0;.00nan;0;0
2006;23075;41;85;37;2;35;.946;3600000;0
2007;6081;56;0;0;0;0;.00nan;0;0
2007;14061;56;43;36;5;31;.861;3600000;0
2007;23493;51;72;26;2;24;.923;3600000;0
2007;31822;51;0;0;0;0;.00nan;0;0
2008;5137;58;0;0;0;0;.00nan;0;0
2008;15437;58;67;18;1;17;.944;3600000;0
2008;26919;57;0;0;0;0;.00nan;0;0
2008;27474;57;86;33;2;31;.939;3600000;0
2009;4447;54;84;32;2;30;.938;3600000;0
2009;25076;42;0;0;0;0;.00nan;0;0
2009;31126;54;0;0;0;0;.00nan;0;0
2009;34788;42;65;37;4;33;.892;3541000;0
2010;37;46;0;0;0;0;.00nan;0;0
2010;376;45;71;29;2;27;.931;3600000;0
2010;2198;45;0;0;0;0;.00nan;0;0
2010;35622;46;58;28;3;25;.893;3567000;0
2011;3626;48;74;29;1;28;.966;2463000;0
2011;4716;4619;31;14;4;10;.714;3600000;0
2011;23255;4619;0;0;0;0;.00nan;0;0
2011;38547;48;38;19;4;15;.789;1108000;0
2012;2016;61;0;0;0;0;.00nan;0;0
2012;7049;47;0;0;0;0;.00nan;0;0
2012;30971;61;58;27;4;23;.852;3646000;0
2012;33654;47;67;35;3;32;.914;3646000;0
2013;6572;62;89;40;3;37;.925;3583000;0
2013;11194;62;0;0;0;0;.00nan;0;0
2013;20717;60;0;0;0;0;.00nan;0;0
2013;35536;60;74;31;2;29;.935;3600000;0
2014;2900;36;0;0;0;0;.00nan;0;0
2014;14874;36;75;30;2;28;.933;3600000;0
2014;23493;51;62;28;3;25;.893;3566000;0
2014;31822;51;0;0;0;0;.00nan;0;0
2015;907;39;0;0;0;0;.00nan;0;0
2015;5298;55;46;37;6;31;.838;3600000;0
2015;9238;39;58;20;3;17;.850;3600000;0
2015;32340;55;0;0;0;0;.00nan;0;0
2016;6081;56;0;0;0;0;.00nan;0;0
2016;14061;56;100;40;1;39;.975;3600000;0
2016;26967;63;0;0;0;0;.00nan;0;0
2016;34814;63;48;22;3;19;.864;3531000;0
2017;3847;38;0;0;0;0;.00nan;0;0
2017;4338;65;73;35;3;32;.914;3534000;0
2017;4987;65;0;0;0;0;.00nan;0;0
2017;31021;38;91;27;1;26;.963;3600000;0
2018;1592;63;0;0;0;0;.00nan;0;0
2018;6081;56;63;30;3;27;.900;3583000;0
2018;14061;56;0;0;0;0;.00nan;0;0
2018;34814;63;83;36;2;34;.944;3600000;0
2019;1486;43;0;0;0;0;.00nan;0;0
2019;3625;43;75;42;4;38;.905;3552000;0
2019;19640;41;61;28;3;25;.893;3600000;0
2019;23075;41;0;0;0;0;.00nan;0;0
2020;2163;59;0;0;0;0;.00nan;0;0
2020;2796;59;100;28;0;28;1.000;3600000;0
2020;5137;58;0;0;0;0;.00nan;0;0
2020;35595;58;41;22;4;18;.818;3600000;0
2021;904;38;78;23;1;22;.957;3600000;0
2021;22970;38;0;0;0;0;.00nan;0;0
2021;28772;53;43;26;5;21;.808;3600000;0
2021;31156;53;0;0;0;0;.00nan;0;0
2022;4338;65;0;0;0;0;.00nan;0;0
2022;4987;65;61;36;4;32;.889;3900000;0
2022;31408;52;42;20;4;16;.800;3900000;0
2022;33661;52;0;0;0;0;.00nan;0;0
2023;907;39;70;29;3;26;.897;3580000;0
2023;2900;36;69;21;1;20;.952;3600000;0
2023;9238;39;0;0;0;0;.00nan;0;0
2023;14874;36;0;0;0;0;.00nan;0;0
2024;37;46;77;36;3;33;.917;3600000;0
2024;25076;42;0;0;0;0;.00nan;0;0
2024;34788;42;78;26;2;24;.923;3600000;0
2024;35622;46;0;0;0;0;.00nan;0;0
2025;5298;55;93;33;1;32;.970;3600000;0
2025;26919;57;0;0;0;0;.00nan;0;0
2025;27474;57;73;36;3;33;.917;3570000;0
2025;32340;55;0;0;0;0;.00nan;0;0
2026;3;50;100;23;0;23;1.000;3600000;0
2026;4106;64;38;33;6;27;.818;3600000;0
2026;5048;50;0;0;0;0;.00nan;0;0
2026;5146;64;0;0;0;0;.00nan;0;0
2027;376;45;0;0;0;0;.00nan;0;0
2027;2198;45;74;30;3;27;.900;3600000;0
2027;20717;60;0;0;0;0;.00nan;0;0
2027;35536;60;30;25;5;20;.800;3525000;0
2028;1051;44;0;0;0;0;.00nan;0;0
2028;3281;44;51;35;6;29;.829;3665000;0
2028;3626;48;52;35;5;30;.857;3665000;0
2028;38547;48;0;0;0;0;.00nan;0;0
2029;2016;61;0;0;0;0;.00nan;0;0
2029;23255;4619;80;30;2;28;.933;3735000;0
2029;30971;61;99;41;1;40;.976;3735000;0
2029;35508;4619;0;0;0;0;.00nan;0;0
2030;7049;47;63;16;1;15;.938;1546000;0
2030;14351;40;79;30;2;28;.933;3600000;0
2030;28712;40;0;0;0;0;.00nan;0;0
2030;33654;47;52;26;4;22;.846;2054000;0
2031;2152;49;0;0;0;0;.00nan;0;0
2031;4435;49;69;26;2;24;.923;3600000;0
2031;6572;62;78;40;3;37;.925;3600000;0
2031;11194;62;0;0;0;0;.00nan;0;0
2032;1486;43;84;39;2;37;.949;3869000;0
2032;3625;43;0;0;0;0;.00nan;0;0
2032;19640;41;0;0;0;0;.00nan;0;0
2032;23075;41;90;35;1;34;.971;3869000;0
2033;28772;53;0;0;0;0;.00nan;0;0
2033;31156;53;75;27;2;25;.926;3600000;0
2033;31408;52;0;0;0;0;.00nan;0;0
2033;33661;52;60;27;3;24;.889;3554000;0
2034;2296;37;0;0;0;0;.00nan;0;0
2034;4447;54;52;30;4;26;.867;3600000;0
2034;5883;37;100;50;1;49;.980;3600000;0
2034;31126;54;0;0;0;0;.00nan;0;0
2035;904;38;0;0;0;0;.00nan;0;0
2035;4338;65;66;29;3;26;.897;3600000;0
2035;4987;65;0;0;0;0;.00nan;0;0
2035;22970;38;75;44;5;39;.886;3532000;0
2036;5137;58;0;0;0;0;.00nan;0;0
2036;26919;57;78;28;2;26;.929;3877000;0
2036;27474;57;0;0;0;0;.00nan;0;0
2036;35595;58;78;27;1;26;.963;3877000;0
2037;907;39;0;0;0;0;.00nan;0;0
2037;9238;39;76;30;2;28;.933;3600000;0
2037;23493;51;57;31;4;27;.871;3583000;0
2037;31822;51;0;0;0;0;.00nan;0;0
2038;3;50;90;30;1;29;.967;3600000;0
2038;4106;64;0;0;0;0;.00nan;0;0
2038;5048;50;0;0;0;0;.00nan;0;0
2038;5146;64;88;37;3;34;.919;3547000;0
2039;37;46;0;0;0;0;.00nan;0;0
2039;2553;46;54;26;3;23;.885;3600000;0
2039;25076;42;74;28;1;27;.964;3600000;0
2039;34788;42;0;0;0;0;.00nan;0;0
2040;2016;61;0;0;0;0;.00nan;0;0
2040;23255;4619;0;0;0;0;.00nan;0;0
2040;30971;61;86;31;2;29;.935;3600000;0
2040;35508;4619;66;28;3;25;.893;3600000;0
2041;376;45;34;25;5;20;.800;3600000;0
2041;2198;45;0;0;0;0;.00nan;0;0
2041;20717;60;74;23;2;21;.913;3600000;0
2041;35536;60;0;0;0;0;.00nan;0;0
2042;2152;49;48;35;6;29;.829;3600000;0
2042;4435;49;0;0;0;0;.00nan;0;0
2042;6572;62;0;0;0;0;.00nan;0;0
2042;11194;62;76;45;4;41;.911;3600000;0
2043;7049;47;0;0;0;0;.00nan;0;0
2043;14351;40;0;0;0;0;.00nan;0;0
2043;28712;40;63;23;2;21;.913;3600000;0
2043;33654;47;73;32;3;29;.906;3579000;0
2044;1592;63;0;0;0;0;.00nan;0;0
2044;23493;51;83;16;0;16;1.000;3600000;0
2044;31822;51;0;0;0;0;.00nan;0;0
2044;34814;63;67;46;6;40;.870;3600000;0
2045;2900;36;51;2;0;2;1.000;510000;0
2045;6081;56;0;0;0;0;.00nan;0;0
2045;14061;56;46;32;5;27;.844;3600000;0
2045;14874;36;22;22;6;16;.727;3047000;0
2046;2296;37;69;30;3;27;.900;3600000;0
2046;4447;54;0;0;0;0;.00nan;0;0
2046;5883;37;0;0;0;0;.00nan;0;0
2046;31126;54;58;30;4;26;.867;3600000;0
2047;1051;44;0;0;0;0;.00nan;0;0
2047;3281;44;100;27;0;27;1.000;3600000;0
2047;3626;48;71;30;2;28;.933;3600000;0
2047;38547;48;0;0;0;0;.00nan;0;0
2048;3;50;78;33;2;31;.939;3600000;0
2048;376;45;52;35;5;30;.857;3600000;0
2048;2198;45;0;0;0;0;.00nan;0;0
2048;5048;50;0;0;0;0;.00nan;0;0
2049;23493;51;71;31;3;28;.903;3757000;0
2049;26967;63;0;0;0;0;.00nan;0;0
2049;31822;51;0;0;0;0;.00nan;0;0
2049;34814;63;83;33;2;31;.939;3757000;0
2050;37;46;0;0;0;0;.00nan;0;0
2050;1486;43;0;0;0;0;.00nan;0;0
2050;2553;46;85;39;2;37;.949;3900000;0
2050;3625;43;84;27;2;25;.926;3900000;0
2051;2163;59;0;0;0;0;.00nan;0;0
2051;2796;59;84;29;1;28;.966;3600000;0
2051;27474;57;82;30;2;28;.933;3600000;0
2051;28772;57;0;0;0;0;.00nan;0;0
2052;5137;58;0;0;0;0;.00nan;0;0
2052;31408;52;0;0;0;0;.00nan;0;0
2052;32146;52;94;36;1;35;.972;3600000;0
2052;35595;58;79;34;2;32;.941;3591000;0
2053;2296;37;0;0;0;0;.00nan;0;0
2053;4447;54;81;34;2;32;.941;3600000;0
2053;5883;37;88;39;3;36;.923;3553000;0
2053;31126;54;0;0;0;0;.00nan;0;0
2054;7049;47;78;27;1;26;.963;3900000;0
2054;20717;60;0;0;0;0;.00nan;0;0
2054;25787;47;0;0;0;0;.00nan;0;0
2054;35536;60;93;28;1;27;.964;3900000;0
2055;2152;49;0;0;0;0;.00nan;0;0
2055;3626;48;47;18;3;15;.833;1283000;0
2055;4435;49;47;18;3;15;.833;3600000;0
2055;38547;48;35;25;6;19;.760;2317000;0
2056;3;50;50;23;4;19;.826;3551000;0
2056;376;45;95;37;2;35;.946;3600000;0
2056;2198;45;0;0;0;0;.00nan;0;0
2056;5048;50;0;0;0;0;.00nan;0;0
2057;907;39;0;0;0;0;.00nan;0;0
2057;7139;36;68;26;2;24;.923;3600000;0
2057;9238;39;55;35;5;30;.857;3600000;0
2057;14874;36;0;0;0;0;.00nan;0;0
2058;1486;43;0;0;0;0;.00nan;0;0
2058;3625;43;75;29;2;27;.931;3600000;0
2058;27474;57;57;25;3;22;.880;3559000;0
2058;28772;57;0;0;0;0;.00nan;0;0
2059;4338;65;76;45;5;40;.889;3600000;0
2059;4987;65;0;0;0;0;.00nan;0;0
2059;5298;55;64;31;3;28;.903;3600000;0
2059;32340;55;0;0;0;0;.00nan;0;0
2060;6081;56;0;0;0;0;.00nan;0;0
2060;14061;56;83;41;3;38;.927;3589000;0
2060;23493;51;0;0;0;0;.00nan;0;0
2060;31822;51;89;25;1;24;.960;3600000;0
2061;37;46;0;0;0;0;.00nan;0;0
2061;2553;46;64;32;3;29;.906;3530000;0
2061;7049;47;92;30;1;29;.967;3600000;0
2061;25787;47;0;0;0;0;.00nan;0;0
2062;3847;38;0;0;0;0;.00nan;0;0
2062;19640;41;66;21;2;19;.905;3600000;0
2062;23075;41;0;0;0;0;.00nan;0;0
2062;31021;38;73;34;3;31;.912;3577000;0
2063;5137;58;0;0;0;0;.00nan;0;0
2063;15437;58;76;39;3;36;.923;3549000;0
2063;31156;53;0;0;0;0;.00nan;0;0
2063;38651;53;59;21;2;19;.905;3600000;0
2064;3;50;0;0;0;0;.00nan;0;0
2064;5048;50;69;27;2;25;.926;3900000;0
2064;25076;42;79;31;2;29;.935;3900000;0
2064;34788;42;0;0;0;0;.00nan;0;0
2065;3626;48;88;38;2;36;.947;3900000;0
2065;6572;62;100;37;2;35;.946;3900000;0
2065;11194;62;0;0;0;0;.00nan;0;0
2065;38547;48;0;0;0;0;.00nan;0;0
2066;2016;61;0;0;0;0;.00nan;0;0
2066;14351;40;39;32;5;27;.844;3600000;0
2066;26840;40;0;0;0;0;.00nan;0;0
2066;30971;61;69;17;1;16;.941;3600000;0
2067;1486;43;59;34;4;30;.882;3841000;0
2067;3625;43;0;0;0;0;.00nan;0;0
2067;27474;57;0;0;0;0;.00nan;0;0
2067;28772;57;73;31;3;28;.903;3841000;0
2068;6081;56;75;32;2;30;.938;3600000;0
2068;14061;56;0;0;0;0;.00nan;0;0
2068;23493;51;46;33;6;27;.818;2797000;0
2068;31822;51;44;12;2;10;.833;803000;0
2069;2296;37;50;2;0;2;1.000;262000;0
2069;4106;64;86;28;1;27;.964;3600000;0
2069;5146;64;0;0;0;0;.00nan;0;0
2069;5883;37;37;26;5;21;.808;3338000;0
2070;907;39;76;26;1;25;.962;3600000;0
2070;9238;39;0;0;0;0;.00nan;0;0
2070;26967;63;0;0;0;0;.00nan;0;0
2070;34814;63;61;30;3;27;.900;3515000;0
2071;3847;38;62;37;4;33;.892;3600000;0
2071;31021;38;0;0;0;0;.00nan;0;0
2071;31156;53;72;23;1;22;.957;3600000;0
2071;38651;53;0;0;0;0;.00nan;0;0
2072;2163;59;0;0;0;0;.00nan;0;0
2072;2796;59;96;39;3;36;.923;3585000;0
2072;31408;52;0;0;0;0;.00nan;0;0
2072;32146;52;86;36;2;34;.944;3600000;0
2073;5298;55;79;34;2;32;.941;3558000;0
2073;7139;36;0;0;0;0;.00nan;0;0
2073;14874;36;83;29;1;28;.966;3600000;0
2073;32340;55;0;0;0;0;.00nan;0;0
2074;4447;54;100;25;0;25;1.000;3600000;0
2074;4716;4619;0;0;0;0;.00nan;0;0
2074;23255;4619;73;36;3;33;.917;3600000;0
2074;31126;54;0;0;0;0;.00nan;0;0
2075;37;46;84;16;0;16;1.000;3600000;0
2075;2553;46;0;0;0;0;.00nan;0;0
2075;7049;47;0;0;0;0;.00nan;0;0
2075;25787;47;73;33;3;30;.909;3600000;0
2076;376;45;72;23;2;21;.913;3600000;0
2076;2198;45;0;0;0;0;.00nan;0;0
2076;25076;42;0;0;0;0;.00nan;0;0
2076;34788;42;66;45;5;40;.889;3600000;0
2077;5137;58;86;36;3;33;.917;3547000;0
2077;15437;58;0;0;0;0;.00nan;0;0
2077;19640;41;0;0;0;0;.00nan;0;0
2077;23075;41;85;37;2;35;.946;3600000;0
2078;1051;44;0;0;0;0;.00nan;0;0
2078;2152;49;0;0;0;0;.00nan;0;0
2078;3281;44;72;41;4;37;.902;3600000;0
2078;4435;49;51;32;5;27;.844;3577000;0
2079;3626;48;51;18;2;16;.889;1262000;0
2079;6572;62;0;0;0;0;.00nan;0;0
2079;11194;62;52;28;4;24;.857;3600000;0
2079;38547;48;36;24;5;19;.792;2338000;0
2080;19640;41;77;36;2;34;.944;3900000;0
2080;23075;41;0;0;0;0;.00nan;0;0
2080;31408;52;0;0;0;0;.00nan;0;0
2080;32146;52;87;34;2;32;.941;3900000;0
2081;2296;37;86;29;2;27;.931;3600000;0
2081;4106;64;0;0;0;0;.00nan;0;0
2081;5146;64;89;46;3;43;.935;3557000;0
2081;5883;37;0;0;0;0;.00nan;0;0
2082;3847;38;0;0;0;0;.00nan;0;0
2082;31021;38;88;18;0;18;1.000;3600000;0
2082;31156;53;0;0;0;0;.00nan;0;0
2082;38651;53;81;36;3;33;.917;3600000;0
2083;2163;59;80;23;1;22;.957;3600000;0
2083;2796;59;0;0;0;0;.00nan;0;0
2083;7139;36;66;30;3;27;.900;3561000;0
2083;14874;36;0;0;0;0;.00nan;0;0
2084;907;39;0;0;0;0;.00nan;0;0
2084;9238;39;68;25;2;23;.920;3900000;0
2084;26967;63;90;34;2;32;.941;3900000;0
2084;34814;63;0;0;0;0;.00nan;0;0
2085;4447;54;83;36;2;34;.944;3600000;0
2085;4716;4619;54;24;3;21;.875;3550000;0
2085;23255;4619;0;0;0;0;.00nan;0;0
2085;31126;54;0;0;0;0;.00nan;0;0
2086;4338;65;63;24;3;21;.875;3900000;0
2086;4987;65;0;0;0;0;.00nan;0;0
2086;5298;55;0;0;0;0;.00nan;0;0
2086;32340;55;73;35;3;32;.914;3900000;0
2087;376;45;0;0;0;0;.00nan;0;0
2087;2198;45;100;24;0;24;1.000;3600000;0
2087;25076;42;79;25;1;24;.960;3600000;0
2087;34788;42;0;0;0;0;.00nan;0;0
2088;1051;44;43;27;4;23;.852;3564000;0
2088;2152;49;64;27;3;24;.889;3600000;0
2088;3281;44;0;0;0;0;.00nan;0;0
2088;4435;49;0;0;0;0;.00nan;0;0
2089;2016;61;0;0;0;0;.00nan;0;0
2089;14351;40;88;36;1;35;.972;3600000;0
2089;26840;40;0;0;0;0;.00nan;0;0
2089;30971;61;63;24;2;22;.917;3583000;0
2090;1486;43;55;24;3;21;.875;3577000;0
2090;3625;43;0;0;0;0;.00nan;0;0
2090;23493;51;73;28;2;26;.929;3600000;0
2090;31822;51;0;0;0;0;.00nan;0;0
2091;4338;65;84;24;1;23;.958;3600000;0
2091;4987;65;0;0;0;0;.00nan;0;0
2091;19640;41;71;23;2;21;.913;3572000;0
2091;23075;41;0;0;0;0;.00nan;0;0
2092;2016;61;0;0;0;0;.00nan;0;0
2092;26967;63;0;0;0;0;.00nan;0;0
2092;30971;61;47;35;6;29;.829;3600000;0
2092;34814;63;78;32;3;29;.906;3600000;0
2093;3847;38;0;0;0;0;.00nan;0;0
2093;27474;57;73;24;1;23;.958;3600000;0
2093;28772;57;0;0;0;0;.00nan;0;0
2093;31021;38;66;29;4;25;.862;3600000;0
2094;907;39;0;0;0;0;.00nan;0;0
2094;7139;36;0;0;0;0;.00nan;0;0
2094;9238;39;66;31;3;28;.903;3558000;0
2094;14874;36;74;31;2;29;.935;3600000;0
2095;1486;43;98;36;1;35;.972;3600000;0
2095;3625;43;0;0;0;0;.00nan;0;0
2095;23493;51;85;34;2;32;.941;3570000;0
2095;31822;51;0;0;0;0;.00nan;0;0
2096;376;45;0;0;0;0;.00nan;0;0
2096;2198;45;73;16;1;15;.938;3600000;0
2096;4106;64;83;45;4;41;.911;3600000;0
2096;5146;64;0;0;0;0;.00nan;0;0
2097;4716;4619;0;0;0;0;.00nan;0;0
2097;6572;62;64;24;3;21;.875;3600000;0
2097;11194;62;0;0;0;0;.00nan;0;0
2097;23255;4619;63;35;4;31;.886;3555000;0
2098;1051;44;0;0;0;0;.00nan;0;0
2098;2152;49;56;21;3;18;.857;3900000;0
2098;3281;44;84;35;3;32;.914;3900000;0
2098;4435;49;0;0;0;0;.00nan;0;0
2099;2296;37;0;0;0;0;.00nan;0;0
2099;5883;37;47;18;3;15;.833;3587000;0
2099;25076;42;92;38;1;37;.974;3600000;0
2099;34788;42;0;0;0;0;.00nan;0;0
2100;2163;59;85;27;1;26;.963;3600000;0
2100;2796;59;0;0;0;0;.00nan;0;0
2100;31408;52;0;0;0;0;.00nan;0;0
2100;32146;52;31;31;7;24;.774;3600000;0
2101;5298;55;72;19;1;18;.947;3600000;0
2101;6062;36;57;28;3;25;.893;3539000;0
2101;14874;36;0;0;0;0;.00nan;0;0
2101;32340;55;0;0;0;0;.00nan;0;0
2102;907;39;42;28;5;23;.821;3600000;0
2102;6081;56;0;0;0;0;.00nan;0;0
2102;9238;39;0;0;0;0;.00nan;0;0
2102;14061;56;50;41;6;35;.854;3564000;0
2103;2016;61;0;0;0;0;.00nan;0;0
2103;23493;51;78;38;3;35;.921;3900000;0
2103;30971;61;65;24;3;21;.875;3900000;0
2103;31822;51;0;0;0;0;.00nan;0;0
2104;3;50;80;26;1;25;.962;3600000;0
2104;37;46;93;19;0;19;1.000;3600000;0
2104;2553;46;0;0;0;0;.00nan;0;0
2104;5048;50;0;0;0;0;.00nan;0;0
2105;19640;41;90;34;2;32;.941;3600000;0
2105;23075;41;0;0;0;0;.00nan;0;0
2105;27474;57;56;25;3;22;.880;3556000;0
2105;28772;57;0;0;0;0;.00nan;0;0
2106;4338;65;0;0;0;0;.00nan;0;0
2106;4987;65;95;37;1;36;.973;3562000;0
2106;5137;58;0;0;0;0;.00nan;0;0
2106;15437;58;100;26;0;26;1.000;3600000;0
2107;376;45;84;27;1;26;.963;3600000;0
2107;2198;45;0;0;0;0;.00nan;0;0
2107;4447;54;55;19;2;17;.895;3595000;0
2107;31126;54;0;0;0;0;.00nan;0;0
2108;4716;4619;69;20;1;19;.950;3600000;0
2108;6572;62;79;37;3;34;.919;3600000;0
2108;11194;62;0;0;0;0;.00nan;0;0
2108;23255;4619;0;0;0;0;.00nan;0;0
2109;2152;49;70;28;2;26;.929;3600000;0
2109;3626;48;60;47;5;42;.894;3600000;0
2109;4435;49;0;0;0;0;.00nan;0;0
2109;38547;48;0;0;0;0;.00nan;0;0
2110;7049;47;72;36;4;32;.889;3652000;0
2110;14351;40;54;22;3;19;.864;3652000;0
2110;25787;47;0;0;0;0;.00nan;0;0
2110;26840;40;0;0;0;0;.00nan;0;0
2111;2016;61;78;43;4;39;.907;3600000;0
2111;23493;51;0;0;0;0;.00nan;0;0
2111;30971;61;0;0;0;0;.00nan;0;0
2111;31822;51;79;21;1;20;.952;3600000;0
2112;2296;37;0;0;0;0;.00nan;0;0
2112;5883;37;62;24;2;22;.917;3600000;0
2112;25076;42;58;30;4;26;.867;2502000;0
2112;34788;42;24;12;4;8;.667;1098000;0
2113;2163;59;0;0;0;0;.00nan;0;0
2113;2796;59;100;34;0;34;1.000;3600000;0
2113;31408;52;83;32;2;30;.938;3538000;0
2113;32146;52;0;0;0;0;.00nan;0;0
2114;5298;55;82;22;1;21;.955;3600000;0
2114;6062;36;0;0;0;0;.00nan;0;0
2114;14874;36;97;51;3;48;.941;3570000;0
2114;32340;55;0;0;0;0;.00nan;0;0
2115;1486;43;0;0;0;0;.00nan;0;0
2115;3625;43;58;28;4;24;.857;3717000;0
2115;26967;63;76;39;3;36;.923;3717000;0
2115;34814;63;0;0;0;0;.00nan;0;0
2116;907;39;0;0;0;0;.00nan;0;0
2116;6081;56;84;40;3;37;.925;3900000;0
2116;9238;39;67;39;4;35;.897;3900000;0
2116;14061;56;0;0;0;0;.00nan;0;0
2117;3;50;0;0;0;0;.00nan;0;0
2117;37;46;95;42;2;40;.952;3900000;0
2117;2553;46;0;0;0;0;.00nan;0;0
2117;5048;50;79;35;2;33;.943;3900000;0
2118;19640;41;0;0;0;0;.00nan;0;0
2118;23075;41;43;23;4;19;.826;3900000;0
2118;27474;57;0;0;0;0;.00nan;0;0
2118;28772;57;72;40;4;36;.900;3900000;0
2119;3847;38;0;0;0;0;.00nan;0;0
2119;5137;58;60;21;3;18;.857;3600000;0
2119;15437;58;0;0;0;0;.00nan;0;0
2119;31021;38;46;41;7;34;.829;3600000;0
2120;4338;65;70;35;3;32;.914;3600000;0
2120;4987;65;0;0;0;0;.00nan;0;0
2120;38651;53;70;22;2;20;.909;3600000;0
2120;40293;53;0;0;0;0;.00nan;0;0
2121;376;45;0;0;0;0;.00nan;0;0
2121;2198;45;55;25;3;22;.880;3562000;0
2121;4106;64;0;0;0;0;.00nan;0;0
2121;5146;64;95;24;1;23;.958;3600000;0
2122;2152;49;0;0;0;0;.00nan;0;0
2122;3626;48;0;0;0;0;.00nan;0;0
2122;4435;49;90;19;0;19;1.000;3600000;0
2122;38547;48;70;38;3;35;.921;3600000;0
2123;14351;40;68;32;3;29;.906;3020000;0
2123;20717;60;40;9;2;7;.778;1205000;0
2123;26840;40;38;9;3;6;.667;580000;0
2123;35536;60;22;22;6;16;.727;2385000;0
2124;4716;4619;0;0;0;0;.00nan;0;0
2124;6572;62;0;0;0;0;.00nan;0;0
2124;11194;62;82;38;2;36;.947;3565000;0
2124;23255;4619;100;31;0;31;1.000;3600000;0
2125;1051;44;0;0;0;0;.00nan;0;0
2125;3281;44;75;26;2;24;.923;3600000;0
2125;7049;47;0;0;0;0;.00nan;0;0
2125;25787;47;68;36;4;32;.889;3556000;0
2126;31408;52;55;5;0;5;1.000;375000;0
2126;32146;52;64;40;5;35;.875;3197000;0
2126;38651;53;0;0;0;0;.00nan;0;0
2126;40293;53;61;27;3;24;.889;3600000;0
2127;2163;59;73;32;3;29;.906;3877000;0
2127;2796;59;0;0;0;0;.00nan;0;0
2127;3847;38;81;33;3;30;.909;3900000;0
2127;31021;38;0;0;0;0;.00nan;0;0
2128;3;50;37;26;5;21;.808;3571000;0
2128;4106;64;69;34;4;30;.882;3600000;0
2128;5048;50;0;0;0;0;.00nan;0;0
2128;5146;64;0;0;0;0;.00nan;0;0
2129;37;46;0;0;0;0;.00nan;0;0
2129;2553;46;63;35;4;31;.886;3571000;0
2129;4447;54;66;28;2;26;.929;3600000;0
2129;31126;54;0;0;0;0;.00nan;0;0
2130;1051;44;67;29;3;26;.897;3600000;0
2130;3281;44;0;0;0;0;.00nan;0;0
2130;20717;60;0;0;0;0;.00nan;0;0
2130;35536;60;36;36;6;30;.833;3600000;0
2131;2016;61;0;0;0;0;.00nan;0;0
2131;26967;63;0;0;0;0;.00nan;0;0
2131;30971;61;54;18;2;16;.889;3546000;0
2131;34814;63;100;47;1;46;.979;3600000;0
2132;3;50;26;24;6;18;.750;3600000;0
2132;4447;54;52;21;3;18;.857;3600000;0
2132;5048;50;0;0;0;0;.00nan;0;0
2132;31126;54;0;0;0;0;.00nan;0;0
2133;5298;55;80;24;1;23;.958;3600000;0
2133;6062;36;0;0;0;0;.00nan;0;0
2133;14874;36;54;27;3;24;.889;3600000;0
2133;32340;55;0;0;0;0;.00nan;0;0
2134;37;46;0;0;0;0;.00nan;0;0
2134;2553;46;79;27;1;26;.963;3600000;0
2134;4106;64;0;0;0;0;.00nan;0;0
2134;5146;64;60;34;4;30;.882;3600000;0
2135;3847;38;0;0;0;0;.00nan;0;0
2135;5137;58;0;0;0;0;.00nan;0;0
2135;15437;58;52;24;3;21;.875;3549000;0
2135;31021;38;77;29;2;27;.931;3600000;0
2136;2163;59;0;0;0;0;.00nan;0;0
2136;2796;59;81;26;1;25;.962;3600000;0
2136;4338;65;50;53;7;46;.868;3600000;0
2136;4987;65;0;0;0;0;.00nan;0;0
2137;907;39;0;0;0;0;.00nan;0;0
2137;9238;39;49;23;4;19;.826;3560000;0
2137;23493;51;65;31;3;28;.903;3600000;0
2137;31822;51;0;0;0;0;.00nan;0;0
2138;6572;62;99;41;1;40;.976;3600000;0
2138;11194;62;0;0;0;0;.00nan;0;0
2138;14351;40;50;26;4;22;.846;3600000;0
2138;26840;40;0;0;0;0;.00nan;0;0
2139;2152;49;0;0;0;0;.00nan;0;0
2139;4435;49;54;24;3;21;.875;3541000;0
2139;20717;60;0;0;0;0;.00nan;0;0
2139;35536;60;73;26;2;24;.923;3600000;0
2140;4338;65;79;28;2;26;.929;3600000;0
2140;4987;65;0;0;0;0;.00nan;0;0
2140;31408;52;0;0;0;0;.00nan;0;0
2140;32146;52;65;27;3;24;.889;3600000;0
2141;5137;58;0;0;0;0;.00nan;0;0
2141;15437;58;67;29;3;26;.897;3600000;0
2141;19640;41;56;32;4;28;.875;3600000;0
2141;23075;41;0;0;0;0;.00nan;0;0
2142;5298;55;54;24;3;21;.875;3600000;0
2142;26967;63;0;0;0;0;.00nan;0;0
2142;32340;55;0;0;0;0;.00nan;0;0
2142;34814;63;82;33;2;31;.939;3600000;0
2143;37;46;99;40;1;39;.975;3600000;0
2143;1486;43;67;38;4;34;.895;3600000;0
2143;2553;46;0;0;0;0;.00nan;0;0
2143;3625;43;0;0;0;0;.00nan;0;0
2144;23493;51;66;24;2;22;.917;3521000;0
2144;27474;57;100;46;0;46;1.000;3600000;0
2144;28772;57;0;0;0;0;.00nan;0;0
2144;31822;51;0;0;0;0;.00nan;0;0
2145;907;39;0;0;0;0;.00nan;0;0
2145;6062;36;0;0;0;0;.00nan;0;0
2145;9238;39;99;35;2;33;.943;3600000;0
2145;14874;36;30;25;5;20;.800;3600000;0
2146;2296;37;0;0;0;0;.00nan;0;0
2146;5883;37;56;39;5;34;.872;3600000;0
2146;6081;56;0;0;0;0;.00nan;0;0
2146;14061;56;51;34;4;30;.882;3600000;0
2147;4447;54;82;42;3;39;.929;3546000;0
2147;25076;42;49;12;2;10;.833;3600000;0
2147;31126;54;0;0;0;0;.00nan;0;0
2147;34788;42;0;0;0;0;.00nan;0;0
2148;376;45;100;40;1;39;.975;3600000;0
2148;1051;44;0;0;0;0;.00nan;0;0
2148;2198;45;0;0;0;0;.00nan;0;0
2148;3281;44;77;30;2;28;.933;3552000;0
2149;6572;62;61;26;3;23;.885;3600000;0
2149;7049;47;0;0;0;0;.00nan;0;0
2149;11194;62;0;0;0;0;.00nan;0;0
2149;25787;47;31;28;5;23;.821;3543000;0
2150;14351;40;0;0;0;0;.00nan;0;0
2150;20717;60;0;0;0;0;.00nan;0;0
2150;26840;40;100;27;0;27;1.000;3600000;0
2150;35536;60;45;35;5;30;.857;3600000;0
2151;2016;61;0;0;0;0;.00nan;0;0
2151;4716;4619;0;0;0;0;.00nan;0;0
2151;23255;4619;87;30;1;29;.967;3900000;0
2151;30971;61;100;33;1;32;.970;3900000;0
2152;5137;58;62;23;2;21;.913;3570000;0
2152;15437;58;0;0;0;0;.00nan;0;0
2152;19640;41;0;0;0;0;.00nan;0;0
2152;23075;41;77;28;1;27;.964;3600000;0
2153;2163;59;0;0;0;0;.00nan;0;0
2153;2796;59;89;39;2;37;.949;3600000;0
2153;23493;51;0;0;0;0;.00nan;0;0
2153;31822;51;65;30;3;27;.900;3543000;0
2154;6062;36;80;29;1;28;.966;3600000;0
2154;14874;36;0;0;0;0;.00nan;0;0
2154;26967;63;49;25;3;22;.880;3595000;0
2154;34814;63;0;0;0;0;.00nan;0;0
2155;907;39;63;33;4;29;.879;3900000;0
2155;5298;55;0;0;0;0;.00nan;0;0
2155;9238;39;0;0;0;0;.00nan;0;0
2155;32340;55;59;29;4;25;.862;3872000;0
2156;2296;37;0;0;0;0;.00nan;0;0
2156;5883;37;95;35;2;33;.943;3900000;0
2156;6081;56;78;27;2;25;.926;3900000;0
2156;14061;56;0;0;0;0;.00nan;0;0
2157;4106;64;0;0;0;0;.00nan;0;0
2157;4447;54;100;25;0;25;1.000;3600000;0
2157;5146;64;87;42;2;40;.952;3518000;0
2157;31126;54;0;0;0;0;.00nan;0;0
2158;3;50;74;25;2;23;.920;3600000;0
2158;3626;48;31;23;5;18;.783;2215000;0
2158;5048;50;0;0;0;0;.00nan;0;0
2158;38547;48;49;14;2;12;.857;1385000;0
2159;3847;38;0;0;0;0;.00nan;0;0
2159;31021;38;73;40;4;36;.900;3600000;0
2159;31408;52;0;0;0;0;.00nan;0;0
2159;32146;52;94;26;1;25;.962;3600000;0
2160;27474;57;67;25;2;23;.920;3600000;0
2160;28772;57;0;0;0;0;.00nan;0;0
2160;38651;53;0;0;0;0;.00nan;0;0
2160;40293;53;53;25;3;22;.880;3556000;0
2161;376;45;0;0;0;0;.00nan;0;0
2161;1051;44;100;40;1;39;.975;3600000;0
2161;2198;45;80;44;3;41;.932;3542000;0
2161;3281;44;0;0;0;0;.00nan;0;0
2162;14351;40;41;24;4;20;.833;2653000;0
2162;20717;60;64;19;1;18;.947;3600000;0
2162;26840;40;40;17;4;13;.765;947000;0
2162;35536;60;0;0;0;0;.00nan;0;0
2163;2152;49;49;14;2;12;.857;3600000;0
2163;4435;49;0;0;0;0;.00nan;0;0
2163;6572;62;0;0;0;0;.00nan;0;0
2163;11194;62;96;54;4;50;.926;3600000;0
2164;1486;43;57;13;1;12;.923;1147000;0
2164;3625;43;12;25;7;18;.720;2453000;0
2164;25076;42;79;24;2;22;.917;3600000;0
2164;34788;42;0;0;0;0;.00nan;0;0
2165;3847;38;78;35;3;32;.914;3565000;0
2165;31021;38;0;0;0;0;.00nan;0;0
2165;31408;52;0;0;0;0;.00nan;0;0
2165;32146;52;99;33;1;32;.970;3600000;0
2166;2163;59;47;23;4;19;.826;3600000;0
2166;2796;59;0;0;0;0;.00nan;0;0
2166;38651;53;42;40;6;34;.850;3557000;0
2166;40293;53;0;0;0;0;.00nan;0;0
2167;37;46;0;0;0;0;.00nan;0;0
2167;2553;46;98;35;1;34;.971;3600000;0
2167;4106;64;68;27;2;25;.926;3600000;0
2167;5146;64;0;0;0;0;.00nan;0;0
2168;3;50;0;0;0;0;.00nan;0;0
2168;3626;48;77;29;1;28;.966;3016000;0
2168;5048;50;62;20;2;18;.900;3600000;0
2168;38547;48;39;13;3;10;.769;559000;0
2169;4338;65;77;40;4;36;.900;3520000;0
2169;4987;65;0;0;0;0;.00nan;0;0
2169;27474;57;71;27;2;25;.926;3600000;0
2169;28772;57;0;0;0;0;.00nan;0;0
2170;2016;61;0;0;0;0;.00nan;0;0
2170;4716;4619;0;0;0;0;.00nan;0;0
2170;23255;4619;80;23;1;22;.957;3600000;0
2170;30971;61;73;33;3;30;.909;3579000;0
2171;1486;43;63;30;3;27;.900;3900000;0
2171;3625;43;0;0;0;0;.00nan;0;0
2171;25076;42;75;34;3;31;.912;3900000;0
2171;34788;42;0;0;0;0;.00nan;0;0
2172;2016;61;0;0;0;0;.00nan;0;0
2172;2296;37;0;0;0;0;.00nan;0;0
2172;5883;37;80;36;3;33;.917;3575000;0
2172;30971;61;75;23;1;22;.957;3600000;0
2173;5137;58;0;0;0;0;.00nan;0;0
2173;15437;58;63;33;4;29;.879;3600000;0
2173;31408;52;0;0;0;0;.00nan;0;0
2173;32146;52;70;32;3;29;.906;3600000;0
2174;6062;36;0;0;0;0;.00nan;0;0
2174;14874;36;86;27;1;26;.963;3600000;0
2174;31156;53;65;10;0;10;1.000;576000;0
2174;38651;53;43;42;7;35;.833;3024000;0
2175;37;46;13;12;5;7;.583;1690000;0
2175;376;45;0;0;0;0;.00nan;0;0
2175;2198;45;88;41;3;38;.927;3600000;0
2175;2553;46;72;25;1;24;.960;1910000;0
2176;4106;64;0;0;0;0;.00nan;0;0
2176;4447;54;73;24;2;22;.917;3514000;0
2176;5146;64;100;36;0;36;1.000;3600000;0
2176;31126;54;0;0;0;0;.00nan;0;0
2177;7049;47;0;0;0;0;.00nan;0;0
2177;14351;40;83;37;3;34;.919;3600000;0
2177;25787;47;100;32;0;32;1.000;3600000;0
2177;26840;40;0;0;0;0;.00nan;0;0
2178;1051;44;0;0;0;0;.00nan;0;0
2178;3281;44;77;42;3;39;.929;3900000;0
2178;20717;60;0;0;0;0;.00nan;0;0
2178;35536;60;100;52;3;49;.942;3900000;0
2179;3626;48;0;0;0;0;.00nan;0;0
2179;6572;62;100;30;0;30;1.000;3600000;0
2179;11194;62;0;0;0;0;.00nan;0;0
2179;38547;48;74;35;2;33;.943;3555000;0
2180;2016;61;93;38;1;37;.974;3568000;0
2180;2296;37;0;0;0;0;.00nan;0;0
2180;5883;37;100;34;0;34;1.000;3600000;0
2180;30971;61;0;0;0;0;.00nan;0;0
2181;4338;65;51;37;5;32;.865;3600000;0
2181;4987;65;0;0;0;0;.00nan;0;0
2181;26967;63;0;0;0;0;.00nan;0;0
2181;34814;63;78;32;2;30;.938;3600000;0
2182;3847;38;0;0;0;0;.00nan;0;0
2182;19640;41;74;30;2;28;.933;3600000;0
2182;23075;41;0;0;0;0;.00nan;0;0
2182;31021;38;89;41;3;38;.927;3582000;0
2183;6062;36;15;7;4;3;.429;724000;0
2183;14874;36;40;30;5;25;.833;2876000;0
2183;31408;52;0;0;0;0;.00nan;0;0
2183;32146;52;56;19;2;17;.895;3600000;0
2184;4338;65;0;0;0;0;.00nan;0;0
2184;4987;65;53;48;6;42;.875;3600000;0
2184;6081;56;0;0;0;0;.00nan;0;0
2184;14061;56;70;24;2;22;.917;3600000;0
2185;23493;51;97;23;0;23;1.000;3600000;0
2185;31156;53;0;0;0;0;.00nan;0;0
2185;31822;51;0;0;0;0;.00nan;0;0
2185;38651;53;67;25;2;23;.920;3516000;0
2186;37;46;0;0;0;0;.00nan;0;0
2186;376;45;0;0;0;0;.00nan;0;0
2186;2198;45;86;29;2;27;.931;3600000;0
2186;2553;46;73;28;3;25;.893;3574000;0
2187;2163;59;0;0;0;0;.00nan;0;0
2187;2796;59;81;25;1;24;.960;3600000;0
2187;5298;55;80;40;3;37;.925;3525000;0
2187;32340;55;0;0;0;0;.00nan;0;0
2188;5137;58;0;0;0;0;.00nan;0;0
2188;15437;58;71;35;4;31;.886;3600000;0
2188;27474;57;81;27;1;26;.963;3600000;0
2188;28772;57;0;0;0;0;.00nan;0;0
2189;907;39;0;0;0;0;.00nan;0;0
2189;1486;43;69;33;3;30;.909;3545000;0
2189;3625;43;0;0;0;0;.00nan;0;0
2189;9238;39;87;33;2;31;.939;3600000;0
2190;4716;4619;0;0;0;0;.00nan;0;0
2190;14351;40;0;0;0;0;.00nan;0;0
2190;23255;4619;71;24;2;22;.917;3600000;0
2190;26840;40;76;33;3;30;.909;3569000;0
2191;2152;49;0;0;0;0;.00nan;0;0
2191;4435;49;70;26;2;24;.923;3900000;0
2191;7049;47;0;0;0;0;.00nan;0;0
2191;25787;47;87;31;2;29;.935;3900000;0
2192;3626;48;0;0;0;0;.00nan;0;0
2192;6572;62;80;28;2;26;.929;3600000;0
2192;11194;62;0;0;0;0;.00nan;0;0
2192;38547;48;75;34;3;31;.912;3546000;0
2193;1051;44;0;0;0;0;.00nan;0;0
2193;3281;44;86;28;2;26;.929;3600000;0
2193;20717;60;0;0;0;0;.00nan;0;0
2193;35536;60;70;32;3;29;.906;3546000;0
2194;4338;65;50;37;5;32;.865;3600000;0
2194;4987;65;0;0;0;0;.00nan;0;0
2194;23493;51;82;29;1;28;.966;3600000;0
2194;31822;51;0;0;0;0;.00nan;0;0
2195;4106;64;0;0;0;0;.00nan;0;0
2195;5146;64;78;36;3;33;.917;3576000;0
2195;26967;63;0;0;0;0;.00nan;0;0
2195;34814;63;56;17;2;15;.882;3600000;0
2196;3847;38;0;0;0;0;.00nan;0;0
2196;19640;41;76;25;1;24;.960;3600000;0
2196;23075;41;0;0;0;0;.00nan;0;0
2196;31021;38;61;43;6;37;.860;3600000;0
2197;2163;59;95;44;2;42;.955;3600000;0
2197;2796;59;0;0;0;0;.00nan;0;0
2197;6062;36;42;26;5;21;.808;3600000;0
2197;14874;36;0;0;0;0;.00nan;0;0
2198;907;39;72;25;1;24;.960;3600000;0
2198;1486;43;64;38;4;34;.895;3600000;0
2198;3625;43;0;0;0;0;.00nan;0;0
2198;9238;39;0;0;0;0;.00nan;0;0
2199;5298;55;74;30;2;28;.933;3600000;0
2199;31408;52;45;36;5;31;.861;3600000;0
2199;32146;52;0;0;0;0;.00nan;0;0
2199;32340;55;0;0;0;0;.00nan;0;0
2200;6081;56;91;32;1;31;.969;3600000;0
2200;14061;56;0;0;0;0;.00nan;0;0
2200;31156;53;56;23;3;20;.870;3547000;0
2200;38651;53;0;0;0;0;.00nan;0;0
2201;376;45;55;20;3;17;.850;3600000;0
2201;2198;45;0;0;0;0;.00nan;0;0
2201;4447;54;66;43;5;38;.884;3566000;0
2201;31126;54;0;0;0;0;.00nan;0;0
2202;37;46;79;34;4;30;.882;3600000;0
2202;2553;46;0;0;0;0;.00nan;0;0
2202;25076;42;0;0;0;0;.00nan;0;0
2202;34788;42;79;22;1;21;.955;3600000;0
2203;3;50;73;27;2;25;.926;3600000;0
2203;2296;37;0;0;0;0;.00nan;0;0
2203;5048;50;0;0;0;0;.00nan;0;0
2203;5883;37;67;34;3;31;.912;3549000;0
2204;5137;58;44;15;3;12;.800;3600000;0
2204;15437;58;0;0;0;0;.00nan;0;0
2204;27474;57;89;35;2;33;.943;3600000;0
2204;28772;57;0;0;0;0;.00nan;0;0
2205;4716;4619;34;12;3;9;.750;3560000;0
2205;14351;40;95;47;2;45;.957;3600000;0
2205;23255;4619;0;0;0;0;.00nan;0;0
2205;26840;40;0;0;0;0;.00nan;0;0
2206;2016;61;0;0;0;0;.00nan;0;0
2206;7049;47;61;23;3;20;.870;3542000;0
2206;25787;47;0;0;0;0;.00nan;0;0
2206;30971;61;86;33;2;31;.939;3600000;0
2207;1051;44;79;26;2;24;.923;3600000;0
2207;3281;44;0;0;0;0;.00nan;0;0
2207;20717;60;0;0;0;0;.00nan;0;0
2207;35536;60;55;30;4;26;.867;3582000;0
2208;3626;48;92;51;4;47;.922;3712000;0
2208;6572;62;0;0;0;0;.00nan;0;0
2208;11194;62;69;30;3;27;.900;3712000;0
2208;38547;48;0;0;0;0;.00nan;0;0
2209;3847;38;64;20;1;19;.950;3600000;0
2209;19640;41;0;0;0;0;.00nan;0;0
2209;23075;41;92;44;3;41;.932;3552000;0
2209;31021;38;0;0;0;0;.00nan;0;0
2210;4106;64;94;21;0;21;1.000;3600000;0
2210;5146;64;0;0;0;0;.00nan;0;0
2210;26967;63;47;38;6;32;.842;3600000;0
2210;34814;63;0;0;0;0;.00nan;0;0
2211;4447;54;42;36;6;30;.833;3600000;0
2211;25076;42;67;34;3;31;.912;3600000;0
2211;31126;54;0;0;0;0;.00nan;0;0
2211;34788;42;0;0;0;0;.00nan;0;0
2212;2163;59;0;0;0;0;.00nan;0;0
2212;2796;59;76;28;2;26;.929;3600000;0
2212;27474;57;0;0;0;0;.00nan;0;0
2212;28772;57;63;32;3;29;.906;3541000;0
2213;2016;61;0;0;0;0;.00nan;0;0
2213;2152;49;79;28;1;27;.964;3600000;0
2213;4435;49;0;0;0;0;.00nan;0;0
2213;30971;61;62;37;5;32;.865;3600000;0
2214;1486;43;0;0;0;0;.00nan;0;0
2214;3625;43;99;43;2;41;.953;3600000;0
2214;5298;55;57;35;4;31;.886;3514000;0
2214;32340;55;0;0;0;0;.00nan;0;0
2215;3;50;69;19;1;18;.947;3600000;0
2215;2296;37;0;0;0;0;.00nan;0;0
2215;5048;50;0;0;0;0;.00nan;0;0
2215;5883;37;69;31;3;28;.903;3552000;0
2216;376;45;0;0;0;0;.00nan;0;0
2216;2198;45;75;32;3;29;.906;3567000;0
2216;4106;64;90;36;2;34;.944;3600000;0
2216;5146;64;0;0;0;0;.00nan;0;0
2217;37;46;0;0;0;0;.00nan;0;0
2217;2152;49;81;37;3;34;.919;3600000;0
2217;2553;46;46;27;4;23;.852;3546000;0
2217;4435;49;0;0;0;0;.00nan;0;0
2218;5137;58;0;0;0;0;.00nan;0;0
2218;15437;58;51;31;5;26;.839;3584000;0
2218;31156;53;80;36;3;33;.917;3600000;0
2218;38651;53;0;0;0;0;.00nan;0;0
2219;4338;65;97;34;1;33;.971;3600000;0
2219;4987;65;0;0;0;0;.00nan;0;0
2219;27474;57;75;35;3;32;.914;3557000;0
2219;28772;57;0;0;0;0;.00nan;0;0
2220;1486;43;0;0;0;0;.00nan;0;0
2220;2900;36;0;0;0;0;.00nan;0;0
2220;3625;43;46;29;4;25;.862;3600000;0
2220;14874;36;96;21;0;21;1.000;3600000;0
2221;2163;59;0;0;0;0;.00nan;0;0
2221;2796;59;78;31;2;29;.935;3549000;0
2221;26967;63;0;0;0;0;.00nan;0;0
2221;34814;63;95;42;1;41;.976;3600000;0
2222;5298;55;85;34;3;31;.912;3600000;0
2222;31408;52;0;0;0;0;.00nan;0;0
2222;32146;52;96;23;0;23;1.000;3600000;0
2222;32340;55;0;0;0;0;.00nan;0;0
2223;2296;37;0;0;0;0;.00nan;0;0
2223;5883;37;75;31;2;29;.935;3600000;0
2223;25076;42;79;40;3;37;.925;3558000;0
2223;34788;42;0;0;0;0;.00nan;0;0
2224;4716;4619;0;0;0;0;.00nan;0;0
2224;7049;47;0;0;0;0;.00nan;0;0
2224;23255;4619;61;17;2;15;.882;3600000;0
2224;25787;47;68;19;1;18;.947;3600000;0
2225;1051;44;0;0;0;0;.00nan;0;0
2225;3281;44;53;19;3;16;.842;3738000;0
2225;6572;62;70;40;4;36;.900;3738000;0
2225;11194;62;0;0;0;0;.00nan;0;0
2226;2016;61;0;0;0;0;.00nan;0;0
2226;20717;60;0;0;0;0;.00nan;0;0
2226;30971;61;88;43;3;40;.930;3900000;0
2226;35536;60;81;36;3;33;.917;3867000;0
2227;5137;58;0;0;0;0;.00nan;0;0
2227;15437;58;48;25;4;21;.840;3900000;0
2227;31156;53;0;0;0;0;.00nan;0;0
2227;38651;53;67;30;3;27;.900;3900000;0
2228;1486;43;78;37;2;35;.946;3600000;0
2228;3625;43;0;0;0;0;.00nan;0;0
2228;19640;41;55;27;4;23;.852;3524000;0
2228;23075;41;0;0;0;0;.00nan;0;0
2229;2900;36;0;0;0;0;.00nan;0;0
2229;5298;55;0;0;0;0;.00nan;0;0
2229;14874;36;53;25;3;22;.880;3573000;0
2229;32340;55;94;25;0;25;1.000;3600000;0
2230;2163;59;72;29;2;27;.931;3564000;0
2230;2796;59;0;0;0;0;.00nan;0;0
2230;6081;56;0;0;0;0;.00nan;0;0
2230;14061;56;100;25;0;25;1.000;3600000;0
2231;23493;51;62;22;2;20;.909;3600000;0
2231;27474;57;46;35;6;29;.829;2230000;0
2231;28772;57;59;18;2;16;.889;1370000;0
2231;31822;51;0;0;0;0;.00nan;0;0
2232;3847;38;0;0;0;0;.00nan;0;0
2232;4338;65;0;0;0;0;.00nan;0;0
2232;4987;65;74;30;2;28;.933;3735000;0
2232;31021;38;70;31;3;28;.903;3735000;0
2233;907;39;0;0;0;0;.00nan;0;0
2233;9238;39;44;20;3;17;.850;3600000;0
2233;26967;63;0;0;0;0;.00nan;0;0
2233;34814;63;55;42;5;37;.881;3570000;0
2234;2296;37;0;0;0;0;.00nan;0;0
2234;4106;64;93;55;5;50;.909;3600000;0
2234;5146;64;0;0;0;0;.00nan;0;0
2234;5883;37;68;23;2;21;.913;3600000;0
2235;376;45;0;0;0;0;.00nan;0;0
2235;2198;45;45;18;3;15;.833;3600000;0
2235;4447;54;49;36;5;31;.861;3514000;0
2235;31126;54;0;0;0;0;.00nan;0;0
2236;3;50;14;20;6;14;.700;2752000;0
2236;5048;50;70;13;0;13;1.000;848000;0
2236;25076;42;66;26;3;23;.885;3600000;0
2236;34788;42;0;0;0;0;.00nan;0;0
2237;37;46;0;0;0;0;.00nan;0;0
2237;2553;46;83;38;3;35;.921;3566000;0
2237;7049;47;0;0;0;0;.00nan;0;0
2237;33654;47;60;23;2;21;.913;3600000;0
2238;2016;61;0;0;0;0;.00nan;0;0
2238;14351;40;89;45;3;42;.933;3568000;0
2238;26840;40;0;0;0;0;.00nan;0;0
2238;30971;61;91;35;2;33;.943;3600000;0
2239;1051;44;0;0;0;0;.00nan;0;0
2239;3281;44;95;49;3;46;.939;3600000;0
2239;3626;48;0;0;0;0;.00nan;0;0
2239;38547;48;32;31;6;25;.806;3600000;0
2240;2163;59;0;0;0;0;.00nan;0;0
2240;2796;59;59;26;3;23;.885;3600000;0
2240;23493;51;0;0;0;0;.00nan;0;0
2240;31822;51;40;22;5;17;.773;3600000;0
2241;26967;63;98;44;1;43;.977;3543000;0
2241;31408;52;0;0;0;0;.00nan;0;0
2241;32146;52;91;20;0;20;1.000;3600000;0
2241;34814;63;0;0;0;0;.00nan;0;0
2242;4716;4619;55;11;1;10;.909;1536000;0
2242;20717;60;0;0;0;0;.00nan;0;0
2242;23255;4619;47;28;5;23;.821;2064000;0
2242;35536;60;70;24;2;22;.917;3600000;0
2243;1051;44;67;44;5;39;.886;3600000;0
2243;3281;44;0;0;0;0;.00nan;0;0
2243;3626;48;64;24;2;22;.917;3600000;0
2243;38547;48;0;0;0;0;.00nan;0;0
2244;4338;65;42;22;4;18;.818;3573000;0
2244;4987;65;0;0;0;0;.00nan;0;0
2244;31156;53;92;44;2;42;.955;3600000;0
2244;38651;53;0;0;0;0;.00nan;0;0
2245;907;39;27;31;6;25;.806;2933000;0
2245;2900;36;88;35;1;34;.971;3600000;0
2245;9238;39;50;3;0;3;1.000;667000;0
2245;14874;36;0;0;0;0;.00nan;0;0
2246;6081;56;0;0;0;0;.00nan;0;0
2246;14061;56;94;32;2;30;.938;3900000;0
2246;27474;57;85;31;2;29;.935;3900000;0
2246;28772;57;0;0;0;0;.00nan;0;0
2247;2296;37;0;0;0;0;.00nan;0;0
2247;5883;37;65;35;4;31;.886;3600000;0
2247;25076;42;0;0;0;0;.00nan;0;0
2247;34788;42;89;46;3;43;.935;3600000;0
2248;3847;38;66;35;3;32;.914;3600000;0
2248;5137;58;40;27;5;22;.815;3580000;0
2248;15437;58;0;0;0;0;.00nan;0;0
2248;31021;38;0;0;0;0;.00nan;0;0
2249;376;45;87;28;0;28;1.000;3900000;0
2249;2198;45;0;0;0;0;.00nan;0;0
2249;4447;54;98;21;0;21;1.000;3900000;0
2249;31126;54;0;0;0;0;.00nan;0;0
2250;37;46;77;47;5;42;.894;3600000;0
2250;7049;47;77;26;1;25;.962;3600000;0
2250;33654;47;0;0;0;0;.00nan;0;0
2250;35622;46;0;0;0;0;.00nan;0;0
2251;2152;49;84;25;1;24;.960;3600000;0
2251;4435;49;0;0;0;0;.00nan;0;0
2251;6572;62;76;26;2;24;.923;3542000;0
2251;11194;62;0;0;0;0;.00nan;0;0
2252;1486;43;0;0;0;0;.00nan;0;0
2252;3625;43;92;41;3;38;.927;3579000;0
2252;19640;41;74;26;2;24;.923;3600000;0
2252;23075;41;0;0;0;0;.00nan;0;0
2253;3847;38;0;0;0;0;.00nan;0;0
2253;5298;55;0;0;0;0;.00nan;0;0
2253;31021;38;35;21;4;17;.810;3550000;0
2253;32340;55;50;28;3;25;.893;3600000;0
2254;907;39;0;0;0;0;.00nan;0;0
2254;9238;39;98;41;1;40;.976;3594000;0
2254;31408;52;0;0;0;0;.00nan;0;0
2254;32146;52;100;19;0;19;1.000;3600000;0
2255;3;50;100;23;0;23;1.000;3600000;0
2255;4106;64;0;0;0;0;.00nan;0;0
2255;5048;50;0;0;0;0;.00nan;0;0
2255;5146;64;70;37;3;34;.919;3600000;0
2256;37;46;45;33;6;27;.818;3309000;0
2256;2152;49;0;0;0;0;.00nan;0;0
2256;4435;49;83;28;1;27;.964;3600000;0
2256;35622;46;49;2;0;2;1.000;291000;0
2257;4716;4619;0;0;0;0;.00nan;0;0
2257;20717;60;39;25;5;20;.800;3900000;0
2257;23255;4619;72;43;5;38;.884;3900000;0
2257;35536;60;0;0;0;0;.00nan;0;0
2258;6572;62;0;0;0;0;.00nan;0;0
2258;11194;62;60;26;3;23;.885;3900000;0
2258;14351;40;58;20;3;17;.850;3900000;0
2258;26840;40;0;0;0;0;.00nan;0;0
2259;2296;37;0;0;0;0;.00nan;0;0
2259;5883;37;80;25;1;24;.960;3600000;0
2259;23493;51;86;40;3;37;.925;3555000;0
2259;31822;51;0;0;0;0;.00nan;0;0
2260;4447;54;50;13;2;11;.846;3600000;0
2260;25076;42;26;31;7;24;.774;3220000;0
2260;31126;54;0;0;0;0;.00nan;0;0
2260;34788;42;46;4;1;3;.750;380000;0
2261;2016;61;62;20;2;18;.900;3600000;0
2261;26967;63;0;0;0;0;.00nan;0;0
2261;30971;61;0;0;0;0;.00nan;0;0
2261;34814;63;53;41;6;35;.854;3600000;0
2262;2152;49;71;33;2;31;.939;3579000;0
2262;4435;49;0;0;0;0;.00nan;0;0
2262;20717;60;0;0;0;0;.00nan;0;0
2262;35536;60;76;16;1;15;.938;3600000;0
2263;2163;59;0;0;0;0;.00nan;0;0
2263;2796;59;93;21;0;21;1.000;3600000;0
2263;31156;53;60;40;4;36;.900;3600000;0
2263;38651;53;0;0;0;0;.00nan;0;0
2264;907;39;0;0;0;0;.00nan;0;0
2264;5298;55;0;0;0;0;.00nan;0;0
2264;9238;39;99;25;0;25;1.000;3600000;0
2264;32340;55;54;23;3;20;.870;3600000;0
2265;2296;37;75;32;3;29;.906;3600000;0
2265;5883;37;0;0;0;0;.00nan;0;0
2265;23493;51;32;31;5;26;.839;3557000;0
2265;31822;51;0;0;0;0;.00nan;0;0
2266;4716;4619;74;34;2;32;.941;3781000;0
2266;14351;40;59;28;3;25;.893;3781000;0
2266;23255;4619;0;0;0;0;.00nan;0;0
2266;26840;40;0;0;0;0;.00nan;0;0
2267;2016;61;0;0;0;0;.00nan;0;0
2267;26967;63;68;35;4;31;.886;3560000;0
2267;30971;61;59;21;2;19;.905;3600000;0
2267;34814;63;0;0;0;0;.00nan;0;0
2268;6081;56;0;0;0;0;.00nan;0;0
2268;14061;56;61;32;3;29;.906;3900000;0
2268;31156;53;0;0;0;0;.00nan;0;0
2268;38651;53;85;44;3;41;.932;3900000;0
2269;4338;65;0;0;0;0;.00nan;0;0
2269;4987;65;71;43;5;38;.884;3569000;0
2269;19640;41;54;20;3;17;.850;3600000;0
2269;23075;41;0;0;0;0;.00nan;0;0
2270;907;39;0;0;0;0;.00nan;0;0
2270;1486;43;0;0;0;0;.00nan;0;0
2270;3625;43;56;31;4;27;.871;3600000;0
2270;9238;39;51;19;3;16;.842;3600000;0
2271;2900;36;0;0;0;0;.00nan;0;0
2271;5298;55;86;41;3;38;.927;3579000;0
2271;14874;36;100;35;1;34;.971;3600000;0
2271;32340;55;0;0;0;0;.00nan;0;0
2272;37;46;72;31;2;29;.935;3600000;0
2272;376;45;58;24;3;21;.875;3578000;0
2272;2198;45;0;0;0;0;.00nan;0;0
2272;35622;46;0;0;0;0;.00nan;0;0
2273;3847;38;0;0;0;0;.00nan;0;0
2273;5137;58;0;0;0;0;.00nan;0;0
2273;15437;58;69;36;3;33;.917;3543000;0
2273;31021;38;92;30;1;29;.967;3600000;0
2274;2163;59;0;0;0;0;.00nan;0;0
2274;2796;59;91;58;5;53;.914;3600000;0
2274;26919;57;0;0;0;0;.00nan;0;0
2274;27474;57;85;30;1;29;.967;3600000;0
2275;2296;37;0;0;0;0;.00nan;0;0
2275;5883;37;68;24;2;22;.917;3805000;0
2275;26967;63;0;0;0;0;.00nan;0;0
2275;34814;63;78;38;3;35;.921;3805000;0
2276;4106;64;0;0;0;0;.00nan;0;0
2276;4447;54;80;23;2;21;.913;3900000;0
2276;5146;64;73;27;2;25;.926;3900000;0
2276;31126;54;0;0;0;0;.00nan;0;0
2277;3626;48;83;28;1;27;.964;3600000;0
2277;7049;47;60;28;3;25;.893;3542000;0
2277;33654;47;0;0;0;0;.00nan;0;0
2277;38547;48;0;0;0;0;.00nan;0;0
2278;2152;49;99;35;1;34;.971;3600000;0
2278;4435;49;0;0;0;0;.00nan;0;0
2278;4716;4619;0;0;0;0;.00nan;0;0
2278;23255;4619;49;43;6;37;.860;3600000;0
2279;3;50;70;27;2;25;.926;3900000;0
2279;5048;50;0;0;0;0;.00nan;0;0
2279;6572;62;97;35;2;33;.943;3900000;0
2279;11194;62;0;0;0;0;.00nan;0;0
2280;1051;44;0;0;0;0;.00nan;0;0
2280;3281;44;81;23;1;22;.957;3600000;0
2280;25076;42;0;0;0;0;.00nan;0;0
2280;34788;42;62;22;2;20;.909;3600000;0
2281;4338;65;77;39;4;35;.897;3600000;0
2281;4987;65;0;0;0;0;.00nan;0;0
2281;19640;41;0;0;0;0;.00nan;0;0
2281;23075;41;82;23;1;22;.957;3600000;0
2282;2163;59;86;28;2;26;.929;3900000;0
2282;2796;59;0;0;0;0;.00nan;0;0
2282;31408;52;0;0;0;0;.00nan;0;0
2282;32146;52;64;22;2;20;.909;3900000;0
2283;5137;58;63;22;2;20;.909;3600000;0
2283;6081;56;79;45;4;41;.911;3583000;0
2283;14061;56;0;0;0;0;.00nan;0;0
2283;15437;58;0;0;0;0;.00nan;0;0
2284;6062;36;0;0;0;0;.00nan;0;0
2284;14874;36;94;23;0;23;1.000;3600000;0
2284;31156;53;89;35;2;33;.943;3578000;0
2284;38651;53;0;0;0;0;.00nan;0;0
2285;907;39;65;34;3;31;.912;3600000;0
2285;1486;43;18;23;6;17;.739;3564000;0
2285;3625;43;0;0;0;0;.00nan;0;0
2285;9238;39;0;0;0;0;.00nan;0;0
2286;37;46;0;0;0;0;.00nan;0;0
2286;376;45;0;0;0;0;.00nan;0;0
2286;2198;45;66;35;4;31;.886;3599000;0
2286;2553;46;78;24;2;22;.917;3600000;0
2287;5298;55;0;0;0;0;.00nan;0;0
2287;26919;57;100;36;1;35;.972;3600000;0
2287;27474;57;0;0;0;0;.00nan;0;0
2287;32340;55;73;37;4;33;.892;3600000;0
2288;4106;64;76;44;4;40;.909;3600000;0
2288;4447;54;0;0;0;0;.00nan;0;0
2288;5146;64;0;0;0;0;.00nan;0;0
2288;31126;54;91;20;0;20;1.000;3600000;0
2289;2152;49;0;0;0;0;.00nan;0;0
2289;4435;49;52;29;4;25;.862;3573000;0
2289;4716;4619;88;35;2;33;.943;3600000;0
2289;23255;4619;0;0;0;0;.00nan;0;0
2290;14351;40;73;34;3;31;.912;3576000;0
2290;20717;60;0;0;0;0;.00nan;0;0
2290;26840;40;0;0;0;0;.00nan;0;0
2290;35536;60;81;26;1;25;.962;3600000;0
2291;3;50;0;0;0;0;.00nan;0;0
2291;5048;50;71;27;2;25;.926;3600000;0
2291;6572;62;87;39;3;36;.923;3542000;0
2291;11194;62;0;0;0;0;.00nan;0;0
2292;1051;44;87;31;1;30;.968;3600000;0
2292;3281;44;0;0;0;0;.00nan;0;0
2292;25076;42;66;29;3;26;.897;3600000;0
2292;34788;42;0;0;0;0;.00nan;0;0
2293;3626;48;0;0;0;0;.00nan;0;0
2293;7049;47;0;0;0;0;.00nan;0;0
2293;33654;47;59;32;4;28;.875;3900000;0
2293;38547;48;42;28;4;24;.857;3895000;0
2294;2016;61;0;0;0;0;.00nan;0;0
2294;23493;51;95;35;1;34;.971;3542000;0
2294;30971;61;89;20;0;20;1.000;3600000;0
2294;31822;51;0;0;0;0;.00nan;0;0
2295;5137;58;0;0;0;0;.00nan;0;0
2295;6081;56;59;5;0;5;1.000;322000;0
2295;14061;56;31;31;6;25;.806;3278000;0
2295;15437;58;98;25;0;25;1.000;3600000;0
2296;26919;57;0;0;0;0;.00nan;0;0
2296;27474;57;85;39;2;37;.949;3900000;0
2296;31408;52;78;24;2;22;.917;3900000;0
2296;32146;52;0;0;0;0;.00nan;0;0
2297;2296;37;0;0;0;0;.00nan;0;0
2297;5883;37;44;32;6;26;.813;3557000;0
2297;26967;63;0;0;0;0;.00nan;0;0
2297;34814;63;70;45;4;41;.911;3600000;0
2298;376;45;93;32;2;30;.938;3600000;0
2298;2198;45;0;0;0;0;.00nan;0;0
2298;4106;64;54;3;0;3;1.000;373000;0
2298;5146;64;39;39;6;33;.846;3227000;0
2299;3847;38;0;0;0;0;.00nan;0;0
2299;6062;36;92;28;1;27;.964;3600000;0
2299;14874;36;0;0;0;0;.00nan;0;0
2299;31021;38;64;26;2;24;.923;3543000;0
2300;37;46;80;22;1;21;.955;3639000;0
2300;2553;46;0;0;0;0;.00nan;0;0
2300;4447;54;0;0;0;0;.00nan;0;0
2300;31126;54;74;28;2;26;.929;3639000;0
2301;14351;40;0;0;0;0;.00nan;0;0
2301;20717;60;61;38;5;33;.868;3600000;0
2301;26840;40;44;37;6;31;.838;3600000;0
2301;35536;60;0;0;0;0;.00nan;0;0
2302;2016;61;0;0;0;0;.00nan;0;0
2302;23493;51;0;0;0;0;.00nan;0;0
2302;30971;61;50;25;4;21;.840;3554000;0
2302;31822;51;92;39;3;36;.923;3600000;0
2303;3626;48;78;32;2;30;.938;3600000;0
2303;25076;42;0;0;0;0;.00nan;0;0
2303;34788;42;40;19;4;15;.789;3550000;0
2303;38547;48;0;0;0;0;.00nan;0;0
2304;4338;65;87;33;1;32;.970;3900000;0
2304;4987;65;0;0;0;0;.00nan;0;0
2304;31408;52;0;0;0;0;.00nan;0;0
2304;32146;52;100;37;1;36;.973;3900000;0
2305;3;50;73;29;2;27;.931;3600000;0
2305;1051;44;73;37;3;34;.919;3554000;0
2305;5048;50;0;0;0;0;.00nan;0;0
2305;22601;44;0;0;0;0;.00nan;0;0
2306;3626;48;0;0;0;0;.00nan;0;0
2306;25076;42;21;28;7;21;.750;3162000;0
2306;34788;42;54;4;0;4;1.000;438000;0
2306;38547;48;70;34;3;31;.912;3600000;0
2307;6062;36;0;0;0;0;.00nan;0;0
2307;14874;36;46;20;4;16;.800;3513000;0
2307;26967;63;0;0;0;0;.00nan;0;0
2307;34814;63;92;47;2;45;.957;3600000;0
2308;2296;37;0;0;0;0;.00nan;0;0
2308;4447;54;65;39;4;35;.897;3585000;0
2308;5883;37;69;23;2;21;.913;3600000;0
2308;31126;54;0;0;0;0;.00nan;0;0
2309;2198;45;72;29;3;26;.897;3555000;0
2309;4106;64;0;0;0;0;.00nan;0;0
2309;5146;64;92;29;1;28;.966;3600000;0
2309;34815;45;0;0;0;0;.00nan;0;0
2310;5298;55;57;33;4;29;.879;3571000;0
2310;6081;56;0;0;0;0;.00nan;0;0
2310;14061;56;70;28;3;25;.893;3600000;0
2310;32340;55;0;0;0;0;.00nan;0;0
2311;37;46;0;0;0;0;.00nan;0;0
2311;1486;43;0;0;0;0;.00nan;0;0
2311;2553;46;59;34;5;29;.853;3600000;0
2311;3625;43;81;30;2;28;.933;3600000;0
2312;2163;59;0;0;0;0;.00nan;0;0
2312;2796;59;91;30;1;29;.967;3600000;0
2312;26919;57;0;0;0;0;.00nan;0;0
2312;27474;57;57;27;3;24;.889;3576000;0
2313;907;39;0;0;0;0;.00nan;0;0
2313;9238;39;60;41;5;36;.878;3600000;0
2313;23493;51;58;32;4;28;.875;3600000;0
2313;31822;51;0;0;0;0;.00nan;0;0
2314;7049;47;0;0;0;0;.00nan;0;0
2314;20717;60;0;0;0;0;.00nan;0;0
2314;33654;47;90;38;3;35;.921;3900000;0
2314;35536;60;67;29;3;26;.897;3900000;0
2315;3;50;0;0;0;0;.00nan;0;0
2315;1051;44;0;0;0;0;.00nan;0;0
2315;5048;50;35;20;4;16;.800;3600000;0
2315;22601;44;86;30;1;29;.967;3600000;0
2316;19640;41;0;0;0;0;.00nan;0;0
2316;23075;41;88;31;1;30;.968;3600000;0
2316;31156;53;74;26;2;24;.923;3570000;0
2316;38651;53;0;0;0;0;.00nan;0;0
2317;3847;38;0;0;0;0;.00nan;0;0
2317;31021;38;56;22;3;19;.864;3512000;0
2317;31408;52;0;0;0;0;.00nan;0;0
2317;32146;52;100;40;1;39;.975;3600000;0
2318;19640;41;37;24;5;19;.792;3565000;0
2318;23075;41;0;0;0;0;.00nan;0;0
2318;31156;53;0;0;0;0;.00nan;0;0
2318;38651;53;57;24;3;21;.875;3600000;0
2319;5137;58;0;0;0;0;.00nan;0;0
2319;6062;36;0;0;0;0;.00nan;0;0
2319;14874;36;98;38;2;36;.947;3900000;0
2319;15437;58;63;20;2;18;.900;3900000;0
2320;5298;55;81;24;1;23;.958;3600000;0
2320;6081;56;0;0;0;0;.00nan;0;0
2320;14061;56;92;46;2;44;.957;3600000;0
2320;32340;55;0;0;0;0;.00nan;0;0
2321;907;39;0;0;0;0;.00nan;0;0
2321;9238;39;71;27;2;25;.926;3900000;0
2321;23493;51;0;0;0;0;.00nan;0;0
2321;31035;51;95;38;2;36;.947;3900000;0
2322;4338;65;28;9;3;6;.667;416000;0
2322;4987;65;72;29;3;26;.897;3184000;0
2322;27474;57;0;0;0;0;.00nan;0;0
2322;28772;57;98;30;1;29;.967;3600000;0
2323;2296;37;0;0;0;0;.00nan;0;0
2323;4447;54;82;28;1;27;.964;3600000;0
2323;5883;37;74;37;4;33;.892;3600000;0
2323;31126;54;0;0;0;0;.00nan;0;0
2324;4716;4619;100;27;0;27;1.000;3600000;0
2324;7049;47;85;31;2;29;.935;3582000;0
2324;23255;4619;0;0;0;0;.00nan;0;0
2324;33654;47;0;0;0;0;.00nan;0;0
2325;2152;49;71;24;2;22;.917;3600000;0
2325;4435;49;0;0;0;0;.00nan;0;0
2325;14351;40;51;27;4;23;.852;3565000;0
2325;26840;40;0;0;0;0;.00nan;0;0
2326;2016;61;0;0;0;0;.00nan;0;0
2326;6572;62;80;34;2;32;.941;3600000;0
2326;11194;62;0;0;0;0;.00nan;0;0
2326;30971;61;62;34;4;30;.882;3600000;0
2327;37;46;97;20;0;20;1.000;3600000;0
2327;2553;46;0;0;0;0;.00nan;0;0
2327;26967;63;0;0;0;0;.00nan;0;0
2327;34814;63;97;49;3;46;.939;3600000;0
2328;5298;55;0;0;0;0;.00nan;0;0
2328;23493;51;33;32;6;26;.813;3600000;0
2328;31035;51;0;0;0;0;.00nan;0;0
2328;32340;55;94;41;1;40;.976;3600000;0
2329;4338;65;78;33;3;30;.909;3692000;0
2329;4987;65;0;0;0;0;.00nan;0;0
2329;5137;58;0;0;0;0;.00nan;0;0
2329;15437;58;70;20;2;18;.900;3692000;0
2330;2163;59;0;0;0;0;.00nan;0;0
2330;2796;59;63;29;3;26;.897;3600000;0
2330;6062;36;100;25;0;25;1.000;3600000;0
2330;14874;36;0;0;0;0;.00nan;0;0
2331;907;39;62;29;4;25;.862;3727000;0
2331;6081;56;65;24;3;21;.875;3727000;0
2331;9238;39;0;0;0;0;.00nan;0;0
2331;14061;56;0;0;0;0;.00nan;0;0
2332;1486;43;0;0;0;0;.00nan;0;0
2332;3625;43;82;24;1;23;.958;3600000;0
2332;4447;54;0;0;0;0;.00nan;0;0
2332;31126;54;62;35;3;32;.914;3562000;0
2333;1051;44;92;37;2;35;.946;3900000;0
2333;22601;44;0;0;0;0;.00nan;0;0
2333;25076;42;0;0;0;0;.00nan;0;0
2333;34788;42;82;30;2;28;.933;3900000;0
2334;3847;38;33;32;6;26;.813;3600000;0
2334;31021;38;0;0;0;0;.00nan;0;0
2334;31408;52;91;30;1;29;.967;3600000;0
2334;32146;52;0;0;0;0;.00nan;0;0
2335;2296;37;0;0;0;0;.00nan;0;0
2335;4106;64;70;42;5;37;.881;3584000;0
2335;5146;64;0;0;0;0;.00nan;0;0
2335;5883;37;61;31;4;27;.871;3600000;0
2336;3;50;75;32;2;30;.938;3547000;0
2336;2198;45;0;0;0;0;.00nan;0;0
2336;5048;50;0;0;0;0;.00nan;0;0
2336;34815;45;100;35;0;35;1.000;3600000;0
2337;4716;4619;75;25;1;24;.960;3600000;0
2337;7049;47;0;0;0;0;.00nan;0;0
2337;23255;4619;0;0;0;0;.00nan;0;0
2337;33654;47;65;41;4;37;.902;3600000;0
2338;3626;48;78;42;3;39;.929;3586000;0
2338;20717;60;0;0;0;0;.00nan;0;0
2338;35536;60;65;25;2;23;.920;3600000;0
2338;38547;48;0;0;0;0;.00nan;0;0
2339;2016;61;65;23;2;21;.913;3600000;0
2339;6572;62;91;47;3;44;.936;3557000;0
2339;11194;62;0;0;0;0;.00nan;0;0
2339;30971;61;0;0;0;0;.00nan;0;0
2340;19640;41;38;30;5;25;.833;3600000;0
2340;23075;41;0;0;0;0;.00nan;0;0
2340;31156;53;91;39;2;37;.949;3600000;0
2340;38651;53;0;0;0;0;.00nan;0;0
2341;27474;57;93;33;1;32;.970;3600000;0
2341;28772;57;0;0;0;0;.00nan;0;0
2341;31408;52;0;0;0;0;.00nan;0;0
2341;32146;52;59;24;3;21;.875;3566000;0
2342;37;46;0;0;0;0;.00nan;0;0
2342;2553;46;79;25;1;24;.960;3600000;0
2342;26967;63;63;38;4;34;.895;3600000;0
2342;34814;63;0;0;0;0;.00nan;0;0
2343;1486;43;0;0;0;0;.00nan;0;0
2343;3625;43;49;35;5;30;.857;3600000;0
2343;4106;64;0;0;0;0;.00nan;0;0
2343;5146;64;85;34;2;32;.941;3600000;0
2344;4338;65;0;0;0;0;.00nan;0;0
2344;4987;65;59;20;2;18;.900;3600000;0
2344;5137;58;0;0;0;0;.00nan;0;0
2344;15437;58;89;43;3;40;.930;3600000;0
2345;1051;44;0;0;0;0;.00nan;0;0
2345;22601;44;41;21;4;17;.810;3600000;0
2345;25076;42;75;20;1;19;.950;3600000;0
2345;34788;42;0;0;0;0;.00nan;0;0
2346;3;50;0;0;0;0;.00nan;0;0
2346;2198;45;89;36;3;33;.917;3900000;0
2346;5048;50;59;29;3;26;.897;3900000;0
2346;34815;45;0;0;0;0;.00nan;0;0
2347;2152;49;35;14;3;11;.786;3600000;0
2347;4435;49;0;0;0;0;.00nan;0;0
2347;14351;40;0;0;0;0;.00nan;0;0
2347;26840;40;47;38;6;32;.842;3600000;0
2348;3626;48;0;0;0;0;.00nan;0;0
2348;20717;60;73;17;1;16;.941;3900000;0
2348;35536;60;0;0;0;0;.00nan;0;0
2348;38547;48;100;40;1;39;.975;3900000;0
2349;6081;56;0;0;0;0;.00nan;0;0
2349;14061;56;87;34;2;32;.941;3600000;0
2349;31156;53;0;0;0;0;.00nan;0;0
2349;38651;53;70;35;4;31;.886;3560000;0
2350;37;46;89;33;2;31;.939;3511000;0
2350;1486;43;0;0;0;0;.00nan;0;0
2350;2553;46;0;0;0;0;.00nan;0;0
2350;3625;43;100;24;0;24;1.000;3600000;0
2351;4338;65;89;43;3;40;.930;3900000;0
2351;4987;65;0;0;0;0;.00nan;0;0
2351;27474;57;0;0;0;0;.00nan;0;0
2351;28772;57;72;32;3;29;.906;3900000;0
2352;5137;58;0;0;0;0;.00nan;0;0
2352;6062;36;0;0;0;0;.00nan;0;0
2352;14874;36;50;23;3;20;.870;3599000;0
2352;15437;58;92;32;1;31;.969;3600000;0
2353;907;39;62;34;4;30;.882;3208000;0
2353;9238;39;29;8;3;5;.625;367000;0
2353;23493;51;44;40;6;34;.850;2759000;0
2353;31035;51;55;4;0;4;1.000;841000;0
2354;376;45;100;37;1;36;.973;3600000;0
2354;2198;45;0;0;0;0;.00nan;0;0
2354;4106;64;0;0;0;0;.00nan;0;0
2354;5146;64;55;17;2;15;.882;3545000;0
2355;3;50;55;21;3;18;.857;3551000;0
2355;4447;54;83;36;2;34;.944;3600000;0
2355;5048;50;0;0;0;0;.00nan;0;0
2355;31126;54;0;0;0;0;.00nan;0;0
2356;7049;47;83;32;2;30;.938;3600000;0
2356;20717;60;0;0;0;0;.00nan;0;0
2356;33654;47;0;0;0;0;.00nan;0;0
2356;35536;60;74;37;3;34;.919;3566000;0
2357;3626;48;87;28;1;27;.964;3600000;0
2357;14351;40;0;0;0;0;.00nan;0;0
2357;26840;40;54;25;3;22;.880;3590000;0
2357;38547;48;0;0;0;0;.00nan;0;0
2358;2296;37;0;0;0;0;.00nan;0;0
2358;5883;37;58;32;4;28;.875;3550000;0
2358;25076;42;0;0;0;0;.00nan;0;0
2358;34788;42;84;39;3;36;.923;3600000;0
2359;26967;63;91;24;0;24;1.000;3009000;0
2359;31156;53;84;28;2;26;.929;3600000;0
2359;34814;63;32;11;3;8;.727;537000;0
2359;38651;53;0;0;0;0;.00nan;0;0
2360;1486;43;0;0;0;0;.00nan;0;0
2360;3625;43;87;25;1;24;.960;3600000;0
2360;23493;51;0;0;0;0;.00nan;0;0
2360;31035;51;59;30;4;26;.867;3600000;0
2361;5298;55;0;0;0;0;.00nan;0;0
2361;6062;36;0;0;0;0;.00nan;0;0
2361;14874;36;52;14;2;12;.857;3600000;0
2361;32340;55;91;48;3;45;.938;3600000;0
2362;3;50;0;0;0;0;.00nan;0;0
2362;37;46;63;42;4;38;.905;3817000;0
2362;2553;46;0;0;0;0;.00nan;0;0
2362;5048;50;62;35;5;30;.857;3817000;0
2363;27474;57;50;31;4;27;.871;3600000;0
2363;28772;57;0;0;0;0;.00nan;0;0
2363;31408;52;0;0;0;0;.00nan;0;0
2363;32146;52;39;30;5;25;.833;3564000;0
2364;2163;59;0;0;0;0;.00nan;0;0
2364;2796;59;100;21;0;21;1.000;3624000;0
2364;4338;65;93;43;1;42;.977;3624000;0
2364;4987;65;0;0;0;0;.00nan;0;0
2365;5137;58;0;0;0;0;.00nan;0;0
2365;15437;58;78;40;4;36;.900;3557000;0
2365;19640;41;66;24;2;22;.917;3600000;0
2365;23075;41;0;0;0;0;.00nan;0;0
2366;376;45;35;20;4;16;.800;3533000;0
2366;2198;45;0;0;0;0;.00nan;0;0
2366;4106;64;70;26;2;24;.923;3600000;0
2366;5146;64;0;0;0;0;.00nan;0;0
2367;2152;49;56;24;3;21;.875;3600000;0
2367;4435;49;0;0;0;0;.00nan;0;0
2367;6572;62;75;36;4;32;.889;3568000;0
2367;11194;62;0;0;0;0;.00nan;0;0
2368;2016;61;60;9;0;9;1.000;457000;0
2368;20717;60;0;0;0;0;.00nan;0;0
2368;30971;61;29;26;6;20;.769;3143000;0
2368;35536;60;50;21;3;18;.857;3600000;0
2369;1051;44;83;40;3;37;.925;3540000;0
2369;4716;4619;0;0;0;0;.00nan;0;0
2369;22601;44;0;0;0;0;.00nan;0;0
2369;23255;4619;85;29;1;28;.966;3600000;0
2370;3626;48;89;42;3;39;.929;3600000;0
2370;14351;40;0;0;0;0;.00nan;0;0
2370;26840;40;60;37;4;33;.892;3600000;0
2370;38547;48;0;0;0;0;.00nan;0;0
2371;2296;37;55;17;3;14;.824;3900000;0
2371;5883;37;0;0;0;0;.00nan;0;0
2371;25076;42;57;26;3;23;.885;3900000;0
2371;34788;42;0;0;0;0;.00nan;0;0
2372;2163;59;0;0;0;0;.00nan;0;0
2372;2796;59;90;33;2;31;.939;3600000;0
2372;31408;52;73;34;3;31;.912;3547000;0
2372;32146;52;0;0;0;0;.00nan;0;0
2373;5137;58;66;39;4;35;.897;3595000;0
2373;15437;58;0;0;0;0;.00nan;0;0
2373;19640;41;0;0;0;0;.00nan;0;0
2373;23075;41;66;22;3;19;.864;3600000;0
2374;6062;36;60;15;1;14;.933;3600000;0
2374;14874;36;0;0;0;0;.00nan;0;0
2374;26967;63;0;0;0;0;.00nan;0;0
2374;34814;63;76;40;4;36;.900;3600000;0
2375;1486;43;0;0;0;0;.00nan;0;0
2375;3625;43;74;27;2;25;.926;3600000;0
2375;23493;51;47;26;4;22;.846;3554000;0
2375;31035;51;0;0;0;0;.00nan;0;0
2376;5298;55;86;44;3;41;.932;3600000;0
2376;6081;56;0;0;0;0;.00nan;0;0
2376;14061;56;58;34;5;29;.853;3561000;0
2376;32340;55;0;0;0;0;.00nan;0;0
2377;3;50;92;43;3;40;.930;3786000;0
2377;4447;54;66;29;4;25;.862;3786000;0
2377;5048;50;0;0;0;0;.00nan;0;0
2377;31126;54;0;0;0;0;.00nan;0;0
2378;3847;38;42;25;4;21;.840;3569000;0
2378;27474;57;0;0;0;0;.00nan;0;0
2378;28772;57;60;27;3;24;.889;3600000;0
2378;31021;38;0;0;0;0;.00nan;0;0
2379;907;39;0;0;0;0;.00nan;0;0
2379;9238;39;83;35;3;32;.914;3600000;0
2379;31156;53;0;0;0;0;.00nan;0;0
2379;38651;53;60;45;6;39;.867;3600000;0
2380;376;45;0;0;0;0;.00nan;0;0
2380;2198;45;85;32;3;29;.906;3600000;0
2380;4106;64;0;0;0;0;.00nan;0;0
2380;5146;64;99;21;0;21;1.000;3600000;0
2381;2016;61;62;32;4;28;.875;3600000;0
2381;7049;47;72;21;1;20;.952;3600000;0
2381;30971;61;0;0;0;0;.00nan;0;0
2381;33654;47;0;0;0;0;.00nan;0;0
2382;2152;49;23;23;6;17;.739;3208000;0
2382;4435;49;50;1;0;1;1.000;392000;0
2382;6572;62;99;38;2;36;.947;3600000;0
2382;11194;62;0;0;0;0;.00nan;0;0
2383;1051;44;0;0;0;0;.00nan;0;0
2383;4716;4619;71;19;2;17;.895;3600000;0
2383;22601;44;56;33;5;28;.848;3600000;0
2383;23255;4619;0;0;0;0;.00nan;0;0
2384;3626;48;0;0;0;0;.00nan;0;0
2384;14351;40;33;32;6;26;.813;2887000;0
2384;26840;40;57;6;0;6;1.000;713000;0
2384;38547;48;63;27;3;24;.889;3600000;0
2385;3847;38;0;0;0;0;.00nan;0;0
2385;4338;65;100;45;1;44;.978;3600000;0
2385;4987;65;0;0;0;0;.00nan;0;0
2385;31021;38;64;31;3;28;.903;3518000;0
2386;1486;43;0;0;0;0;.00nan;0;0
2386;3625;43;77;25;2;23;.920;3600000;0
2386;5298;55;73;46;5;41;.891;3600000;0
2386;32340;55;0;0;0;0;.00nan;0;0
2387;3;50;0;0;0;0;.00nan;0;0
2387;37;46;70;15;1;14;.933;3600000;0
2387;2553;46;0;0;0;0;.00nan;0;0
2387;5048;50;74;41;3;38;.927;3522000;0
2388;1486;43;0;0;0;0;.00nan;0;0
2388;3625;43;76;28;2;26;.929;3600000;0
2388;5298;55;0;0;0;0;.00nan;0;0
2388;32340;55;31;24;5;19;.792;3600000;0
2389;6081;56;48;0;0;0;.00nan;368000;0
2389;14061;56;40;28;5;23;.821;3232000;0
2389;26967;63;0;0;0;0;.00nan;0;0
2389;34814;63;100;38;2;36;.947;3600000;0
2390;376;45;52;35;4;31;.886;3566000;0
2390;2198;45;0;0;0;0;.00nan;0;0
2390;4447;54;69;34;3;31;.912;3600000;0
2390;31126;54;0;0;0;0;.00nan;0;0
2391;37;46;0;0;0;0;.00nan;0;0
2391;2553;46;65;35;4;31;.886;3600000;0
2391;25076;42;0;0;0;0;.00nan;0;0
2391;34788;42;39;30;6;24;.800;3587000;0
2392;2152;49;31;28;6;22;.786;2569000;0
2392;4435;49;53;14;2;12;.857;1031000;0
2392;4716;4619;0;0;0;0;.00nan;0;0
2392;23255;4619;78;22;1;21;.955;3600000;0
2393;7049;47;0;0;0;0;.00nan;0;0
2393;20717;60;0;0;0;0;.00nan;0;0
2393;33654;47;45;29;4;25;.862;3551000;0
2393;35536;60;66;30;3;27;.900;3600000;0
2394;1051;44;99;32;1;31;.969;3600000;0
2394;14351;40;0;0;0;0;.00nan;0;0
2394;22601;44;0;0;0;0;.00nan;0;0
2394;26840;40;56;33;5;28;.848;3600000;0
2395;2016;61;0;0;0;0;.00nan;0;0
2395;6572;62;58;39;5;34;.872;3900000;0
2395;11194;62;0;0;0;0;.00nan;0;0
2395;30971;61;71;43;5;38;.884;3900000;0
2396;19640;41;45;27;5;22;.815;3600000;0
2396;23075;41;0;0;0;0;.00nan;0;0
2396;31156;53;94;31;1;30;.968;3600000;0
2396;38651;53;0;0;0;0;.00nan;0;0
2397;5137;58;0;0;0;0;.00nan;0;0
2397;15437;58;87;41;2;39;.951;3900000;0
2397;31408;52;0;0;0;0;.00nan;0;0
2397;32146;52;89;33;2;31;.939;3900000;0
2398;6062;36;0;0;0;0;.00nan;0;0
2398;6081;56;0;0;0;0;.00nan;0;0
2398;14061;56;56;31;4;27;.871;3600000;0
2398;14874;36;85;32;2;30;.938;3600000;0
2399;907;39;0;0;0;0;.00nan;0;0
2399;5298;55;0;0;0;0;.00nan;0;0
2399;9238;39;66;35;3;32;.914;3771000;0
2399;32340;55;59;26;4;22;.846;3771000;0
2400;23493;51;0;0;0;0;.00nan;0;0
2400;26967;63;0;0;0;0;.00nan;0;0
2400;31035;51;94;13;0;13;1.000;3600000;0
2400;34814;63;80;47;5;42;.894;3600000;0
2401;37;46;94;40;2;38;.950;3600000;0
2401;2553;46;0;0;0;0;.00nan;0;0
2401;4106;64;0;0;0;0;.00nan;0;0
2401;5146;64;64;34;4;30;.882;3517000;0
2402;2163;59;0;0;0;0;.00nan;0;0
2402;2796;59;90;29;1;28;.966;3600000;0
2402;3847;38;0;0;0;0;.00nan;0;0
2402;31021;38;79;35;3;32;.914;3566000;0
2403;4338;65;99;35;1;34;.971;3600000;0
2403;4987;65;0;0;0;0;.00nan;0;0
2403;27474;57;68;27;3;24;.889;3531000;0
2403;28772;57;0;0;0;0;.00nan;0;0
2404;3;50;96;21;0;21;1.000;3600000;0
2404;376;45;63;23;3;20;.870;3600000;0
2404;2198;45;0;0;0;0;.00nan;0;0
2404;5048;50;0;0;0;0;.00nan;0;0
2405;2152;49;22;12;4;8;.667;1102000;0
2405;4435;49;58;28;3;25;.893;2498000;0
2405;4716;4619;0;0;0;0;.00nan;0;0
2405;23255;4619;64;34;4;30;.882;3600000;0
2406;1051;44;64;33;3;30;.909;3885000;0
2406;7049;47;65;37;4;33;.892;3885000;0
2406;22601;44;0;0;0;0;.00nan;0;0
2406;33654;47;0;0;0;0;.00nan;0;0
2407;2016;61;0;0;0;0;.00nan;0;0
2407;14351;40;0;0;0;0;.00nan;0;0
2407;26840;40;78;31;2;29;.935;3751000;0
2407;30971;61;85;31;1;30;.968;3751000;0
2408;2163;59;43;31;5;26;.839;3600000;0
2408;2796;59;0;0;0;0;.00nan;0;0
2408;5137;58;93;39;1;38;.974;3600000;0
2408;15437;58;0;0;0;0;.00nan;0;0
2409;31156;53;0;0;0;0;.00nan;0;0
2409;31408;52;73;28;1;27;.964;3900000;0
2409;32146;52;0;0;0;0;.00nan;0;0
2409;38651;53;100;45;1;44;.978;3900000;0
2410;4338;65;53;2;0;2;1.000;670000;0
2410;4987;65;37;32;6;26;.813;2877000;0
2410;27474;57;0;0;0;0;.00nan;0;0
2410;28772;57;55;30;5;25;.833;3600000;0
2411;6062;36;81;26;1;25;.962;3600000;0
2411;14874;36;0;0;0;0;.00nan;0;0
2411;23493;51;0;0;0;0;.00nan;0;0
2411;31035;51;66;37;4;33;.892;3600000;0
2412;2296;37;0;0;0;0;.00nan;0;0
2412;5883;37;77;25;1;24;.960;3600000;0
2412;25076;42;78;32;2;30;.938;3555000;0
2412;34788;42;0;0;0;0;.00nan;0;0
2413;3;50;0;0;0;0;.00nan;0;0
2413;376;45;0;0;0;0;.00nan;0;0
2413;2198;45;50;24;4;20;.833;3544000;0
2413;5048;50;69;26;2;24;.923;3600000;0
2414;3847;38;50;29;4;25;.862;3558000;0
2414;10698;41;0;0;0;0;.00nan;0;0
2414;23075;41;73;29;2;27;.931;3600000;0
2414;31021;38;0;0;0;0;.00nan;0;0
2415;907;39;95;35;2;33;.943;3600000;0
2415;1486;43;0;0;0;0;.00nan;0;0
2415;3625;43;61;29;4;25;.862;3600000;0
2415;9238;39;0;0;0;0;.00nan;0;0
2416;4106;64;90;28;1;27;.964;3600000;0
2416;4447;54;30;11;3;8;.727;577000;0
2416;5146;64;0;0;0;0;.00nan;0;0
2416;31126;54;78;24;0;24;1.000;2987000;0
2417;2152;49;58;35;4;31;.886;3600000;0
2417;4435;49;0;0;0;0;.00nan;0;0
2417;4716;4619;72;18;1;17;.944;3600000;0
2417;23255;4619;0;0;0;0;.00nan;0;0
2418;7049;47;0;0;0;0;.00nan;0;0
2418;14351;40;35;29;5;24;.828;2821000;0
2418;26840;40;63;11;1;10;.909;779000;0
2418;33654;47;78;22;1;21;.955;3600000;0
2419;1051;44;0;0;0;0;.00nan;0;0
2419;6572;62;90;30;1;29;.967;3600000;0
2419;11194;62;0;0;0;0;.00nan;0;0
2419;22601;44;33;39;7;32;.821;3600000;0
2420;3626;48;50;34;5;29;.853;3567000;0
2420;20717;60;0;0;0;0;.00nan;0;0
2420;35536;60;74;32;3;29;.906;3600000;0
2420;38547;48;0;0;0;0;.00nan;0;0
2421;3847;38;0;0;0;0;.00nan;0;0
2421;5137;58;0;0;0;0;.00nan;0;0
2421;15437;58;74;27;2;25;.926;3554000;0
2421;31021;38;93;27;1;26;.963;3600000;0
2422;2163;59;0;0;0;0;.00nan;0;0
2422;2796;59;48;26;4;22;.846;3600000;0
2422;31156;53;43;38;6;32;.842;3581000;0
2422;38651;53;0;0;0;0;.00nan;0;0
2423;907;39;0;0;0;0;.00nan;0;0
2423;1486;43;0;0;0;0;.00nan;0;0
2423;3625;43;77;32;3;29;.906;3600000;0
2423;9238;39;64;32;4;28;.875;3575000;0
2424;6081;56;0;0;0;0;.00nan;0;0
2424;14061;56;60;34;4;30;.882;3735000;0
2424;26967;63;78;30;2;28;.933;3218000;0
2424;34814;63;25;7;3;4;.571;517000;0
2425;2296;37;0;0;0;0;.00nan;0;0
2425;4447;54;81;38;4;34;.895;3900000;0
2425;5883;37;56;24;4;20;.833;3900000;0
2425;31126;54;0;0;0;0;.00nan;0;0
2426;37;46;97;31;1;30;.968;3600000;0
2426;2553;46;0;0;0;0;.00nan;0;0
2426;4106;64;0;0;0;0;.00nan;0;0
2426;5146;64;85;38;3;35;.921;3537000;0
2427;4338;65;93;30;1;29;.967;3600000;0
2427;4987;65;0;0;0;0;.00nan;0;0
2427;6062;36;0;0;0;0;.00nan;0;0
2427;14874;36;78;35;3;32;.914;3549000;0
2428;3;50;94;31;1;30;.968;3900000;0
2428;5048;50;0;0;0;0;.00nan;0;0
2428;25076;42;0;0;0;0;.00nan;0;0
2428;34788;42;90;25;1;24;.960;3900000;0
2429;3626;48;0;0;0;0;.00nan;0;0
2429;20717;60;57;17;2;15;.882;3600000;0
2429;35536;60;0;0;0;0;.00nan;0;0
2429;38547;48;59;34;4;30;.882;3600000;0
2925;6572;62;58;32;5;27;.844;3600000;0
2925;7049;47;61;19;2;17;.895;3600000;0
2925;26919;62;0;0;0;0;.00nan;0;0
2925;33654;47;0;0;0;0;.00nan;0;0
2927;5137;58;0;0;0;0;.00nan;0;0
2927;8046;57;0;0;0;0;.00nan;0;0
2927;14321;58;92;30;1;29;.967;3600000;0
2927;27474;57;64;24;2;22;.917;3568000;0
2929;780;52;0;0;0;0;.00nan;0;0
2929;1051;44;0;0;0;0;.00nan;0;0
2929;3281;44;71;33;3;30;.909;3597000;0
2929;32146;52;99;40;2;38;.950;3600000;0
2931;3;50;73;29;2;27;.931;3548000;0
2931;5048;50;0;0;0;0;.00nan;0;0
2931;20717;60;0;0;0;0;.00nan;0;0
2931;35536;60;70;21;1;20;.952;3600000;0
2933;1486;43;0;0;0;0;.00nan;0;0
2933;3625;43;92;35;2;33;.943;3600000;0
2933;4716;4619;34;30;5;25;.833;3600000;0
2933;23255;4619;0;0;0;0;.00nan;0;0
2935;1592;63;49;16;2;14;.875;1911000;0
2935;2796;59;0;0;0;0;.00nan;0;0
2935;26967;63;35;13;4;9;.692;1689000;0
2935;31858;59;89;15;0;15;1.000;3600000;0
2937;2163;39;0;0;0;0;.00nan;0;0
2937;9238;39;100;34;0;34;1.000;3600000;0
2937;28772;53;0;0;0;0;.00nan;0;0
2937;31156;53;56;22;3;19;.864;3600000;0
2939;376;45;0;0;0;0;.00nan;0;0
2939;2198;45;63;38;5;33;.868;3600000;0
2939;3847;38;0;0;0;0;.00nan;0;0
2939;31021;38;97;26;0;26;1.000;3600000;0
2941;2016;61;0;0;0;0;.00nan;0;0
2941;30971;61;85;38;2;36;.947;3900000;0
2941;34788;42;66;27;2;25;.926;3881000;0
2941;37416;42;0;0;0;0;.00nan;0;0
2943;4447;54;0;0;0;0;.00nan;0;0
2943;14351;40;0;0;0;0;.00nan;0;0
2943;26840;40;52;34;5;29;.853;3600000;0
2943;31126;54;51;22;3;19;.864;3600000;0
2945;4338;65;0;0;0;0;.00nan;0;0
2945;4987;65;73;34;2;32;.941;3900000;0
2945;5298;55;0;0;0;0;.00nan;0;0
2945;34770;55;84;35;2;33;.943;3900000;0
2947;3626;48;49;34;4;30;.882;3600000;0
2947;19640;41;0;0;0;0;.00nan;0;0
2947;23075;41;86;28;1;27;.964;3600000;0
2947;38547;48;0;0;0;0;.00nan;0;0
2949;37;46;0;0;0;0;.00nan;0;0
2949;2553;46;76;32;2;30;.938;3600000;0
2949;23493;51;75;45;4;41;.911;3572000;0
2949;31822;51;0;0;0;0;.00nan;0;0
2951;2152;49;0;0;0;0;.00nan;0;0
2951;4435;49;100;35;0;35;1.000;3600000;0
2951;6081;56;46;27;4;23;.852;3600000;0
2951;26824;56;0;0;0;0;.00nan;0;0
2953;2296;37;0;0;0;0;.00nan;0;0
2953;5146;64;0;0;0;0;.00nan;0;0
2953;5883;37;84;35;3;32;.914;3734000;0
2953;28845;64;73;26;2;24;.923;3734000;0
2955;2152;49;0;0;0;0;.00nan;0;0
2955;4435;49;39;22;4;18;.818;3600000;0
2955;5137;58;0;0;0;0;.00nan;0;0
2955;14321;58;42;31;5;26;.839;3595000;0
2957;376;45;51;26;4;22;.846;3567000;0
2957;2198;45;0;0;0;0;.00nan;0;0
2957;2296;37;0;0;0;0;.00nan;0;0
2957;5883;37;63;31;3;28;.903;3600000;0
2959;1486;43;50;23;3;20;.870;3523000;0
2959;3625;43;0;0;0;0;.00nan;0;0
2959;6081;56;0;0;0;0;.00nan;0;0
2959;26824;56;89;32;1;31;.969;3600000;0
2961;780;52;0;0;0;0;.00nan;0;0
2961;1592;63;47;32;5;27;.844;3600000;0
2961;26967;63;0;0;0;0;.00nan;0;0
2961;32146;52;76;32;2;30;.938;3600000;0
2963;2016;61;68;28;2;26;.929;3600000;0
2963;30971;61;0;0;0;0;.00nan;0;0
2963;34788;42;62;33;3;30;.909;3600000;0
2963;37416;42;0;0;0;0;.00nan;0;0
2965;1051;44;0;0;0;0;.00nan;0;0
2965;3281;44;67;23;3;20;.870;3900000;0
2965;5146;64;85;41;3;38;.927;3900000;0
2965;28845;64;0;0;0;0;.00nan;0;0
2967;5298;55;0;0;0;0;.00nan;0;0
2967;23493;51;0;0;0;0;.00nan;0;0
2967;31822;51;62;30;3;27;.900;3559000;0
2967;34770;55;77;29;2;27;.931;3600000;0
2969;2900;36;75;25;1;24;.960;3600000;0
2969;14874;36;0;0;0;0;.00nan;0;0
2969;20717;60;55;33;4;29;.879;3600000;0
2969;35536;60;0;0;0;0;.00nan;0;0
2971;2796;59;0;0;0;0;.00nan;0;0
2971;3847;38;0;0;0;0;.00nan;0;0
2971;31021;38;40;36;6;30;.833;3600000;0
2971;31858;59;100;47;3;44;.936;3600000;0
2973;3;50;81;29;1;28;.966;3600000;0
2973;5048;50;0;0;0;0;.00nan;0;0
2973;23075;41;86;27;2;25;.926;3561000;0
2973;51213;41;0;0;0;0;.00nan;0;0
2975;2163;39;0;0;0;0;.00nan;0;0
2975;7049;47;56;23;3;20;.870;3600000;0
2975;9238;39;64;30;4;26;.867;3534000;0
2975;33654;47;0;0;0;0;.00nan;0;0
2977;6572;62;69;25;2;23;.920;3558000;0
2977;8046;57;91;39;1;38;.974;3600000;0
2977;26919;62;0;0;0;0;.00nan;0;0
2977;27474;57;0;0;0;0;.00nan;0;0
2979;4447;54;80;37;3;34;.919;3600000;0
2979;28772;53;0;0;0;0;.00nan;0;0
2979;31126;54;0;0;0;0;.00nan;0;0
2979;31156;53;41;30;6;24;.800;3600000;0
2981;4338;65;0;0;0;0;.00nan;0;0
2981;4987;65;77;23;1;22;.957;3600000;0
2981;14351;40;71;33;3;30;.909;3574000;0
2981;26840;40;0;0;0;0;.00nan;0;0
2983;3626;48;0;0;0;0;.00nan;0;0
2983;4716;4619;73;22;2;20;.909;3559000;0
2983;23255;4619;0;0;0;0;.00nan;0;0
2983;38547;48;78;29;1;28;.966;3600000;0
2985;3626;48;88;25;1;24;.960;3600000;0
2985;8046;57;0;0;0;0;.00nan;0;0
2985;27474;57;85;30;2;28;.933;3515000;0
2985;38547;48;0;0;0;0;.00nan;0;0
2987;3847;38;88;42;3;39;.929;3600000;0
2987;5137;58;39;21;4;17;.810;3543000;0
2987;14321;58;0;0;0;0;.00nan;0;0
2987;31021;38;0;0;0;0;.00nan;0;0
2989;2296;37;70;37;5;32;.865;3900000;0
2989;5883;37;0;0;0;0;.00nan;0;0
2989;7049;47;0;0;0;0;.00nan;0;0
2989;33654;47;32;30;5;25;.833;3900000;0
2991;2016;61;0;0;0;0;.00nan;0;0
2991;4338;65;70;23;2;21;.913;3600000;0
2991;4987;65;0;0;0;0;.00nan;0;0
2991;30971;61;65;36;4;32;.889;3518000;0
2993;3;50;0;0;0;0;.00nan;0;0
2993;37;46;0;0;0;0;.00nan;0;0
2993;2553;46;100;41;1;40;.976;3600000;0
2993;5048;50;61;24;3;21;.875;3550000;0
2995;780;52;72;26;2;24;.923;3569000;0
2995;6081;56;85;28;1;27;.964;3600000;0
2995;26824;56;0;0;0;0;.00nan;0;0
2995;32146;52;0;0;0;0;.00nan;0;0
2997;20717;60;0;0;0;0;.00nan;0;0
2997;28772;53;81;33;2;31;.939;3900000;0
2997;31156;53;0;0;0;0;.00nan;0;0
2997;35536;60;96;38;2;36;.947;3900000;0
2999;1051;44;77;33;3;30;.909;3600000;0
2999;3281;44;0;0;0;0;.00nan;0;0
2999;14351;40;0;0;0;0;.00nan;0;0
2999;26840;40;62;35;4;31;.886;3559000;0
3001;1486;43;0;0;0;0;.00nan;0;0
3001;2796;59;92;18;0;18;1.000;3600000;0
3001;3625;43;48;31;5;26;.839;3600000;0
3001;31858;59;0;0;0;0;.00nan;0;0
3003;2900;36;0;0;0;0;.00nan;0;0
3003;5298;55;29;22;5;17;.773;2945000;0
3003;14874;36;67;30;3;27;.900;3600000;0
3003;34770;55;60;5;0;5;1.000;578000;0
3005;23075;41;0;0;0;0;.00nan;0;0
3005;23493;51;79;29;2;27;.931;3646000;0
3005;31822;51;0;0;0;0;.00nan;0;0
3005;51213;41;68;25;3;22;.880;3646000;0
3007;2152;49;74;29;3;26;.897;3549000;0
3007;2163;39;79;26;2;24;.923;3600000;0
3007;4435;49;0;0;0;0;.00nan;0;0
3007;9238;39;0;0;0;0;.00nan;0;0
3009;376;45;0;0;0;0;.00nan;0;0
3009;2198;45;60;41;6;35;.854;3600000;0
3009;5146;64;0;0;0;0;.00nan;0;0
3009;28845;64;94;44;1;43;.977;3600000;0
3011;1592;63;0;0;0;0;.00nan;0;0
3011;26967;63;97;40;2;38;.950;3900000;0
3011;34788;42;0;0;0;0;.00nan;0;0
3011;37416;42;75;29;2;27;.931;3900000;0
3013;4716;4619;0;0;0;0;.00nan;0;0
3013;6572;62;0;0;0;0;.00nan;0;0
3013;23255;4619;78;27;1;26;.963;3544000;0
3013;26919;62;82;16;0;16;1.000;3600000;0
3015;2016;61;94;45;1;44;.978;3900000;0
3015;7049;47;0;0;0;0;.00nan;0;0
3015;30971;61;0;0;0;0;.00nan;0;0
3015;33654;47;79;26;1;25;.962;3900000;0
3017;2163;39;0;0;0;0;.00nan;0;0
3017;9238;39;52;26;3;23;.885;3552000;0
3017;28772;53;0;0;0;0;.00nan;0;0
3017;31156;53;73;23;1;22;.957;3600000;0
3019;780;52;0;0;0;0;.00nan;0;0
3019;6081;56;75;28;3;25;.893;3600000;0
3019;26824;56;0;0;0;0;.00nan;0;0
3019;32146;52;41;30;5;25;.833;3540000;0
3021;1592;63;76;43;3;40;.930;3600000;0
3021;6572;62;0;0;0;0;.00nan;0;0
3021;26919;62;52;28;4;24;.857;3600000;0
3021;26967;63;0;0;0;0;.00nan;0;0
3023;3847;38;0;0;0;0;.00nan;0;0
3023;4338;65;0;0;0;0;.00nan;0;0
3023;4987;65;67;45;5;40;.889;3600000;0
3023;31021;38;96;22;0;22;1.000;3600000;0
3025;5137;58;0;0;0;0;.00nan;0;0
3025;14321;58;75;25;1;24;.960;3900000;0
3025;14351;40;0;0;0;0;.00nan;0;0
3025;26840;40;96;46;1;45;.978;3900000;0
3027;2296;37;0;0;0;0;.00nan;0;0
3027;5146;64;59;12;1;11;.917;2455000;0
3027;5883;37;54;23;3;20;.870;3600000;0
3027;28845;64;27;12;4;8;.667;1067000;0
3029;3;50;75;29;2;27;.931;3600000;0
3029;4716;4619;0;0;0;0;.00nan;0;0
3029;5048;50;0;0;0;0;.00nan;0;0
3029;23255;4619;63;27;3;24;.889;3549000;0
3031;4447;54;0;0;0;0;.00nan;0;0
3031;23493;51;0;0;0;0;.00nan;0;0
3031;31126;54;99;33;1;32;.970;3600000;0
3031;31822;51;82;33;2;31;.939;3600000;0
3033;2152;49;0;0;0;0;.00nan;0;0
3033;4435;49;94;24;0;24;1.000;3600000;0
3033;20717;60;0;0;0;0;.00nan;0;0
3033;35536;60;77;40;3;37;.925;3600000;0
3035;1486;43;79;27;1;26;.963;3600000;0
3035;3625;43;0;0;0;0;.00nan;0;0
3035;8046;57;64;26;2;24;.923;3596000;0
3035;27474;57;0;0;0;0;.00nan;0;0
3037;1051;44;0;0;0;0;.00nan;0;0
3037;3281;44;45;36;6;30;.833;3600000;0
3037;23075;41;40;28;5;23;.821;3600000;0
3037;51213;41;0;0;0;0;.00nan;0;0
3039;2900;36;0;0;0;0;.00nan;0;0
3039;14874;36;81;35;2;33;.943;3600000;0
3039;34788;42;0;0;0;0;.00nan;0;0
3039;37416;42;65;34;3;31;.912;3590000;0
3041;2796;59;88;26;1;25;.962;3600000;0
3041;5298;55;46;33;5;28;.848;3600000;0
3041;31858;59;0;0;0;0;.00nan;0;0
3041;34770;55;0;0;0;0;.00nan;0;0
3043;376;45;0;0;0;0;.00nan;0;0
3043;2198;45;38;25;4;21;.840;3872000;0
3043;3626;48;60;32;5;27;.844;3872000;0
3043;38547;48;0;0;0;0;.00nan;0;0
3045;37;46;74;28;2;26;.929;3545000;0
3045;2296;37;87;31;1;30;.968;3600000;0
3045;2553;46;0;0;0;0;.00nan;0;0
3045;5883;37;0;0;0;0;.00nan;0;0
3047;2152;49;42;29;5;24;.828;3600000;0
3047;28772;53;84;28;1;27;.964;3600000;0
3047;31156;53;0;0;0;0;.00nan;0;0
3047;38817;49;0;0;0;0;.00nan;0;0
3049;4716;4619;97;25;1;24;.960;3900000;0
3049;7049;47;100;42;1;41;.976;3900000;0
3049;23255;4619;0;0;0;0;.00nan;0;0
3049;33654;47;0;0;0;0;.00nan;0;0
3051;1051;44;35;34;6;28;.824;2974000;0
3051;3281;44;67;9;0;9;1.000;626000;0
3051;34788;42;72;17;1;16;.941;3600000;0
3051;37416;42;0;0;0;0;.00nan;0;0
3053;2900;36;35;24;5;19;.792;3600000;0
3053;3847;38;0;0;0;0;.00nan;0;0
3053;14874;36;0;0;0;0;.00nan;0;0
3053;31021;38;94;38;2;36;.947;3600000;0
3055;780;52;61;37;5;32;.865;3900000;0
3055;2163;39;47;33;5;28;.848;3896000;0
3055;9238;39;0;0;0;0;.00nan;0;0
3055;32146;52;0;0;0;0;.00nan;0;0
3057;5298;55;0;0;0;0;.00nan;0;0
3057;8046;57;0;0;0;0;.00nan;0;0
3057;27474;57;59;33;4;29;.879;3577000;0
3057;34770;55;63;23;2;21;.913;3600000;0
3059;2016;61;0;0;0;0;.00nan;0;0
3059;3626;48;0;0;0;0;.00nan;0;0
3059;30971;61;63;23;2;21;.913;3600000;0
3059;38547;48;63;39;4;35;.897;3513000;0
3061;2796;59;0;0;0;0;.00nan;0;0
3061;4447;54;48;18;3;15;.833;3549000;0
3061;31126;54;0;0;0;0;.00nan;0;0
3061;31858;59;99;45;2;43;.956;3600000;0
3063;376;45;42;20;3;17;.850;3600000;0
3063;1592;63;0;0;0;0;.00nan;0;0
3063;2198;45;0;0;0;0;.00nan;0;0
3063;26967;63;93;23;0;23;1.000;3600000;0
3065;3;50;0;0;0;0;.00nan;0;0
3065;5048;50;67;28;2;26;.929;3600000;0
3065;6081;56;0;0;0;0;.00nan;0;0
3065;26824;56;69;39;3;36;.923;3574000;0
3067;14351;40;76;32;2;30;.938;3600000;0
3067;23075;41;0;0;0;0;.00nan;0;0
3067;26840;40;0;0;0;0;.00nan;0;0
3067;51213;41;77;25;1;24;.960;3600000;0
3069;1486;43;0;0;0;0;.00nan;0;0
3069;3625;43;68;36;4;32;.889;3872000;0
3069;6572;62;36;23;5;18;.783;3872000;0
3069;26919;62;0;0;0;0;.00nan;0;0
3071;5137;58;80;30;1;29;.967;3600000;0
3071;14321;58;0;0;0;0;.00nan;0;0
3071;20717;60;63;34;4;30;.882;3600000;0
3071;35536;60;0;0;0;0;.00nan;0;0
3073;4338;65;73;27;2;25;.926;3900000;0
3073;4987;65;0;0;0;0;.00nan;0;0
3073;23493;51;87;35;2;33;.943;3900000;0
3073;31822;51;0;0;0;0;.00nan;0;0
3075;1051;44;0;0;0;0;.00nan;0;0
3075;2016;61;0;0;0;0;.00nan;0;0
3075;3281;44;69;42;4;38;.905;3826000;0
3075;30971;61;55;38;5;33;.868;3826000;0
3077;37;46;53;23;3;20;.870;3530000;0
3077;2553;46;0;0;0;0;.00nan;0;0
3077;5137;58;0;0;0;0;.00nan;0;0
3077;14321;58;61;21;2;19;.905;3600000;0
3079;376;45;0;0;0;0;.00nan;0;0
3079;2198;45;43;29;6;23;.793;3600000;0
3079;2796;59;0;0;0;0;.00nan;0;0
3079;31858;59;98;30;1;29;.967;3600000;0
3081;2296;37;0;0;0;0;.00nan;0;0
3081;3626;48;0;0;0;0;.00nan;0;0
3081;5883;37;86;44;3;41;.932;3600000;0
3081;38547;48;86;32;1;31;.969;3600000;0
3083;2900;36;18;29;6;23;.793;3600000;0
3083;14874;36;0;0;0;0;.00nan;0;0
3083;23493;51;0;0;0;0;.00nan;0;0
3083;31822;51;78;25;1;24;.960;3600000;0
3085;780;52;0;0;0;0;.00nan;0;0
3085;4716;4619;0;0;0;0;.00nan;0;0
3085;23255;4619;34;30;5;25;.833;3600000;0
3085;32146;52;90;27;1;26;.963;3600000;0
3087;4338;65;0;0;0;0;.00nan;0;0
3087;4987;65;77;29;2;27;.931;3600000;0
3087;23075;41;60;32;4;28;.875;3523000;0
3087;51213;41;0;0;0;0;.00nan;0;0
3089;6081;56;0;0;0;0;.00nan;0;0
3089;26824;56;70;44;4;40;.909;3600000;0
3089;34788;42;0;0;0;0;.00nan;0;0
3089;37416;42;94;17;0;17;1.000;3600000;0
3091;3;50;0;0;0;0;.00nan;0;0
3091;2163;39;0;0;0;0;.00nan;0;0
3091;5048;50;100;36;0;36;1.000;3600000;0
3091;9238;39;74;32;2;30;.938;3600000;0
3093;1486;43;99;28;0;28;1.000;3600000;0
3093;3625;43;0;0;0;0;.00nan;0;0
3093;7049;47;0;0;0;0;.00nan;0;0
3093;33654;47;94;32;1;31;.969;3566000;0
3095;5146;64;0;0;0;0;.00nan;0;0
3095;28772;53;0;0;0;0;.00nan;0;0
3095;28845;64;56;22;3;19;.864;3600000;0
3095;31156;53;69;48;5;43;.896;3572000;0
3097;1592;63;0;0;0;0;.00nan;0;0
3097;3847;38;0;0;0;0;.00nan;0;0
3097;26967;63;80;34;2;32;.941;3562000;0
3097;31021;38;100;29;0;29;1.000;3600000;0
3099;2152;49;54;31;4;27;.871;3600000;0
3099;4447;54;68;33;3;30;.909;3600000;0
3099;31126;54;0;0;0;0;.00nan;0;0
3099;38817;49;0;0;0;0;.00nan;0;0
3101;6572;62;0;0;0;0;.00nan;0;0
3101;20717;60;77;23;1;22;.957;3867000;0
3101;26919;62;78;34;2;32;.941;3867000;0
3101;35536;60;0;0;0;0;.00nan;0;0
3103;5298;55;100;39;0;39;1.000;3600000;0
3103;8046;57;40;43;8;35;.814;3600000;0
3103;27474;57;0;0;0;0;.00nan;0;0
3103;34770;55;0;0;0;0;.00nan;0;0
3105;3625;43;75;29;2;27;.931;3600000;0
3105;6572;62;16;21;6;15;.714;1741000;0
3105;26919;62;65;18;1;17;.944;1859000;0
3105;36324;43;0;0;0;0;.00nan;0;0
3107;5883;37;85;34;1;33;.971;3600000;0
3107;6081;56;66;24;2;22;.917;3571000;0
3107;23043;37;0;0;0;0;.00nan;0;0
3107;26824;56;0;0;0;0;.00nan;0;0
3109;21469;49;0;0;0;0;.00nan;0;0
3109;30971;61;0;0;0;0;.00nan;0;0
3109;35538;61;62;25;2;23;.920;3600000;0
3109;38817;49;68;35;3;32;.914;3576000;0
3111;3281;44;94;52;3;49;.942;3726000;0
3111;14874;36;65;24;2;22;.917;3726000;0
3111;31545;44;0;0;0;0;.00nan;0;0
3111;42825;36;0;0;0;0;.00nan;0;0
3113;14321;58;54;4;0;4;1.000;699000;0
3113;22970;38;0;0;0;0;.00nan;0;0
3113;31021;38;95;22;0;22;1.000;3600000;0
3113;35595;58;28;27;6;21;.778;2901000;0
3115;4447;54;0;0;0;0;.00nan;0;0
3115;31126;54;79;27;1;26;.963;3600000;0
3115;31408;52;73;34;3;31;.912;3532000;0
3115;32146;52;0;0;0;0;.00nan;0;0
3117;37;46;0;0;0;0;.00nan;0;0
3117;26929;46;49;25;4;21;.840;3600000;0
3117;34788;42;0;0;0;0;.00nan;0;0
3117;37416;42;47;39;6;33;.846;3558000;0
3119;5298;55;0;0;0;0;.00nan;0;0
3119;26622;65;52;30;4;26;.867;3552000;0
3119;34770;55;88;32;2;30;.938;3600000;0
3119;40296;65;0;0;0;0;.00nan;0;0
3121;20717;60;0;0;0;0;.00nan;0;0
3121;26967;63;0;0;0;0;.00nan;0;0
3121;31433;63;100;33;0;33;1.000;3600000;0
3121;35536;60;58;28;3;25;.893;3600000;0
3123;28772;53;100;35;0;35;1.000;3600000;0
3123;31156;53;0;0;0;0;.00nan;0;0
3123;31858;59;64;26;2;24;.923;3600000;0
3123;34819;59;0;0;0;0;.00nan;0;0
3125;3626;48;83;34;2;32;.941;3600000;0
3125;4716;4619;43;26;4;22;.846;3513000;0
3125;23255;4619;0;0;0;0;.00nan;0;0
3125;38547;48;0;0;0;0;.00nan;0;0
3127;714;51;0;0;0;0;.00nan;0;0
3127;9238;39;62;13;0;13;1.000;1184000;0
3127;31822;51;60;34;4;30;.882;3600000;0
3127;35210;39;31;34;7;27;.794;2416000;0
3129;7523;40;0;0;0;0;.00nan;0;0
3129;14351;40;81;42;3;39;.929;3872000;0
3129;34815;45;0;0;0;0;.00nan;0;0
3129;36703;45;60;20;2;18;.900;3872000;0
3131;7049;47;90;42;3;39;.929;3600000;0
3131;28845;64;0;0;0;0;.00nan;0;0
3131;32826;64;41;22;4;18;.818;3600000;0
3131;33654;47;0;0;0;0;.00nan;0;0
3133;3;50;45;17;3;14;.824;3600000;0
3133;5571;50;0;0;0;0;.00nan;0;0
3133;8046;57;0;0;0;0;.00nan;0;0
3133;26865;57;36;34;6;28;.824;3600000;0
